"","UMD","TPG","elec_type","local_1","local_2","pop_vote","pop_voted","Moon","Hong","Ahn","Yoo","Sim","Jo","Oh","Jang","LeeJae","KimSun","LeeKyoung","Yoon","KimMin","total","invalid","null"
"1","거소·선상투표","거소·선상투표","대통령선거","부산광역시","중구",125,109,33,31,31,4,5,0,0,0,0,0,0,1,2,107,2,16
"2","관외사전투표","관외사전투표","대통령선거","부산광역시","중구",3305,3305,1522,755,515,262,222,6,0,0,0,3,0,1,4,3290,15,0
"3","재외투표","재외투표","대통령선거","부산광역시","중구",335,223,137,22,32,8,22,1,0,0,0,0,0,0,0,222,1,112
"4","중앙동","관내사전투표","대통령선거","부산광역시","중구",328,328,125,121,41,23,17,1,0,0,0,0,0,0,0,328,0,0
"5","중앙동","중앙동제1투","대통령선거","부산광역시","중구",534,277,82,113,44,24,12,0,0,0,0,1,0,0,1,277,0,257
"6","중앙동","중앙동제2투","대통령선거","부산광역시","중구",726,416,136,157,79,22,19,1,0,0,0,0,1,0,1,416,0,310
"7","동광동","관내사전투표","대통령선거","부산광역시","중구",615,615,254,210,90,31,22,4,0,1,0,1,0,0,0,613,2,0
"8","동광동","동광동제1투","대통령선거","부산광역시","중구",1235,655,207,266,121,37,21,2,0,0,0,0,0,1,0,655,0,580
"9","동광동","동광동제2투","대통령선거","부산광역시","중구",1068,648,199,264,104,52,22,2,0,0,0,1,0,1,1,646,2,420
"10","대청동","관내사전투표","대통령선거","부산광역시","중구",949,949,356,344,162,46,37,0,0,1,0,0,0,1,1,948,1,0
"11","대청동","대청동제1투","대통령선거","부산광역시","중구",1805,1134,403,401,187,92,42,4,0,1,0,0,1,0,1,1132,2,671
"12","대청동","대청동제2투","대통령선거","부산광역시","중구",1548,936,310,321,176,58,62,0,0,0,0,0,1,0,0,928,8,612
"13","대청동","대청동제3투","대통령선거","부산광역시","중구",1345,890,299,346,140,57,40,1,0,0,1,0,0,1,1,886,4,455
"14","보수동","관내사전투표","대통령선거","부산광역시","중구",1283,1283,522,443,157,90,67,1,0,1,0,0,0,1,0,1282,1,0
"15","보수동","보수동제1투","대통령선거","부산광역시","중구",1850,1239,372,492,225,82,53,5,0,0,0,2,0,0,0,1231,8,611
"16","보수동","보수동제2투","대통령선거","부산광역시","중구",2116,1287,361,530,242,89,58,0,1,0,1,0,0,0,0,1282,5,829
"17","보수동","보수동제3투","대통령선거","부산광역시","중구",1328,771,240,342,119,35,27,1,0,0,0,1,0,0,1,766,5,557
"18","보수동","보수동제4투","대통령선거","부산광역시","중구",2450,1628,529,665,261,94,69,2,1,2,0,0,0,0,1,1624,4,822
"19","부평동","관내사전투표","대통령선거","부산광역시","중구",930,930,291,434,113,53,32,1,0,0,1,0,1,0,0,926,4,0
"20","부평동","부평동제1투","대통령선거","부산광역시","중구",1867,1032,273,521,162,51,21,0,0,0,0,0,1,1,0,1030,2,835
"21","부평동","부평동제2투","대통령선거","부산광역시","중구",1767,1081,318,509,143,72,35,1,0,0,0,1,0,0,0,1079,2,686
"22","광복동","관내사전투표","대통령선거","부산광역시","중구",342,342,122,132,46,24,14,2,0,0,0,0,0,0,0,340,2,0
"23","광복동","광복동투표소","대통령선거","부산광역시","중구",917,548,129,256,107,31,19,5,0,0,0,0,0,0,1,548,0,369
"24","남포동","관내사전투표","대통령선거","부산광역시","중구",194,194,75,80,27,7,5,0,0,0,0,0,0,0,0,194,0,0
"25","남포동","남포동투표소","대통령선거","부산광역시","중구",896,459,120,228,65,27,15,1,0,0,0,0,0,0,1,457,2,437
"26","영주제1동","관내사전투표","대통령선거","부산광역시","중구",546,546,243,142,94,31,33,0,0,0,0,1,0,0,0,544,2,0
"27","영주제1동","영주제1동제1투","대통령선거","부산광역시","중구",1076,674,229,234,130,48,30,0,1,0,0,0,0,0,0,672,2,402
"28","영주제1동","영주제1동제2투","대통령선거","부산광역시","중구",986,653,216,230,131,34,38,1,1,1,0,0,0,0,0,652,1,333
"29","영주제1동","영주제1동제3투","대통령선거","부산광역시","중구",1375,794,258,298,139,48,47,1,0,0,0,0,0,1,0,792,2,581
"30","영주제2동","관내사전투표","대통령선거","부산광역시","중구",787,787,339,236,127,45,36,1,0,1,0,2,0,0,0,787,0,0
"31","영주제2동","영주제2동제1투","대통령선거","부산광역시","중구",1508,874,250,372,157,60,29,1,0,0,0,0,0,0,1,870,4,634
"32","영주제2동","영주제2동제2투","대통령선거","부산광역시","중구",1382,845,254,346,151,65,25,1,0,0,0,0,0,0,0,842,3,537
"33","영주제2동","영주제2동제3투","대통령선거","부산광역시","중구",1966,1449,494,530,249,110,56,1,0,2,0,0,0,0,1,1443,6,517
"34","영주제2동","영주제2동제4투","대통령선거","부산광역시","중구",964,703,220,313,108,33,22,0,0,1,0,1,2,0,0,700,3,261
"35","잘못 투입·구분된 투표지","잘못 투입·구분된 투표지","대통령선거","부산광역시","중구",0,0,0,0,0,0,0,0,0,0,0,0,0,0,0,0,0,0
"36","거소·선상투표","거소·선상투표","대통령선거","부산광역시","서구",388,359,124,73,97,19,16,2,4,4,2,3,2,0,3,349,10,29
"37","관외사전투표","관외사전투표","대통령선거","부산광역시","서구",7769,7769,3485,1831,1242,644,486,5,1,7,3,6,0,3,15,7728,41,0
"38","재외투표","재외투표","대통령선거","부산광역시","서구",669,437,241,50,64,23,54,2,0,0,0,0,0,0,0,434,3,232
"39","동대신제1동","관내사전투표","대통령선거","부산광역시","서구",843,843,298,340,99,63,37,0,0,0,0,0,1,1,1,840,3,0
"40","동대신제1동","동대신제1동제1투","대통령선거","부산광역시","서구",1814,1281,323,589,226,98,38,1,0,1,0,0,0,1,1,1278,3,533
"41","동대신제1동","동대신제1동제2투","대통령선거","부산광역시","서구",1409,919,287,380,159,51,31,1,0,2,0,1,1,0,0,913,6,490
"42","동대신제2동","관내사전투표","대통령선거","부산광역시","서구",742,742,294,282,85,46,33,1,0,0,0,1,0,0,0,742,0,0
"43","동대신제2동","동대신제2동제1투","대통령선거","부산광역시","서구",1778,1319,371,556,245,101,38,3,0,2,0,0,0,1,0,1317,2,459
"44","동대신제2동","동대신제2동제2투","대통령선거","부산광역시","서구",2183,1343,406,568,239,74,46,3,0,0,0,1,0,0,1,1338,5,840
"45","동대신제2동","동대신제2동제3투","대통령선거","부산광역시","서구",1893,1239,388,508,211,80,45,2,0,0,1,0,0,0,0,1235,4,654
"46","동대신제3동","관내사전투표","대통령선거","부산광역시","서구",1629,1629,639,545,223,123,89,1,0,1,0,1,0,0,0,1622,7,0
"47","동대신제3동","동대신제3동제1투","대통령선거","부산광역시","서구",1960,1198,366,475,197,101,51,2,0,0,0,0,0,1,1,1194,4,762
"48","동대신제3동","동대신제3동제2투","대통령선거","부산광역시","서구",2433,1666,526,643,307,117,64,1,0,0,0,0,0,0,2,1660,6,767
"49","서대신제1동","관내사전투표","대통령선거","부산광역시","서구",1456,1456,579,478,212,100,74,1,0,1,0,0,0,2,4,1451,5,0
"50","서대신제1동","서대신제1동제1투","대통령선거","부산광역시","서구",1814,1321,456,460,222,104,71,1,0,0,1,0,0,0,0,1315,6,493
"51","서대신제1동","서대신제1동제2투","대통령선거","부산광역시","서구",1913,1231,361,513,222,78,48,0,0,0,0,0,3,0,2,1227,4,682
"52","서대신제1동","서대신제1동제3투","대통령선거","부산광역시","서구",2159,1408,432,561,248,108,53,3,0,1,0,0,1,0,0,1407,1,751
"53","서대신제1동","서대신제1동제4투","대통령선거","부산광역시","서구",1100,787,289,287,117,50,36,1,0,1,0,0,0,0,1,782,5,313
"54","서대신제3동","관내사전투표","대통령선거","부산광역시","서구",1629,1629,624,570,245,103,79,2,0,0,0,1,0,1,2,1627,2,0
"55","서대신제3동","서대신제3동제1투","대통령선거","부산광역시","서구",3012,2144,745,773,371,145,100,1,0,0,0,2,2,2,0,2141,3,868
"56","서대신제3동","서대신제3동제2투","대통령선거","부산광역시","서구",2025,1369,458,525,216,110,54,0,0,1,0,0,1,1,2,1368,1,656
"57","서대신제4동","관내사전투표","대통령선거","부산광역시","서구",983,983,419,311,135,72,43,1,0,0,0,0,0,0,0,981,2,0
"58","서대신제4동","서대신제4동제1투","대통령선거","부산광역시","서구",1761,1238,444,403,228,98,61,0,0,0,0,0,0,2,0,1236,2,523
"59","서대신제4동","서대신제4동제2투","대통령선거","부산광역시","서구",1972,1525,507,566,273,111,62,0,0,2,0,1,0,0,0,1522,3,447
"60","서대신제4동","서대신제4동제3투","대통령선거","부산광역시","서구",657,420,115,178,77,24,22,0,1,0,0,0,0,0,0,417,3,237
"61","부민동","관내사전투표","대통령선거","부산광역시","서구",1370,1370,612,331,171,146,100,0,0,0,0,2,0,2,0,1364,6,0
"62","부민동","부민동제1투","대통령선거","부산광역시","서구",2837,1907,697,620,334,156,84,3,0,4,0,1,1,1,0,1901,6,930
"63","부민동","부민동제2투","대통령선거","부산광역시","서구",2324,1602,507,638,246,141,58,2,0,1,0,1,0,1,3,1598,4,722
"64","아미동","관내사전투표","대통령선거","부산광역시","서구",773,773,296,272,105,66,27,0,0,0,0,0,0,2,1,769,4,0
"65","아미동","아미동제1투","대통령선거","부산광역시","서구",2042,1112,300,479,205,63,49,2,0,2,1,0,0,2,2,1105,7,930
"66","아미동","아미동제2투","대통령선거","부산광역시","서구",1445,869,257,360,140,62,43,0,0,3,0,0,0,2,0,867,2,576
"67","아미동","아미동제3투","대통령선거","부산광역시","서구",1603,821,219,357,153,46,31,3,0,1,1,1,1,1,1,815,6,782
"68","아미동","아미동제4투","대통령선거","부산광역시","서구",1308,821,222,354,159,40,34,1,0,2,1,0,1,1,2,817,4,487
"69","초장동","관내사전투표","대통령선거","부산광역시","서구",628,628,195,250,119,22,29,2,1,2,0,1,1,4,2,628,0,0
"70","초장동","초장동제1투","대통령선거","부산광역시","서구",2164,1188,350,523,187,74,37,0,0,2,1,0,0,2,2,1178,10,976
"71","초장동","초장동제2투","대통령선거","부산광역시","서구",1622,939,255,425,156,59,32,1,0,2,0,1,1,0,1,933,6,683
"72","충무동","관내사전투표","대통령선거","부산광역시","서구",1997,1997,736,746,288,114,97,3,0,1,0,0,0,0,1,1986,11,0
"73","충무동","충무동제1투","대통령선거","부산광역시","서구",3391,2132,693,829,361,146,84,2,0,4,0,2,0,1,1,2123,9,1259
"74","충무동","충무동제2투","대통령선거","부산광역시","서구",2609,1545,366,794,249,87,37,0,0,2,0,0,0,0,1,1536,9,1064
"75","남부민제1동","관내사전투표","대통령선거","부산광역시","서구",815,815,265,356,119,43,23,0,0,3,0,1,0,2,1,813,2,0
"76","남부민제1동","남부민제1동제1투","대통령선거","부산광역시","서구",2102,1236,335,570,219,59,43,0,0,0,1,1,0,1,1,1230,6,866
"77","남부민제1동","남부민제1동제2투","대통령선거","부산광역시","서구",1746,1067,301,504,167,51,35,1,0,3,0,0,1,1,1,1065,2,679
"78","남부민제2동","관내사전투표","대통령선거","부산광역시","서구",917,917,378,300,132,55,48,1,0,1,0,0,0,0,0,915,2,0
"79","남부민제2동","남부민제2동제1투","대통령선거","부산광역시","서구",3018,1824,584,707,335,104,74,2,0,4,0,1,0,0,5,1816,8,1194
"80","남부민제2동","남부민제2동제2투","대통령선거","부산광역시","서구",1606,921,254,443,143,52,17,1,0,2,0,1,0,3,2,918,3,685
"81","남부민제2동","남부민제2동제3투","대통령선거","부산광역시","서구",1579,1014,263,485,173,55,23,1,0,2,0,0,1,3,1,1007,7,565
"82","남부민제2동","남부민제2동제4투","대통령선거","부산광역시","서구",1791,1171,375,484,191,79,31,4,0,1,0,0,0,0,3,1168,3,620
"83","암남동","관내사전투표","대통령선거","부산광역시","서구",1425,1425,610,398,239,96,69,1,1,1,0,0,2,0,1,1418,7,0
"84","암남동","암남동제1투","대통령선거","부산광역시","서구",2404,1230,354,515,227,77,51,2,0,0,0,0,0,0,0,1226,4,1174
"85","암남동","암남동제2투","대통령선거","부산광역시","서구",1621,1093,388,362,202,68,39,2,0,4,0,1,0,4,4,1074,19,528
"86","암남동","암남동제3투","대통령선거","부산광역시","서구",1542,1041,366,380,192,56,40,2,0,0,1,0,0,1,1,1039,2,501
"87","암남동","암남동제4투","대통령선거","부산광역시","서구",2979,1879,526,721,374,142,103,0,0,0,1,1,2,1,2,1873,6,1100
"88","암남동","암남동제5투","대통령선거","부산광역시","서구",2887,1854,641,692,322,111,62,7,0,0,0,0,3,1,3,1842,12,1033
"89","잘못 투입·구분된 투표지","잘못 투입·구분된 투표지","대통령선거","부산광역시","서구",0,0,0,0,0,0,0,0,0,0,0,0,0,0,0,0,0,0
"90","거소·선상투표","거소·선상투표","대통령선거","부산광역시","동구",225,208,69,49,62,15,8,0,0,0,0,0,2,0,0,205,3,17
"91","관외사전투표","관외사전투표","대통령선거","부산광역시","동구",6281,6281,2774,1388,1055,523,470,5,1,6,2,6,0,5,15,6250,31,0
"92","재외투표","재외투표","대통령선거","부산광역시","동구",557,381,241,45,40,16,38,0,0,0,0,0,0,0,0,380,1,176
"93","초량제1동","관내사전투표","대통령선거","부산광역시","동구",598,598,245,189,76,47,34,1,0,0,0,0,0,0,2,594,4,0
"94","초량제1동","초량제1동제1투","대통령선거","부산광역시","동구",2161,1324,411,521,217,90,73,2,0,2,0,0,0,1,4,1321,3,837
"95","초량제1동","초량제1동제2투","대통령선거","부산광역시","동구",1325,849,284,334,130,56,35,1,0,0,0,0,0,1,0,841,8,476
"96","초량제2동","관내사전투표","대통령선거","부산광역시","동구",1003,1003,359,374,161,64,42,0,0,1,0,1,0,0,0,1002,1,0
"97","초량제2동","초량제2동제1투","대통령선거","부산광역시","동구",2507,1428,361,665,281,74,39,1,0,3,0,0,0,0,0,1424,4,1079
"98","초량제2동","초량제2동제2투","대통령선거","부산광역시","동구",1926,1234,344,506,231,81,65,0,1,0,0,0,1,1,2,1232,2,692
"99","초량제3동","관내사전투표","대통령선거","부산광역시","동구",1174,1174,464,354,191,101,58,1,1,0,0,0,1,0,1,1172,2,0
"100","초량제3동","초량제3동제1투","대통령선거","부산광역시","동구",1934,1179,364,480,207,76,42,0,2,2,0,1,0,0,1,1175,4,755
"101","초량제3동","초량제3동제2투","대통령선거","부산광역시","동구",2007,1271,450,417,231,92,70,0,0,1,1,0,1,0,0,1263,8,736
"102","초량제6동","관내사전투표","대통령선거","부산광역시","동구",1120,1120,374,452,165,58,61,0,0,2,1,0,0,2,2,1117,3,0
"103","초량제6동","초량제6동제1투","대통령선거","부산광역시","동구",2288,1381,406,594,248,70,50,2,1,1,0,0,0,0,0,1372,9,907
"104","초량제6동","초량제6동제2투","대통령선거","부산광역시","동구",2489,1632,490,686,291,82,68,1,0,0,0,1,2,1,2,1624,8,857
"105","수정제1동","관내사전투표","대통령선거","부산광역시","동구",971,970,357,341,171,58,38,0,0,0,0,1,0,0,1,967,3,1
"106","수정제1동","수정제1동제1투","대통령선거","부산광역시","동구",1269,776,231,309,141,48,40,1,0,1,1,0,0,1,0,773,3,493
"107","수정제1동","수정제1동제2투","대통령선거","부산광역시","동구",1699,1206,362,494,197,94,48,2,0,2,1,0,1,0,3,1204,2,493
"108","수정제2동","관내사전투표","대통령선거","부산광역시","동구",1161,1161,481,393,171,60,48,0,0,1,0,0,0,2,0,1156,5,0
"109","수정제2동","수정제2동제1투","대통령선거","부산광역시","동구",1779,1258,374,535,227,58,55,0,0,0,0,1,1,0,1,1252,6,521
"110","수정제2동","수정제2동제2투","대통령선거","부산광역시","동구",2157,1337,444,531,233,73,48,1,0,2,0,1,0,0,0,1333,4,820
"111","수정제2동","수정제2동제3투","대통령선거","부산광역시","동구",2366,1570,429,672,288,93,68,2,1,2,1,0,1,3,2,1562,8,796
"112","수정제4동","관내사전투표","대통령선거","부산광역시","동구",612,612,198,277,78,35,18,0,0,1,0,2,0,1,0,610,2,0
"113","수정제4동","수정제4동제1투","대통령선거","부산광역시","동구",1531,926,239,400,178,61,38,0,0,1,1,0,0,1,4,923,3,605
"114","수정제4동","수정제4동제2투","대통령선거","부산광역시","동구",1802,1222,314,604,192,62,41,2,1,1,0,0,0,0,0,1217,5,580
"115","수정제5동","관내사전투표","대통령선거","부산광역시","동구",1070,1070,376,431,154,54,43,4,0,1,0,0,0,2,1,1066,4,0
"116","수정제5동","수정제5동제1투","대통령선거","부산광역시","동구",1950,1302,402,534,221,84,54,2,0,0,1,0,0,0,0,1298,4,648
"117","수정제5동","수정제5동제2투","대통령선거","부산광역시","동구",2260,1423,394,642,243,69,65,3,1,0,0,0,0,1,1,1419,4,837
"118","좌천동","관내사전투표","대통령선거","부산광역시","동구",1726,1726,695,569,266,105,74,0,1,2,2,0,1,0,0,1715,11,0
"119","좌천동","좌천동제1투","대통령선거","부산광역시","동구",2534,1702,525,685,298,120,65,2,0,0,0,1,0,0,3,1699,3,832
"120","좌천동","좌천동제2투","대통령선거","부산광역시","동구",2650,1803,557,732,324,111,62,6,1,1,1,0,1,1,1,1798,5,847
"121","좌천동","좌천동제3투","대통령선거","부산광역시","동구",2655,1711,510,713,310,83,69,5,0,2,1,1,0,1,2,1697,14,944
"122","범일제1동","관내사전투표","대통령선거","부산광역시","동구",1109,1109,390,434,161,63,44,5,0,3,0,0,0,1,2,1103,6,0
"123","범일제1동","범일제1동제1투","대통령선거","부산광역시","동구",2362,1661,526,684,287,93,62,1,1,0,1,0,0,0,2,1657,4,701
"124","범일제1동","범일제1동제2투","대통령선거","부산광역시","동구",847,515,168,218,74,35,13,3,0,2,0,0,0,1,1,515,0,332
"125","범일제1동","범일제1동제3투","대통령선거","부산광역시","동구",1964,1371,432,592,223,62,51,1,0,0,1,1,2,1,1,1367,4,593
"126","범일제1동","범일제1동제4투","대통령선거","부산광역시","동구",2207,1463,426,643,256,78,51,1,1,0,0,0,0,1,1,1458,5,744
"127","범일제1동","범일제1동제5투","대통령선거","부산광역시","동구",2217,1282,359,597,224,57,35,2,0,0,0,0,2,0,1,1277,5,935
"128","범일제2동","관내사전투표","대통령선거","부산광역시","동구",1091,1091,443,370,176,56,41,2,0,1,0,1,0,0,0,1090,1,0
"129","범일제2동","범일제2동제1투","대통령선거","부산광역시","동구",1964,1132,307,551,166,66,34,2,0,0,2,0,1,0,1,1130,2,832
"130","범일제2동","범일제2동제2투","대통령선거","부산광역시","동구",2726,1940,683,676,324,154,89,1,0,2,1,1,1,0,2,1934,6,786
"131","범일제2동","범일제2동제3투","대통령선거","부산광역시","동구",1797,1366,523,443,259,92,42,1,0,1,0,1,0,0,0,1362,4,431
"132","범일제5동","관내사전투표","대통령선거","부산광역시","동구",471,471,190,161,69,27,21,0,0,0,0,0,1,0,1,470,1,0
"133","범일제5동","범일제5동제1투","대통령선거","부산광역시","동구",1510,1006,273,495,158,44,29,1,0,0,0,0,0,2,2,1004,2,504
"134","범일제5동","범일제5동제2투","대통령선거","부산광역시","동구",1668,1058,362,408,160,65,50,1,1,3,1,1,0,1,0,1053,5,610
"135","잘못 투입·구분된 투표지","잘못 투입·구분된 투표지","대통령선거","부산광역시","동구",0,1,0,0,0,1,0,0,0,0,0,0,0,0,0,1,0,-1
"136","거소·선상투표","거소·선상투표","대통령선거","부산광역시","영도구",421,390,152,77,107,23,10,1,2,1,1,2,0,1,1,378,12,31
"137","관외사전투표","관외사전투표","대통령선거","부산광역시","영도구",7605,7603,3546,1595,1202,630,533,2,2,6,2,5,3,2,15,7543,60,2
"138","재외투표","재외투표","대통령선거","부산광역시","영도구",673,489,324,33,64,23,38,2,0,1,0,1,0,0,0,486,3,184
"139","남항동","관내사전투표","대통령선거","부산광역시","영도구",1673,1673,671,612,251,79,52,1,0,3,0,0,0,0,1,1670,3,0
"140","남항동","남항동제1투","대통령선거","부산광역시","영도구",2758,1670,517,692,278,111,55,2,1,1,0,0,0,3,3,1663,7,1088
"141","남항동","남항동제2투","대통령선거","부산광역시","영도구",2349,1427,475,590,235,74,39,4,0,1,0,2,1,0,1,1422,5,922
"142","남항동","남항동제3투","대통령선거","부산광역시","영도구",2890,1768,537,768,273,115,66,1,0,0,0,1,0,1,1,1763,5,1122
"143","영선제1동","관내사전투표","대통령선거","부산광역시","영도구",680,680,314,153,127,51,30,0,1,0,0,0,0,1,2,679,1,0
"144","영선제1동","영선제1동제1투","대통령선거","부산광역시","영도구",1375,802,264,305,132,60,36,2,0,0,1,0,0,0,0,800,2,573
"145","영선제1동","영선제1동제2투","대통령선거","부산광역시","영도구",1511,985,349,324,218,67,23,1,0,0,0,1,0,0,1,984,1,526
"146","영선제2동","관내사전투표","대통령선거","부산광역시","영도구",2057,2057,920,612,294,147,70,2,1,0,0,1,2,0,0,2049,8,0
"147","영선제2동","영선제2동제1투","대통령선거","부산광역시","영도구",2833,1864,677,647,301,142,88,0,0,1,1,2,0,1,0,1860,4,969
"148","영선제2동","영선제2동제2투","대통령선거","부산광역시","영도구",2409,1608,534,619,280,106,57,0,0,1,0,1,0,1,1,1600,8,801
"149","영선제2동","영선제2동제3투","대통령선거","부산광역시","영도구",1432,871,271,366,145,54,28,0,0,0,0,0,0,1,0,865,6,561
"150","신선동","관내사전투표","대통령선거","부산광역시","영도구",738,738,318,232,99,45,33,0,0,2,1,0,1,1,2,734,4,0
"151","신선동","신선동제1투","대통령선거","부산광역시","영도구",2344,1200,406,441,214,85,41,1,0,0,1,1,0,3,1,1194,6,1144
"152","신선동","신선동제2투","대통령선거","부산광역시","영도구",2364,1477,527,541,218,125,54,0,0,0,0,0,1,1,6,1473,4,887
"153","신선동","신선동제3투","대통령선거","부산광역시","영도구",1595,941,334,352,170,44,32,1,0,1,0,0,0,0,2,936,5,654
"154","신선동","신선동제4투","대통령선거","부산광역시","영도구",1796,975,326,348,177,66,46,1,0,1,1,0,1,3,1,971,4,821
"155","봉래제1동","관내사전투표","대통령선거","부산광역시","영도구",1398,1398,576,499,170,75,65,0,0,0,1,1,0,1,1,1389,9,0
"156","봉래제1동","봉래제1동제1투","대통령선거","부산광역시","영도구",2803,1864,651,687,334,122,59,1,0,1,0,1,0,2,0,1858,6,939
"157","봉래제1동","봉래제1동제2투","대통령선거","부산광역시","영도구",2335,1424,519,517,245,84,44,2,0,3,0,0,0,1,2,1417,7,911
"158","봉래제2동","관내사전투표","대통령선거","부산광역시","영도구",497,497,204,143,89,37,22,0,0,0,0,1,0,0,0,496,1,0
"159","봉래제2동","봉래제2동제1투","대통령선거","부산광역시","영도구",921,451,168,157,76,32,13,0,0,0,0,1,0,0,0,447,4,470
"160","봉래제2동","봉래제2동제2투","대통령선거","부산광역시","영도구",1941,1248,407,516,216,72,28,0,0,1,1,1,0,2,1,1245,3,693
"161","봉래제2동","봉래제2동제3투","대통령선거","부산광역시","영도구",1910,1270,457,446,213,83,58,1,1,3,0,2,0,0,1,1265,5,640
"162","청학제1동","관내사전투표","대통령선거","부산광역시","영도구",974,974,466,228,152,69,50,0,0,0,0,2,0,0,1,968,6,0
"163","청학제1동","청학제1동제1투","대통령선거","부산광역시","영도구",3046,1710,583,598,333,124,59,0,0,0,0,0,2,1,3,1703,7,1336
"164","청학제1동","청학제1동제2투","대통령선거","부산광역시","영도구",2251,1407,468,509,252,101,65,0,0,2,0,0,0,2,2,1401,6,844
"165","청학제2동","관내사전투표","대통령선거","부산광역시","영도구",2500,2500,1147,672,362,175,124,2,0,3,2,1,0,0,2,2490,10,0
"166","청학제2동","청학제2동제1투","대통령선거","부산광역시","영도구",2618,1759,679,573,309,118,73,1,0,0,0,2,0,1,0,1756,3,859
"167","청학제2동","청학제2동제2투","대통령선거","부산광역시","영도구",2207,1342,453,488,249,82,56,3,1,2,1,0,0,0,1,1336,6,865
"168","청학제2동","청학제2동제3투","대통령선거","부산광역시","영도구",2607,1712,706,489,309,117,81,2,0,2,0,1,0,1,0,1708,4,895
"169","청학제2동","청학제2동제4투","대통령선거","부산광역시","영도구",3072,2032,806,637,343,152,85,0,0,1,0,0,0,1,1,2026,6,1040
"170","청학제2동","청학제2동제5투","대통령선거","부산광역시","영도구",2875,1853,627,704,294,132,80,3,0,0,1,1,0,0,5,1847,6,1022
"171","동삼제1동","관내사전투표","대통령선거","부산광역시","영도구",4096,4096,1889,1053,631,291,195,3,0,5,1,6,1,5,4,4084,12,0
"172","동삼제1동","동삼제1동제1투","대통령선거","부산광역시","영도구",2157,1388,522,449,242,102,61,0,0,0,0,0,0,0,2,1378,10,769
"173","동삼제1동","동삼제1동제2투","대통령선거","부산광역시","영도구",2387,1462,603,434,257,87,72,0,0,0,1,1,0,2,1,1458,4,925
"174","동삼제1동","동삼제1동제3투","대통령선거","부산광역시","영도구",3146,2051,727,711,354,151,89,10,0,1,0,1,1,0,2,2047,4,1095
"175","동삼제1동","동삼제1동제4투","대통령선거","부산광역시","영도구",2300,1555,580,534,272,96,63,1,0,0,0,1,0,0,3,1550,5,745
"176","동삼제1동","동삼제1동제5투","대통령선거","부산광역시","영도구",2886,1876,744,574,299,157,86,7,0,0,1,0,1,0,0,1869,7,1010
"177","동삼제1동","동삼제1동제6투","대통령선거","부산광역시","영도구",2393,1620,603,540,285,121,63,1,0,1,0,0,0,0,0,1614,6,773
"178","동삼제1동","동삼제1동제7투","대통령선거","부산광역시","영도구",1899,948,331,325,190,51,38,4,0,0,1,0,0,0,2,942,6,951
"179","동삼제1동","동삼제1동제8투","대통령선거","부산광역시","영도구",1969,1271,447,450,217,82,64,4,0,0,0,0,1,1,1,1267,4,698
"180","동삼제2동","관내사전투표","대통령선거","부산광역시","영도구",663,663,268,181,106,52,47,1,0,2,0,1,0,0,1,659,4,0
"181","동삼제2동","동삼제2동투표소","대통령선거","부산광역시","영도구",2547,1601,518,548,327,141,59,0,0,0,1,1,0,1,0,1596,5,946
"182","동삼제3동","관내사전투표","대통령선거","부산광역시","영도구",1659,1659,727,474,255,101,81,6,0,1,0,0,0,1,1,1647,12,0
"183","동삼제3동","동삼제3동제1투","대통령선거","부산광역시","영도구",1768,1102,345,406,202,87,52,0,0,0,1,1,0,1,3,1098,4,666
"184","동삼제3동","동삼제3동제2투","대통령선거","부산광역시","영도구",2123,1366,484,501,243,68,54,1,0,1,0,0,0,1,0,1353,13,757
"185","동삼제3동","동삼제3동제3투","대통령선거","부산광역시","영도구",2376,1302,362,550,252,74,42,3,0,3,1,1,0,1,2,1291,11,1074
"186","동삼제3동","동삼제3동제4투","대통령선거","부산광역시","영도구",2058,1393,565,445,218,92,57,1,0,0,0,2,0,1,2,1383,10,665
"187","잘못 투입·구분된 투표지","잘못 투입·구분된 투표지","대통령선거","부산광역시","영도구",0,1,0,0,1,0,0,0,0,0,0,0,0,0,0,1,0,-1
"188","거소·선상투표","거소·선상투표","대통령선거","부산광역시","부산진구",781,722,273,146,205,45,22,4,1,0,3,1,1,1,2,704,18,59
"189","관외사전투표","관외사전투표","대통령선거","부산광역시","부산진구",25185,25176,11719,5094,4125,2195,1747,36,6,14,5,16,6,6,47,25016,160,9
"190","재외투표","재외투표","대통령선거","부산광역시","부산진구",1784,1370,842,97,199,57,166,2,0,0,1,1,0,0,1,1366,4,414
"191","부전제1동","관내사전투표","대통령선거","부산광역시","부산진구",2268,2268,855,913,292,91,94,4,0,1,0,2,1,1,0,2254,14,0
"192","부전제1동","부전제1동제1투","대통령선거","부산광역시","부산진구",2606,1216,338,579,175,70,44,1,0,2,1,0,0,0,2,1212,4,1390
"193","부전제1동","부전제1동제2투","대통령선거","부산광역시","부산진구",3202,1850,666,606,284,144,130,2,0,3,0,1,0,1,0,1837,13,1352
"194","부전제1동","부전제1동제3투","대통령선거","부산광역시","부산진구",1507,1006,314,402,177,49,51,2,1,2,0,0,0,1,2,1001,5,501
"195","부전제1동","부전제1동제4투","대통령선거","부산광역시","부산진구",945,627,170,308,103,21,19,0,0,1,0,0,0,1,1,624,3,318
"196","부전제1동","부전제1동제5투","대통령선거","부산광역시","부산진구",1314,851,237,391,134,55,28,0,0,0,0,0,0,0,1,846,5,463
"197","부전제2동","관내사전투표","대통령선거","부산광역시","부산진구",1401,1401,694,266,195,117,122,1,0,0,0,0,0,1,1,1397,4,0
"198","부전제2동","부전제2동제1투","대통령선거","부산광역시","부산진구",3069,1912,668,636,366,120,101,6,1,2,1,0,0,1,1,1903,9,1157
"199","부전제2동","부전제2동제2투","대통령선거","부산광역시","부산진구",1684,699,216,263,136,35,37,0,0,0,1,1,0,2,0,691,8,985
"200","부전제2동","부전제2동제3투","대통령선거","부산광역시","부산진구",2780,2187,793,677,434,185,87,5,0,0,0,0,0,1,3,2185,2,593
"201","연지동","관내사전투표","대통령선거","부산광역시","부산진구",3478,3478,1450,1115,490,245,155,3,0,1,0,1,1,2,0,3463,15,0
"202","연지동","연지동제1투","대통령선거","부산광역시","부산진구",2939,2403,1023,713,383,186,89,1,0,1,0,0,0,0,2,2398,5,536
"203","연지동","연지동제2투","대통령선거","부산광역시","부산진구",3256,2405,765,951,415,157,101,4,0,2,1,0,0,0,2,2398,7,851
"204","연지동","연지동제3투","대통령선거","부산광역시","부산진구",2822,1768,536,738,306,95,69,7,1,0,0,1,1,1,3,1758,10,1054
"205","연지동","연지동제4투","대통령선거","부산광역시","부산진구",2769,1953,666,716,313,149,96,2,0,1,1,1,0,2,1,1948,5,816
"206","연지동","연지동제5투","대통령선거","부산광역시","부산진구",2528,1916,697,701,329,109,70,2,0,1,0,0,0,1,0,1910,6,612
"207","초읍동","관내사전투표","대통령선거","부산광역시","부산진구",3083,3083,1216,1144,380,193,132,5,0,2,0,4,0,0,0,3076,7,0
"208","초읍동","초읍동제1투","대통령선거","부산광역시","부산진구",1601,1131,283,561,180,67,33,2,0,1,0,0,0,1,1,1129,2,470
"209","초읍동","초읍동제2투","대통령선거","부산광역시","부산진구",2754,2014,533,966,322,116,69,1,0,1,0,0,0,0,0,2008,6,740
"210","초읍동","초읍동제3투","대통령선거","부산광역시","부산진구",2930,1804,522,836,275,90,63,1,0,0,0,2,0,1,3,1793,11,1126
"211","초읍동","초읍동제4투","대통령선거","부산광역시","부산진구",2306,1598,545,610,259,103,68,0,0,4,0,2,0,1,1,1593,5,708
"212","초읍동","초읍동제5투","대통령선거","부산광역시","부산진구",2919,2051,734,745,332,124,102,5,0,0,0,1,0,0,2,2045,6,868
"213","초읍동","초읍동제6투","대통령선거","부산광역시","부산진구",2597,1865,583,758,303,120,82,3,0,0,1,1,1,0,4,1856,9,732
"214","양정제1동","관내사전투표","대통령선거","부산광역시","부산진구",3243,3243,1497,780,482,259,195,2,1,3,1,2,1,0,6,3229,14,0
"215","양정제1동","양정제1동제1투","대통령선거","부산광역시","부산진구",2294,1508,479,662,219,74,66,1,0,1,0,0,0,3,1,1506,2,786
"216","양정제1동","양정제1동제2투","대통령선거","부산광역시","부산진구",2867,2312,905,755,366,173,95,2,0,0,1,0,0,1,3,2301,11,555
"217","양정제1동","양정제1동제3투","대통령선거","부산광역시","부산진구",3428,2822,995,936,558,195,117,7,0,3,1,0,0,1,1,2814,8,606
"218","양정제1동","양정제1동제4투","대통령선거","부산광역시","부산진구",3165,2134,814,711,344,137,117,2,0,2,0,1,0,0,0,2128,6,1031
"219","양정제1동","양정제1동제5투","대통령선거","부산광역시","부산진구",2049,1444,430,607,226,88,74,2,0,1,0,1,1,1,1,1432,12,605
"220","양정제2동","관내사전투표","대통령선거","부산광역시","부산진구",1705,1705,689,597,244,86,71,4,0,1,0,1,1,1,1,1696,9,0
"221","양정제2동","양정제2동제1투","대통령선거","부산광역시","부산진구",3397,2252,896,696,342,183,119,1,0,0,0,1,0,1,2,2241,11,1145
"222","양정제2동","양정제2동제2투","대통령선거","부산광역시","부산진구",3119,1987,722,659,336,136,116,3,0,1,0,1,0,1,1,1976,11,1132
"223","양정제2동","양정제2동제3투","대통령선거","부산광역시","부산진구",2350,1459,462,589,236,101,59,2,0,2,1,1,0,0,0,1453,6,891
"224","양정제2동","양정제2동제4투","대통령선거","부산광역시","부산진구",1464,925,269,423,141,54,30,2,0,1,1,0,0,1,2,924,1,539
"225","전포제1동","관내사전투표","대통령선거","부산광역시","부산진구",2322,2322,1053,564,313,198,170,5,0,1,0,0,0,1,1,2306,16,0
"226","전포제1동","전포제1동제1투","대통령선거","부산광역시","부산진구",2668,1645,617,511,251,134,115,2,0,0,0,2,0,2,3,1637,8,1023
"227","전포제1동","전포제1동제2투","대통령선거","부산광역시","부산진구",2619,1633,475,713,259,96,79,0,0,2,0,1,0,0,2,1627,6,986
"228","전포제1동","전포제1동제3투","대통령선거","부산광역시","부산진구",3105,2057,878,434,409,181,141,4,0,0,0,0,0,1,0,2048,9,1048
"229","전포제1동","전포제1동제4투","대통령선거","부산광역시","부산진구",3320,1812,478,843,327,91,60,2,0,3,0,1,2,0,1,1808,4,1508
"230","전포제2동","관내사전투표","대통령선거","부산광역시","부산진구",2959,2959,1389,776,437,175,164,6,0,0,0,1,0,3,0,2951,8,0
"231","전포제2동","전포제2동제1투","대통령선거","부산광역시","부산진구",2559,1595,564,580,236,129,72,1,1,2,0,1,0,1,0,1587,8,964
"232","전포제2동","전포제2동제2투","대통령선거","부산광역시","부산진구",3202,2196,807,803,357,142,73,0,0,2,0,3,0,1,0,2188,8,1006
"233","전포제2동","전포제2동제3투","대통령선거","부산광역시","부산진구",2880,2071,693,805,334,134,83,2,3,0,0,3,0,0,2,2059,12,809
"234","전포제2동","전포제2동제4투","대통령선거","부산광역시","부산진구",2643,1774,518,754,312,107,72,1,0,2,0,0,1,2,0,1769,5,869
"235","전포제2동","전포제2동제5투","대통령선거","부산광역시","부산진구",3974,2804,1073,884,453,222,151,0,0,4,0,2,1,1,4,2795,9,1170
"236","부암제1동","관내사전투표","대통령선거","부산광역시","부산진구",2236,2236,1111,541,301,157,114,2,0,0,0,1,0,3,1,2231,5,0
"237","부암제1동","부암제1동제1투","대통령선거","부산광역시","부산진구",3888,2401,869,869,416,149,81,7,0,1,0,1,0,0,0,2393,8,1487
"238","부암제1동","부암제1동제2투","대통령선거","부산광역시","부산진구",3112,2103,716,799,377,126,66,3,1,0,0,3,1,2,1,2095,8,1009
"239","부암제1동","부암제1동제3투","대통령선거","부산광역시","부산진구",4054,3037,1211,968,510,213,112,5,0,0,0,0,2,2,1,3024,13,1017
"240","부암제1동","부암제1동제4투","대통령선거","부산광역시","부산진구",3367,2389,816,904,391,151,113,1,0,2,0,0,0,2,3,2383,6,978
"241","부암제3동","관내사전투표","대통령선거","부산광역시","부산진구",2662,2662,1275,686,378,171,132,4,0,1,0,4,3,3,1,2658,4,0
"242","부암제3동","부암제3동제1투","대통령선거","부산광역시","부산진구",2761,1625,558,593,290,99,69,2,0,2,0,1,1,0,2,1617,8,1136
"243","부암제3동","부암제3동제2투","대통령선거","부산광역시","부산진구",3274,2570,972,813,449,202,120,1,1,0,1,1,0,1,2,2563,7,704
"244","부암제3동","부암제3동제3투","대통령선거","부산광역시","부산진구",3054,2172,748,843,368,128,65,4,0,4,0,4,0,1,1,2166,6,882
"245","부암제3동","부암제3동제4투","대통령선거","부산광역시","부산진구",1868,1294,500,430,234,62,50,3,2,2,0,1,0,1,1,1286,8,574
"246","부암제3동","부암제3동제5투","대통령선거","부산광역시","부산진구",2917,2308,1133,471,402,181,110,4,0,0,0,1,0,1,1,2304,4,609
"247","당감제1동","관내사전투표","대통령선거","부산광역시","부산진구",2909,2909,1376,805,413,155,142,3,0,6,0,0,0,0,3,2903,6,0
"248","당감제1동","당감제1동제1투","대통령선거","부산광역시","부산진구",2950,1914,554,851,314,100,73,3,1,1,1,0,0,1,3,1902,12,1036
"249","당감제1동","당감제1동제2투","대통령선거","부산광역시","부산진구",3003,2187,803,822,324,131,87,5,0,0,0,0,0,3,3,2178,9,816
"250","당감제1동","당감제1동제3투","대통령선거","부산광역시","부산진구",2676,1665,512,683,306,87,69,0,0,1,0,0,0,0,0,1658,7,1011
"251","당감제1동","당감제1동제4투","대통령선거","부산광역시","부산진구",3912,2802,1116,841,509,177,135,4,0,1,0,3,0,2,3,2791,11,1110
"252","당감제1동","당감제1동제5투","대통령선거","부산광역시","부산진구",2389,1908,807,544,319,154,80,0,0,0,0,0,0,0,1,1905,3,481
"253","당감제1동","당감제1동제6투","대통령선거","부산광역시","부산진구",2715,2186,956,577,387,159,94,1,0,0,0,1,1,0,1,2177,9,529
"254","당감제2동","관내사전투표","대통령선거","부산광역시","부산진구",1657,1657,737,463,271,102,73,1,0,2,0,1,0,0,3,1653,4,0
"255","당감제2동","당감제2동제1투","대통령선거","부산광역시","부산진구",2412,1566,527,585,260,109,73,0,0,3,1,1,0,0,2,1561,5,846
"256","당감제2동","당감제2동제2투","대통령선거","부산광역시","부산진구",2231,1730,652,564,302,119,77,2,0,0,0,3,2,3,0,1724,6,501
"257","당감제2동","당감제2동제3투","대통령선거","부산광역시","부산진구",2345,1944,761,627,349,117,82,0,0,0,0,0,0,2,2,1940,4,401
"258","당감제4동","관내사전투표","대통령선거","부산광역시","부산진구",2650,2650,1292,640,389,171,140,1,1,1,1,0,1,2,2,2641,9,0
"259","당감제4동","당감제4동제1투","대통령선거","부산광역시","부산진구",2533,1568,550,600,281,66,56,8,1,0,0,0,1,1,0,1564,4,965
"260","당감제4동","당감제4동제2투","대통령선거","부산광역시","부산진구",2053,1330,466,516,203,93,45,1,0,1,0,0,1,0,1,1327,3,723
"261","당감제4동","당감제4동제3투","대통령선거","부산광역시","부산진구",3750,2805,1265,699,485,215,123,2,1,3,0,5,0,0,2,2800,5,945
"262","가야제1동","관내사전투표","대통령선거","부산광역시","부산진구",2889,2889,1312,783,416,185,164,4,0,1,1,3,1,1,3,2874,15,0
"263","가야제1동","가야제1동제1투","대통령선거","부산광역시","부산진구",2639,1736,523,722,299,108,70,2,1,1,1,0,1,1,3,1732,4,903
"264","가야제1동","가야제1동제2투","대통령선거","부산광역시","부산진구",2735,1702,598,577,304,109,96,3,0,0,0,0,0,0,4,1691,11,1033
"265","가야제1동","가야제1동제3투","대통령선거","부산광역시","부산진구",2761,1897,667,685,337,124,66,1,0,0,1,1,0,0,2,1884,13,864
"266","가야제1동","가야제1동제4투","대통령선거","부산광역시","부산진구",2201,1330,469,458,239,87,64,2,0,1,0,1,0,2,3,1326,4,871
"267","가야제1동","가야제1동제5투","대통령선거","부산광역시","부산진구",2567,1726,590,629,314,117,65,1,0,1,0,0,0,1,0,1718,8,841
"268","가야제1동","가야제1동제6투","대통령선거","부산광역시","부산진구",1861,1145,399,394,195,78,65,1,0,1,0,0,2,0,2,1137,8,716
"269","가야제2동","관내사전투표","대통령선거","부산광역시","부산진구",2558,2558,1134,799,335,170,109,0,0,2,0,3,0,2,1,2555,3,0
"270","가야제2동","가야제2동제1투","대통령선거","부산광역시","부산진구",3073,2096,708,824,335,129,86,1,0,0,1,0,0,1,3,2088,8,977
"271","가야제2동","가야제2동제2투","대통령선거","부산광역시","부산진구",3067,2193,771,764,394,142,111,2,0,0,0,2,0,0,3,2189,4,874
"272","가야제2동","가야제2동제3투","대통령선거","부산광역시","부산진구",2440,1691,535,666,290,102,72,0,0,7,0,3,0,2,4,1681,10,749
"273","가야제2동","가야제2동제4투","대통령선거","부산광역시","부산진구",3389,2578,839,970,445,211,97,2,0,1,1,1,0,3,1,2571,7,811
"274","개금제1동","관내사전투표","대통령선거","부산광역시","부산진구",2439,2439,1144,578,346,188,163,2,0,0,0,0,1,2,2,2426,13,0
"275","개금제1동","개금제1동제1투","대통령선거","부산광역시","부산진구",3999,2675,1052,800,452,219,137,2,0,5,1,3,0,1,0,2672,3,1324
"276","개금제1동","개금제1동제2투","대통령선거","부산광역시","부산진구",3182,2156,780,729,344,151,128,4,0,0,0,1,0,0,2,2139,17,1026
"277","개금제1동","개금제1동제3투","대통령선거","부산광역시","부산진구",2596,1707,577,623,306,110,75,0,0,0,1,0,0,3,2,1697,10,889
"278","개금제2동","관내사전투표","대통령선거","부산광역시","부산진구",1774,1774,771,501,254,137,100,2,0,0,1,0,0,0,1,1767,7,0
"279","개금제2동","개금제2동제1투","대통령선거","부산광역시","부산진구",2730,1752,595,609,298,119,115,4,0,0,0,1,2,2,1,1746,6,978
"280","개금제2동","개금제2동제2투","대통령선거","부산광역시","부산진구",2597,1724,531,714,286,99,77,1,0,0,1,1,0,1,5,1716,8,873
"281","개금제2동","개금제2동제3투","대통령선거","부산광역시","부산진구",2805,2190,801,729,381,168,98,1,0,1,1,0,1,2,2,2185,5,615
"282","개금제3동","관내사전투표","대통령선거","부산광역시","부산진구",3218,3218,1555,817,443,223,161,4,0,3,2,2,0,2,0,3212,6,0
"283","개금제3동","개금제3동제1투","대통령선거","부산광역시","부산진구",2364,1536,507,602,239,101,70,4,0,4,1,1,1,1,1,1532,4,828
"284","개금제3동","개금제3동제2투","대통령선거","부산광역시","부산진구",2511,1740,652,561,297,139,74,4,0,2,0,2,1,0,1,1733,7,771
"285","개금제3동","개금제3동제3투","대통령선거","부산광역시","부산진구",2817,2107,865,612,370,136,108,7,0,0,0,0,1,1,3,2103,4,710
"286","개금제3동","개금제3동제4투","대통령선거","부산광역시","부산진구",2952,2405,942,757,364,204,117,4,0,2,1,0,0,0,6,2397,8,547
"287","개금제3동","개금제3동제5투","대통령선거","부산광역시","부산진구",2325,1635,565,626,280,98,54,3,0,1,1,0,1,0,1,1630,5,690
"288","개금제3동","개금제3동제6투","대통령선거","부산광역시","부산진구",2672,1927,698,674,330,124,90,6,0,0,1,0,0,1,1,1925,2,745
"289","개금제3동","개금제3동제7투","대통령선거","부산광역시","부산진구",2655,2174,808,716,369,170,98,4,0,1,0,0,0,0,0,2166,8,481
"290","개금제3동","개금제3동제8투","대통령선거","부산광역시","부산진구",2477,1984,809,548,392,134,92,2,0,0,1,3,0,0,0,1981,3,493
"291","범천제1동","관내사전투표","대통령선거","부산광역시","부산진구",1893,1893,857,542,260,109,110,5,0,0,0,0,1,0,3,1887,6,0
"292","범천제1동","범천제1동제1투","대통령선거","부산광역시","부산진구",3655,2327,761,919,386,142,108,0,0,0,1,0,1,2,2,2322,5,1328
"293","범천제1동","범천제1동제2투","대통령선거","부산광역시","부산진구",3583,2198,780,752,393,151,110,2,0,2,0,0,1,0,0,2191,7,1385
"294","범천제2동","관내사전투표","대통령선거","부산광역시","부산진구",2302,2302,1003,647,396,131,104,4,0,4,0,2,1,2,3,2297,5,0
"295","범천제2동","범천제2동제1투","대통령선거","부산광역시","부산진구",3172,2288,853,694,458,157,114,3,0,1,0,0,0,0,2,2282,6,884
"296","범천제2동","범천제2동제2투","대통령선거","부산광역시","부산진구",2715,1534,453,587,325,91,66,1,1,2,1,1,0,0,1,1529,5,1181
"297","범천제2동","범천제2동제3투","대통령선거","부산광역시","부산진구",1840,1087,284,500,207,54,35,0,0,1,0,1,1,0,1,1084,3,753
"298","범천제2동","범천제2동제4투","대통령선거","부산광역시","부산진구",2654,1786,517,695,396,91,73,0,0,1,1,1,0,0,0,1775,11,868
"299","범천제2동","범천제2동제5투","대통령선거","부산광역시","부산진구",2157,1448,391,556,361,91,39,1,0,0,1,0,1,0,1,1442,6,709
"300","범천제2동","범천제2동제6투","대통령선거","부산광역시","부산진구",2069,1544,622,436,278,129,67,3,0,0,0,0,0,1,3,1539,5,525
"301","잘못 투입·구분된 투표지","잘못 투입·구분된 투표지","대통령선거","부산광역시","부산진구",0,2,0,2,0,0,0,0,0,0,0,0,0,0,0,2,0,-2
"302","거소·선상투표","거소·선상투표","대통령선거","부산광역시","동래구",579,538,188,121,151,38,23,0,0,0,0,1,1,1,0,524,14,41
"303","관외사전투표","관외사전투표","대통령선거","부산광역시","동래구",19378,19378,8810,4076,3206,1717,1359,23,8,6,4,15,5,7,26,19262,116,0
"304","재외투표","재외투표","대통령선거","부산광역시","동래구",1560,1243,767,80,193,65,129,5,0,0,0,0,0,0,1,1240,3,317
"305","수민동","관내사전투표","대통령선거","부산광역시","동래구",3241,3241,1475,787,536,261,164,3,0,2,1,1,1,0,2,3233,8,0
"306","수민동","수민동제1투","대통령선거","부산광역시","동래구",2867,1932,585,793,350,112,81,1,0,0,0,2,0,3,0,1927,5,935
"307","수민동","수민동제2투","대통령선거","부산광역시","동래구",3406,2689,994,853,519,199,118,2,0,0,1,0,0,0,0,2686,3,717
"308","수민동","수민동제3투","대통령선거","부산광역시","동래구",2728,1900,554,800,346,118,63,7,0,2,0,0,0,0,4,1894,6,828
"309","수민동","수민동제4투","대통령선거","부산광역시","동래구",3210,2237,818,743,367,171,115,6,0,1,0,1,1,6,1,2230,7,973
"310","수민동","수민동제5투","대통령선거","부산광역시","동래구",2219,1714,501,716,292,118,71,5,0,1,1,1,1,1,0,1708,6,505
"311","수민동","수민동제6투","대통령선거","부산광역시","동래구",2761,2207,808,636,401,219,129,3,0,2,0,0,0,0,1,2199,8,554
"312","수민동","수민동제7투","대통령선거","부산광역시","동래구",2810,2212,869,716,367,153,87,6,0,4,0,1,0,0,4,2207,5,598
"313","복산동","관내사전투표","대통령선거","부산광역시","동래구",2505,2505,960,870,384,158,116,3,0,0,0,2,0,0,3,2496,9,0
"314","복산동","복산동제1투","대통령선거","부산광역시","동래구",3100,2214,633,904,400,155,103,2,1,2,1,1,1,1,6,2210,4,886
"315","복산동","복산동제2투","대통령선거","부산광역시","동래구",2602,1762,495,804,286,102,59,3,1,3,1,0,0,0,1,1755,7,840
"316","복산동","복산동제3투","대통령선거","부산광역시","동래구",2121,1356,370,591,227,88,66,1,1,0,0,0,1,2,4,1351,5,765
"317","명륜동","관내사전투표","대통령선거","부산광역시","동래구",3213,3213,1517,788,456,256,183,1,0,0,0,0,1,3,2,3207,6,0
"318","명륜동","명륜동제1투","대통령선거","부산광역시","동래구",2286,1567,501,630,244,126,56,2,0,1,0,0,0,2,0,1562,5,719
"319","명륜동","명륜동제2투","대통령선거","부산광역시","동래구",2426,1921,800,517,376,139,81,1,0,0,1,0,1,0,1,1917,4,505
"320","명륜동","명륜동제3투","대통령선거","부산광역시","동래구",2795,2048,713,694,386,168,81,1,0,1,0,0,0,0,1,2045,3,747
"321","명륜동","명륜동제4투","대통령선거","부산광역시","동래구",2384,1670,540,699,265,98,53,2,0,3,0,2,0,1,3,1666,4,714
"322","명륜동","명륜동제5투","대통령선거","부산광역시","동래구",3547,3022,1444,670,504,259,131,3,0,0,0,0,0,2,2,3015,7,525
"323","온천제1동","관내사전투표","대통령선거","부산광역시","동래구",2340,2340,988,741,328,149,123,1,1,1,0,0,1,0,2,2335,5,0
"324","온천제1동","온천제1동제1투","대통령선거","부산광역시","동래구",3456,2060,544,964,347,115,80,0,1,0,0,2,0,0,1,2054,6,1396
"325","온천제1동","온천제1동제2투","대통령선거","부산광역시","동래구",3967,2590,779,1063,433,187,106,9,0,4,0,0,0,2,1,2584,6,1377
"326","온천제1동","온천제1동제3투","대통령선거","부산광역시","동래구",3815,2424,843,885,410,150,115,0,0,3,1,0,0,1,3,2411,13,1391
"327","온천제1동","온천제1동제4투","대통령선거","부산광역시","동래구",2897,1946,698,677,335,150,80,2,0,0,0,1,0,0,1,1944,2,951
"328","온천제2동","관내사전투표","대통령선거","부산광역시","동래구",3001,3001,1204,973,416,228,155,4,0,1,0,4,1,1,3,2990,11,0
"329","온천제2동","온천제2동제1투","대통령선거","부산광역시","동래구",1557,1098,343,455,178,62,57,1,0,0,0,0,0,0,0,1096,2,459
"330","온천제2동","온천제2동제2투","대통령선거","부산광역시","동래구",2496,1882,615,710,352,134,59,0,2,3,1,0,0,0,0,1876,6,614
"331","온천제2동","온천제2동제3투","대통령선거","부산광역시","동래구",2760,2088,537,964,365,143,66,5,0,1,0,0,0,0,3,2084,4,672
"332","온천제2동","온천제2동제4투","대통령선거","부산광역시","동래구",1574,1057,358,394,154,91,47,0,0,0,0,2,0,4,0,1050,7,517
"333","온천제2동","온천제2동제5투","대통령선거","부산광역시","동래구",730,492,149,192,85,32,30,1,0,0,1,0,0,0,1,491,1,238
"334","온천제2동","온천제2동제6투","대통령선거","부산광역시","동래구",1718,1176,343,499,216,65,45,2,0,0,0,0,0,0,3,1173,3,542
"335","온천제3동","관내사전투표","대통령선거","부산광역시","동래구",3548,3548,1556,1077,480,238,178,1,0,0,0,4,0,1,4,3539,9,0
"336","온천제3동","온천제3동제1투","대통령선거","부산광역시","동래구",3261,2461,954,744,427,209,109,5,0,2,0,0,0,0,4,2454,7,800
"337","온천제3동","온천제3동제2투","대통령선거","부산광역시","동래구",3423,2350,748,911,395,160,118,1,1,3,0,0,0,1,3,2341,9,1073
"338","온천제3동","온천제3동제3투","대통령선거","부산광역시","동래구",3515,2254,698,897,391,150,97,0,0,0,2,3,0,1,1,2240,14,1261
"339","온천제3동","온천제3동제4투","대통령선거","부산광역시","동래구",3343,2319,739,867,391,181,116,6,0,2,0,0,0,0,1,2303,16,1024
"340","온천제3동","온천제3동제5투","대통령선거","부산광역시","동래구",2736,1935,652,736,304,130,93,4,0,2,0,3,0,2,1,1927,8,801
"341","온천제3동","온천제3동제6투","대통령선거","부산광역시","동래구",3165,2335,845,858,363,166,87,2,1,0,0,3,0,2,3,2330,5,830
"342","온천제3동","온천제3동제7투","대통령선거","부산광역시","동래구",4046,3062,1125,968,567,244,138,4,1,0,0,1,1,2,3,3054,8,984
"343","사직제1동","관내사전투표","대통령선거","부산광역시","동래구",1683,1683,708,488,252,131,98,2,1,1,0,0,0,0,1,1682,1,0
"344","사직제1동","사직제1동제1투","대통령선거","부산광역시","동래구",2765,1988,653,793,309,128,84,4,2,0,0,2,0,1,3,1979,9,777
"345","사직제1동","사직제1동제2투","대통령선거","부산광역시","동래구",3546,2558,885,932,405,200,113,2,1,1,1,1,0,0,3,2544,14,988
"346","사직제2동","관내사전투표","대통령선거","부산광역시","동래구",4136,4136,2083,940,566,308,223,2,0,2,0,2,0,1,2,4129,7,0
"347","사직제2동","사직제2동제1투","대통령선거","부산광역시","동래구",2197,1731,684,510,318,142,74,1,0,0,0,0,0,0,0,1729,2,466
"348","사직제2동","사직제2동제2투","대통령선거","부산광역시","동래구",3377,2513,1114,598,469,203,113,1,0,1,0,0,0,0,6,2505,8,864
"349","사직제2동","사직제2동제3투","대통령선거","부산광역시","동래구",2476,1979,821,542,373,143,93,1,0,0,1,0,0,0,1,1975,4,497
"350","사직제2동","사직제2동제4투","대통령선거","부산광역시","동래구",2661,2143,899,595,358,181,104,0,0,0,0,1,0,0,1,2139,4,518
"351","사직제2동","사직제2동제5투","대통령선거","부산광역시","동래구",3187,2389,869,773,440,187,108,1,0,0,0,0,0,0,0,2378,11,798
"352","사직제2동","사직제2동제6투","대통령선거","부산광역시","동래구",2807,2334,1024,588,426,187,101,0,0,0,1,1,0,1,1,2330,4,473
"353","사직제3동","관내사전투표","대통령선거","부산광역시","동래구",1974,1974,857,566,326,116,97,0,0,0,1,0,0,0,2,1965,9,0
"354","사직제3동","사직제3동제1투","대통령선거","부산광역시","동래구",2282,1449,484,573,231,92,54,4,0,0,0,2,0,1,1,1442,7,833
"355","사직제3동","사직제3동제2투","대통령선거","부산광역시","동래구",2456,1919,821,540,334,148,72,0,0,0,0,1,0,0,1,1917,2,537
"356","사직제3동","사직제3동제3투","대통령선거","부산광역시","동래구",2557,1791,524,769,306,104,73,3,0,0,1,2,1,2,2,1787,4,766
"357","사직제3동","사직제3동제4투","대통령선거","부산광역시","동래구",2795,2055,630,859,347,120,84,1,0,1,0,1,1,0,4,2048,7,740
"358","안락제1동","관내사전투표","대통령선거","부산광역시","동래구",2391,2391,984,738,370,161,121,5,0,0,0,3,0,0,1,2383,8,0
"359","안락제1동","안락제1동제1투","대통령선거","부산광역시","동래구",2934,2198,647,930,371,155,78,1,0,1,1,0,0,2,2,2188,10,736
"360","안락제1동","안락제1동제2투","대통령선거","부산광역시","동래구",2687,2097,832,654,358,145,99,2,0,0,0,1,1,1,1,2094,3,590
"361","안락제1동","안락제1동제3투","대통령선거","부산광역시","동래구",2628,1628,437,734,271,110,55,2,0,4,0,1,0,0,5,1619,9,1000
"362","안락제1동","안락제1동제4투","대통령선거","부산광역시","동래구",2594,1753,497,796,287,84,73,1,0,3,1,1,0,0,2,1745,8,841
"363","안락제2동","관내사전투표","대통령선거","부산광역시","동래구",3224,3224,1441,888,492,207,181,5,0,0,0,0,1,0,0,3215,9,0
"364","안락제2동","안락제2동제1투","대통령선거","부산광역시","동래구",2159,1499,435,630,259,100,62,0,0,2,0,1,0,0,3,1492,7,660
"365","안락제2동","안락제2동제2투","대통령선거","부산광역시","동래구",3005,2013,637,744,377,138,99,1,1,1,0,1,0,2,0,2001,12,992
"366","안락제2동","안락제2동제3투","대통령선거","부산광역시","동래구",2488,1757,505,785,288,94,76,2,0,0,0,0,1,1,1,1753,4,731
"367","안락제2동","안락제2동제4투","대통령선거","부산광역시","동래구",3216,2384,912,727,445,182,104,2,0,0,0,1,1,0,2,2376,8,832
"368","안락제2동","안락제2동제5투","대통령선거","부산광역시","동래구",3545,2847,998,991,510,211,119,6,0,0,0,1,1,0,1,2838,9,698
"369","안락제2동","안락제2동제6투","대통령선거","부산광역시","동래구",2602,2079,796,606,374,187,105,1,0,1,0,0,1,0,1,2072,7,523
"370","안락제2동","안락제2동제7투","대통령선거","부산광역시","동래구",3360,2800,1233,695,484,218,157,5,0,0,0,0,1,0,0,2793,7,560
"371","명장제1동","관내사전투표","대통령선거","부산광역시","동래구",1564,1564,616,536,220,102,78,1,0,3,1,0,0,0,0,1557,7,0
"372","명장제1동","명장제1동제1투","대통령선거","부산광역시","동래구",2879,1844,527,778,302,134,86,3,0,2,1,0,0,2,2,1837,7,1035
"373","명장제1동","명장제1동제2투","대통령선거","부산광역시","동래구",2607,1887,594,815,272,110,83,2,1,1,0,2,0,2,1,1883,4,720
"374","명장제1동","명장제1동제3투","대통령선거","부산광역시","동래구",2805,1968,640,786,315,112,99,3,0,1,0,2,0,0,4,1962,6,837
"375","명장제1동","명장제1동제4투","대통령선거","부산광역시","동래구",1002,725,183,336,115,50,34,0,0,2,0,0,0,1,2,723,2,277
"376","명장제2동","관내사전투표","대통령선거","부산광역시","동래구",1939,1939,775,607,305,140,100,1,0,0,0,1,2,0,3,1934,5,0
"377","명장제2동","명장제2동제1투","대통령선거","부산광역시","동래구",3133,2213,732,838,367,161,95,2,0,1,1,0,2,0,1,2200,13,920
"378","명장제2동","명장제2동제2투","대통령선거","부산광역시","동래구",2420,1706,556,640,279,123,97,0,0,1,0,1,0,1,4,1702,4,714
"379","명장제2동","명장제2동제3투","대통령선거","부산광역시","동래구",2466,1697,498,709,265,127,82,1,1,2,0,1,2,1,4,1693,4,769
"380","명장제2동","명장제2동제4투","대통령선거","부산광역시","동래구",1831,1256,356,524,229,66,71,0,0,1,1,0,1,0,1,1250,6,575
"381","잘못 투입·구분된 투표지","잘못 투입·구분된 투표지","대통령선거","부산광역시","동래구",0,0,0,0,0,0,0,0,0,0,0,0,0,0,0,0,0,0
"382","거소·선상투표","거소·선상투표","대통령선거","부산광역시","남구",704,647,238,136,182,37,28,4,0,0,0,1,1,0,5,632,15,57
"383","관외사전투표","관외사전투표","대통령선거","부산광역시","남구",18368,18355,8085,3972,3152,1689,1246,21,3,4,6,9,4,10,33,18234,121,13
"384","재외투표","재외투표","대통령선거","부산광역시","남구",1565,1254,763,97,173,64,150,2,0,0,0,0,0,0,0,1249,5,311
"385","대연제1동","관내사전투표","대통령선거","부산광역시","남구",2690,2690,1213,647,442,182,182,3,1,5,0,2,0,1,3,2681,9,0
"386","대연제1동","대연제1동제1투","대통령선거","부산광역시","남구",3298,2202,753,730,363,195,143,4,1,0,0,0,0,0,3,2192,10,1096
"387","대연제1동","대연제1동제2투","대통령선거","부산광역시","남구",3534,2468,884,799,428,187,147,4,1,3,0,1,0,0,4,2458,10,1066
"388","대연제1동","대연제1동제3투","대통령선거","부산광역시","남구",3288,2108,693,755,371,176,95,1,0,0,0,1,0,3,3,2098,10,1180
"389","대연제1동","대연제1동제4투","대통령선거","부산광역시","남구",1882,1254,390,532,203,73,42,5,0,1,0,0,0,1,2,1249,5,628
"390","대연제1동","대연제1동제5투","대통령선거","부산광역시","남구",2302,1596,470,695,268,93,57,4,0,1,0,0,0,0,0,1588,8,706
"391","대연제3동","관내사전투표","대통령선거","부산광역시","남구",4747,4747,2424,813,652,485,347,3,0,0,0,1,0,2,2,4729,18,0
"392","대연제3동","대연제3동제1투","대통령선거","부산광역시","남구",2377,1723,615,481,310,188,107,4,1,2,0,1,0,0,1,1710,13,654
"393","대연제3동","대연제3동제2투","대통령선거","부산광역시","남구",3216,2365,897,739,444,181,89,1,0,1,1,2,1,0,3,2359,6,851
"394","대연제3동","대연제3동제3투","대통령선거","부산광역시","남구",2169,1275,511,351,202,108,89,6,0,1,0,0,0,0,2,1270,5,894
"395","대연제3동","대연제3동제4투","대통령선거","부산광역시","남구",2328,1702,621,556,292,133,89,3,0,0,1,0,0,1,1,1697,5,626
"396","대연제3동","대연제3동제5투","대통령선거","부산광역시","남구",2665,1938,648,649,352,170,101,3,0,1,0,3,0,2,0,1929,9,727
"397","대연제3동","대연제3동제6투","대통령선거","부산광역시","남구",2929,2304,889,696,425,181,103,3,0,1,0,0,0,1,3,2302,2,625
"398","대연제3동","대연제3동제7투","대통령선거","부산광역시","남구",2868,2276,1084,528,391,164,103,1,0,2,0,0,0,0,0,2273,3,592
"399","대연제3동","대연제3동제8투","대통령선거","부산광역시","남구",2100,1527,709,315,305,131,61,2,0,0,1,0,0,1,1,1526,1,573
"400","대연제4동","관내사전투표","대통령선거","부산광역시","남구",1652,1652,667,605,213,106,52,0,0,1,1,1,1,1,1,1649,3,0
"401","대연제4동","대연제4동제1투","대통령선거","부산광역시","남구",2375,1695,562,670,290,98,58,2,1,2,0,1,0,1,4,1689,6,680
"402","대연제4동","대연제4동제2투","대통령선거","부산광역시","남구",1591,978,321,386,177,48,31,1,0,1,1,0,2,3,1,972,6,613
"403","대연제4동","대연제4동제3투","대통령선거","부산광역시","남구",1751,1190,371,515,184,66,44,0,0,0,0,1,0,2,1,1184,6,561
"404","대연제4동","대연제4동제4투","대통령선거","부산광역시","남구",1544,1120,377,447,189,54,44,1,0,0,0,0,0,1,1,1114,6,424
"405","대연제5동","관내사전투표","대통령선거","부산광역시","남구",2259,2259,859,786,328,143,123,4,0,1,0,3,1,0,2,2250,9,0
"406","대연제5동","대연제5동제1투","대통령선거","부산광역시","남구",3190,2289,764,839,416,164,84,4,1,3,1,0,0,1,4,2281,8,901
"407","대연제5동","대연제5동제2투","대통령선거","부산광역시","남구",3283,2232,750,851,383,153,80,5,0,1,1,0,0,0,2,2226,6,1051
"408","대연제5동","대연제5동제3투","대통령선거","부산광역시","남구",2565,1808,740,539,298,131,93,1,0,0,0,0,0,0,1,1803,5,757
"409","대연제6동","관내사전투표","대통령선거","부산광역시","남구",2629,2629,1169,734,384,184,142,1,0,1,0,0,0,0,4,2619,10,0
"410","대연제6동","대연제6동제1투","대통령선거","부산광역시","남구",2647,1832,566,726,333,113,85,2,0,0,0,0,0,1,0,1826,6,815
"411","대연제6동","대연제6동제2투","대통령선거","부산광역시","남구",2168,1556,535,563,278,105,67,1,0,3,0,0,0,1,1,1554,2,612
"412","용호제1동","관내사전투표","대통령선거","부산광역시","남구",3045,3045,1194,1032,470,196,126,6,1,1,4,0,0,2,1,3033,12,0
"413","용호제1동","용호제1동제1투","대통령선거","부산광역시","남구",1976,1217,357,501,218,73,53,4,0,0,0,0,0,0,2,1208,9,759
"414","용호제1동","용호제1동제2투","대통령선거","부산광역시","남구",2020,1149,395,482,152,59,51,4,0,0,0,0,0,0,2,1145,4,871
"415","용호제1동","용호제1동제3투","대통령선거","부산광역시","남구",2198,1435,448,611,227,80,60,0,0,0,0,0,0,1,3,1430,5,763
"416","용호제1동","용호제1동제4투","대통령선거","부산광역시","남구",1670,1092,343,437,186,70,45,3,0,0,1,0,0,1,1,1087,5,578
"417","용호제1동","용호제1동제5투","대통령선거","부산광역시","남구",3346,2623,1117,685,473,190,144,2,1,1,0,1,1,0,3,2618,5,723
"418","용호제1동","용호제1동제6투","대통령선거","부산광역시","남구",3526,2861,1030,884,603,221,109,3,0,0,1,0,0,1,2,2854,7,665
"419","용호제1동","용호제1동제7투","대통령선거","부산광역시","남구",3439,2693,931,922,521,211,101,1,0,0,0,0,0,0,1,2688,5,746
"420","용호제1동","용호제1동제8투","대통령선거","부산광역시","남구",3574,2855,900,1016,582,251,97,3,0,1,0,0,0,1,1,2852,3,719
"421","용호제1동","용호제1동제9투","대통령선거","부산광역시","남구",2475,1986,809,565,353,171,78,3,0,1,0,2,0,0,2,1984,2,489
"422","용호제1동","용호제1동제10투","대통령선거","부산광역시","남구",2215,1879,580,636,419,183,53,0,0,0,0,0,0,0,2,1873,6,336
"423","용호제2동","관내사전투표","대통령선거","부산광역시","남구",2138,2138,788,772,342,119,101,2,0,1,0,0,0,1,2,2128,10,0
"424","용호제2동","용호제2동제1투","대통령선거","부산광역시","남구",2039,1324,418,508,236,95,57,2,0,1,0,2,0,0,0,1319,5,715
"425","용호제2동","용호제2동제2투","대통령선거","부산광역시","남구",1876,1211,326,545,213,59,63,0,0,1,0,0,1,0,0,1208,3,665
"426","용호제2동","용호제2동제3투","대통령선거","부산광역시","남구",2885,2015,702,719,354,140,87,1,1,0,0,0,0,3,0,2007,8,870
"427","용호제2동","용호제2동제4투","대통령선거","부산광역시","남구",2260,1749,655,548,334,144,62,1,0,0,0,1,1,0,1,1747,2,511
"428","용호제2동","용호제2동제5투","대통령선거","부산광역시","남구",3126,2376,860,756,479,186,85,5,0,0,0,0,0,1,0,2372,4,750
"429","용호제3동","관내사전투표","대통령선거","부산광역시","남구",3594,3594,1567,1001,589,233,179,3,1,3,2,1,1,3,1,3584,10,0
"430","용호제3동","용호제3동제1투","대통령선거","부산광역시","남구",2446,1734,564,655,305,117,79,1,0,1,0,1,0,1,1,1725,9,712
"431","용호제3동","용호제3동제2투","대통령선거","부산광역시","남구",2151,1427,440,561,269,89,52,4,0,0,1,2,0,1,2,1421,6,724
"432","용호제3동","용호제3동제3투","대통령선거","부산광역시","남구",2329,1643,508,697,266,83,73,2,1,0,1,0,0,1,1,1633,10,686
"433","용호제3동","용호제3동제4투","대통령선거","부산광역시","남구",2466,1799,613,664,320,112,76,2,0,4,0,1,0,0,0,1792,7,667
"434","용호제4동","관내사전투표","대통령선거","부산광역시","남구",2211,2211,920,640,352,161,119,6,0,2,0,3,0,1,0,2204,7,0
"435","용호제4동","용호제4동제1투","대통령선거","부산광역시","남구",2973,2053,824,616,372,144,89,0,0,0,0,0,0,0,2,2047,6,920
"436","용호제4동","용호제4동제2투","대통령선거","부산광역시","남구",2809,1900,659,720,307,113,93,1,1,0,0,0,1,1,1,1897,3,909
"437","용당동","관내사전투표","대통령선거","부산광역시","남구",787,787,404,180,109,45,43,2,1,0,0,0,0,1,0,785,2,0
"438","용당동","용당동제1투","대통령선거","부산광역시","남구",1474,954,288,458,123,37,36,1,0,2,0,0,1,1,1,948,6,520
"439","용당동","용당동제2투","대통령선거","부산광역시","남구",1775,1339,490,432,236,111,65,0,0,0,0,0,0,0,0,1334,5,436
"440","용당동","용당동제3투","대통령선거","부산광역시","남구",2598,2022,758,670,340,149,92,5,0,0,0,2,1,3,0,2020,2,576
"441","감만제1동","관내사전투표","대통령선거","부산광역시","남구",2111,2110,890,659,302,143,94,2,1,2,0,1,0,1,2,2097,13,1
"442","감만제1동","감만제1동제1투","대통령선거","부산광역시","남구",1631,938,290,364,166,54,55,2,1,0,1,0,0,0,2,935,3,693
"443","감만제1동","감만제1동제2투","대통령선거","부산광역시","남구",2271,1552,536,493,310,112,91,1,0,0,0,0,0,1,3,1547,5,719
"444","감만제1동","감만제1동제3투","대통령선거","부산광역시","남구",1776,1136,319,529,177,58,41,2,0,0,0,0,0,3,1,1130,6,640
"445","감만제1동","감만제1동제4투","대통령선거","부산광역시","남구",2119,1443,485,522,268,92,69,0,0,0,2,0,0,0,0,1438,5,676
"446","감만제1동","감만제1동제5투","대통령선거","부산광역시","남구",2735,2123,826,655,354,173,102,1,1,3,0,2,0,2,2,2121,2,612
"447","감만제2동","관내사전투표","대통령선거","부산광역시","남구",1469,1469,633,446,208,101,70,2,0,0,0,1,1,0,1,1463,6,0
"448","감만제2동","감만제2동제1투","대통령선거","부산광역시","남구",2471,1648,503,659,305,90,72,2,0,2,0,2,0,3,1,1639,9,823
"449","감만제2동","감만제2동제2투","대통령선거","부산광역시","남구",2551,1774,595,628,352,115,74,0,0,1,0,0,0,0,2,1767,7,777
"450","문현제1동","관내사전투표","대통령선거","부산광역시","남구",2104,2104,918,633,291,152,93,1,0,2,0,1,0,1,2,2094,10,0
"451","문현제1동","문현제1동제1투","대통령선거","부산광역시","남구",3172,2131,750,783,331,147,99,3,0,3,0,0,0,0,4,2120,11,1041
"452","문현제1동","문현제1동제2투","대통령선거","부산광역시","남구",2447,1739,612,607,302,129,69,0,0,6,0,3,3,1,1,1733,6,708
"453","문현제1동","문현제1동제3투","대통령선거","부산광역시","남구",2832,1951,694,656,354,126,97,8,1,5,0,2,0,1,2,1946,5,881
"454","문현제1동","문현제1동제4투","대통령선거","부산광역시","남구",1835,1141,362,470,197,51,47,4,0,2,0,2,1,0,0,1136,5,694
"455","문현제2동","관내사전투표","대통령선거","부산광역시","남구",1174,1174,467,435,160,58,40,0,1,0,0,0,0,0,5,1166,8,0
"456","문현제2동","문현제2동제1투","대통령선거","부산광역시","남구",2067,1219,386,525,186,55,53,1,0,1,0,1,0,3,0,1211,8,848
"457","문현제2동","문현제2동제2투","대통령선거","부산광역시","남구",1428,836,263,357,129,47,33,1,0,0,0,0,1,0,1,832,4,592
"458","문현제2동","문현제2동제3투","대통령선거","부산광역시","남구",2364,1589,525,632,269,91,63,2,1,0,0,0,0,1,0,1584,5,775
"459","문현제3동","관내사전투표","대통령선거","부산광역시","남구",1722,1722,745,491,273,103,99,2,0,0,0,0,0,2,1,1716,6,0
"460","문현제3동","문현제3동제1투","대통령선거","부산광역시","남구",2324,1594,486,658,260,94,75,3,1,0,0,1,2,5,1,1586,8,730
"461","문현제3동","문현제3동제2투","대통령선거","부산광역시","남구",2521,1694,514,690,281,123,67,1,0,2,1,0,0,1,1,1681,13,827
"462","문현제3동","문현제3동제3투","대통령선거","부산광역시","남구",3565,2829,1093,846,519,242,110,4,0,1,2,0,0,3,1,2821,8,736
"463","문현제4동","관내사전투표","대통령선거","부산광역시","남구",1749,1749,789,512,245,113,82,0,0,2,0,2,0,0,1,1746,3,0
"464","문현제4동","문현제4동제1투","대통령선거","부산광역시","남구",2477,1773,577,772,252,82,75,2,0,2,0,0,0,0,2,1764,9,704
"465","문현제4동","문현제4동제2투","대통령선거","부산광역시","남구",2853,1981,692,693,350,128,103,3,0,1,0,1,0,0,3,1974,7,872
"466","문현제4동","문현제4동제3투","대통령선거","부산광역시","남구",1843,1176,404,465,195,58,48,1,0,2,1,1,0,0,0,1175,1,667
"467","우암동","관내사전투표","대통령선거","부산광역시","남구",1162,1162,515,350,145,79,64,1,1,1,0,0,0,1,0,1157,5,0
"468","우암동","우암동제1투","대통령선거","부산광역시","남구",2156,1581,600,526,285,108,50,2,0,0,0,0,1,2,2,1576,5,575
"469","우암동","우암동제2투","대통령선거","부산광역시","남구",2773,2238,860,765,367,146,80,4,0,0,1,0,1,0,3,2227,11,535
"470","우암동","우암동제3투","대통령선거","부산광역시","남구",1680,972,291,448,140,46,34,1,0,1,0,1,0,0,3,965,7,708
"471","우암동","우암동제4투","대통령선거","부산광역시","남구",2908,2245,786,771,411,153,102,6,0,1,1,5,0,1,1,2238,7,663
"472","우암동","우암동제5투","대통령선거","부산광역시","남구",1819,1242,371,533,199,70,48,1,2,2,0,2,1,2,3,1234,8,577
"473","우암동","우암동제6투","대통령선거","부산광역시","남구",1624,1104,333,499,182,46,31,0,1,2,0,0,1,1,3,1099,5,520
"474","잘못 투입·구분된 투표지","잘못 투입·구분된 투표지","대통령선거","부산광역시","남구",0,1,0,0,0,0,0,0,0,0,0,1,0,0,0,1,0,-1
"475","거소·선상투표","거소·선상투표","대통령선거","부산광역시","북구",711,650,242,122,175,44,24,6,1,2,1,1,0,3,2,623,27,61
"476","관외사전투표","관외사전투표","대통령선거","부산광역시","북구",20156,20146,9622,3975,3215,1798,1272,13,3,7,8,14,7,7,36,19977,169,10
"477","재외투표","재외투표","대통령선거","부산광역시","북구",1251,941,573,71,139,46,105,2,0,1,0,0,0,0,0,937,4,310
"478","구포제1동","관내사전투표","대통령선거","부산광역시","북구",2612,2612,1102,838,382,144,116,2,1,2,0,1,1,1,3,2593,19,0
"479","구포제1동","구포제1동제1투","대통령선거","부산광역시","북구",3549,2395,851,883,375,175,100,0,0,1,1,1,2,0,2,2391,4,1154
"480","구포제1동","구포제1동제2투","대통령선거","부산광역시","북구",2155,1202,398,492,199,51,55,0,0,1,0,0,0,1,2,1199,3,953
"481","구포제1동","구포제1동제3투","대통령선거","부산광역시","북구",2383,1507,491,651,201,83,55,1,0,1,0,4,0,1,3,1491,16,876
"482","구포제1동","구포제1동제4투","대통령선거","부산광역시","북구",2540,1633,575,524,293,119,92,4,0,1,0,3,0,1,10,1622,11,907
"483","구포제2동","관내사전투표","대통령선거","부산광역시","북구",2417,2417,1123,689,336,133,111,2,0,1,0,2,0,1,1,2399,18,0
"484","구포제2동","구포제2동제1투","대통령선거","부산광역시","북구",2718,1805,604,682,293,117,88,0,1,2,1,0,0,2,5,1795,10,913
"485","구포제2동","구포제2동제2투","대통령선거","부산광역시","북구",2951,1582,564,601,253,92,54,0,1,1,0,1,1,2,2,1572,10,1369
"486","구포제2동","구포제2동제3투","대통령선거","부산광역시","북구",3290,2321,910,751,368,171,100,2,2,1,0,0,1,1,2,2309,12,969
"487","구포제2동","구포제2동제4투","대통령선거","부산광역시","북구",3094,2097,757,756,331,131,94,4,0,1,0,0,1,2,4,2081,16,997
"488","구포제2동","구포제2동제5투","대통령선거","부산광역시","북구",3436,2742,1071,910,441,172,131,1,0,1,1,0,1,1,5,2735,7,694
"489","구포제2동","구포제2동제6투","대통령선거","부산광역시","북구",1458,882,294,350,141,45,38,1,0,2,1,0,0,1,3,876,6,576
"490","구포제2동","구포제2동제7투","대통령선거","부산광역시","북구",2365,1865,838,463,279,161,115,1,0,2,0,0,0,0,1,1860,5,500
"491","구포제3동","관내사전투표","대통령선거","부산광역시","북구",3049,3049,1384,889,390,185,182,1,1,3,0,1,0,3,1,3040,9,0
"492","구포제3동","구포제3동제1투","대통령선거","부산광역시","북구",2517,1551,538,582,254,92,73,0,0,2,1,0,0,1,2,1545,6,966
"493","구포제3동","구포제3동제2투","대통령선거","부산광역시","북구",2367,1414,490,489,267,92,67,0,0,0,1,0,0,1,2,1409,5,953
"494","구포제3동","구포제3동제3투","대통령선거","부산광역시","북구",2719,1640,584,558,295,117,74,1,1,1,1,2,0,0,1,1635,5,1079
"495","구포제3동","구포제3동제4투","대통령선거","부산광역시","북구",2640,1831,698,574,313,116,114,6,0,0,0,2,0,0,2,1825,6,809
"496","구포제3동","구포제3동제5투","대통령선거","부산광역시","북구",2300,1428,543,493,223,91,65,3,0,1,1,0,0,0,3,1423,5,872
"497","구포제3동","구포제3동제6투","대통령선거","부산광역시","북구",2840,1767,647,592,290,110,106,4,0,0,0,0,0,1,6,1756,11,1073
"498","덕천제1동","관내사전투표","대통령선거","부산광역시","북구",1944,1944,807,628,277,112,98,3,0,2,2,0,1,2,2,1934,10,0
"499","덕천제1동","덕천제1동제1투","대통령선거","부산광역시","북구",3208,2428,832,886,425,153,108,1,0,1,1,2,0,1,5,2415,13,780
"500","덕천제1동","덕천제1동제2투","대통령선거","부산광역시","북구",2669,1692,563,657,273,102,87,0,0,0,0,0,0,0,1,1683,9,977
"501","덕천제1동","덕천제1동제3투","대통령선거","부산광역시","북구",2100,1362,484,474,232,78,74,0,0,0,0,2,0,1,4,1349,13,738
"502","덕천제1동","덕천제1동제4투","대통령선거","부산광역시","북구",3076,2040,676,802,328,118,90,4,1,2,1,3,0,4,2,2031,9,1036
"503","덕천제2동","관내사전투표","대통령선거","부산광역시","북구",2148,2148,995,539,274,159,161,1,0,2,1,3,0,0,1,2136,12,0
"504","덕천제2동","덕천제2동제1투","대통령선거","부산광역시","북구",2175,1360,436,565,208,81,60,2,1,2,0,0,2,0,1,1358,2,815
"505","덕천제2동","덕천제2동제2투","대통령선거","부산광역시","북구",2207,1376,499,517,217,74,63,1,0,1,0,2,0,0,1,1375,1,831
"506","덕천제2동","덕천제2동제3투","대통령선거","부산광역시","북구",2505,1732,695,553,266,114,91,0,0,1,1,0,1,4,0,1726,6,773
"507","덕천제2동","덕천제2동제4투","대통령선거","부산광역시","북구",2205,1464,470,581,240,102,61,2,0,0,0,0,0,0,3,1459,5,741
"508","덕천제3동","관내사전투표","대통령선거","부산광역시","북구",1740,1740,769,500,248,115,90,2,0,2,1,1,0,1,1,1730,10,0
"509","덕천제3동","덕천제3동제1투","대통령선거","부산광역시","북구",1564,1133,473,314,214,74,52,0,0,1,0,0,0,0,1,1129,4,431
"510","덕천제3동","덕천제3동제2투","대통령선거","부산광역시","북구",2523,1640,517,635,289,102,80,3,0,1,0,2,0,0,5,1634,6,883
"511","덕천제3동","덕천제3동제3투","대통령선거","부산광역시","북구",2229,1450,459,560,236,91,87,2,0,2,0,1,1,1,2,1442,8,779
"512","덕천제3동","덕천제3동제4투","대통령선거","부산광역시","북구",2041,1171,314,488,248,64,35,1,0,5,0,0,0,3,3,1161,10,870
"513","만덕제1동","관내사전투표","대통령선거","부산광역시","북구",1622,1622,710,540,220,86,53,1,0,2,0,2,1,0,0,1615,7,0
"514","만덕제1동","만덕제1동제1투","대통령선거","부산광역시","북구",1886,1281,467,478,192,84,49,1,0,0,0,0,1,1,1,1274,7,605
"515","만덕제1동","만덕제1동제2투","대통령선거","부산광역시","북구",2316,1701,581,660,273,116,59,0,0,0,0,0,1,1,0,1691,10,615
"516","만덕제1동","만덕제1동제3투","대통령선거","부산광역시","북구",2169,1607,569,581,250,125,66,3,0,1,0,1,1,2,5,1604,3,562
"517","만덕제2동","관내사전투표","대통령선거","부산광역시","북구",4438,4437,2082,1217,593,297,217,3,2,4,0,1,0,1,2,4419,18,1
"518","만덕제2동","만덕제2동제1투","대통령선거","부산광역시","북구",1933,1323,424,522,236,78,53,0,0,0,0,1,0,2,2,1318,5,610
"519","만덕제2동","만덕제2동제2투","대통령선거","부산광역시","북구",1832,1169,396,455,193,67,52,3,1,0,0,0,0,0,0,1167,2,663
"520","만덕제2동","만덕제2동제3투","대통령선거","부산광역시","북구",2573,1738,613,691,240,105,76,0,0,1,0,0,0,0,3,1729,9,835
"521","만덕제2동","만덕제2동제4투","대통령선거","부산광역시","북구",2063,1437,479,543,229,109,70,1,0,1,0,0,0,0,1,1433,4,626
"522","만덕제2동","만덕제2동제5투","대통령선거","부산광역시","북구",1580,1268,606,281,213,87,69,6,0,0,0,0,0,0,0,1262,6,312
"523","만덕제2동","만덕제2동제6투","대통령선거","부산광역시","북구",2666,1917,801,487,358,169,91,1,0,1,0,0,0,0,3,1911,6,749
"524","만덕제2동","만덕제2동제7투","대통령선거","부산광역시","북구",3308,2588,1234,545,464,197,138,2,0,1,0,1,0,0,2,2584,4,720
"525","만덕제2동","만덕제2동제8투","대통령선거","부산광역시","북구",2445,1865,679,641,305,133,91,5,0,3,0,0,1,0,1,1859,6,580
"526","만덕제3동","관내사전투표","대통령선거","부산광역시","북구",3100,3100,1442,846,428,233,138,2,0,0,0,1,0,0,1,3091,9,0
"527","만덕제3동","만덕제3동제1투","대통령선거","부산광역시","북구",2323,1703,637,585,292,125,57,2,0,0,0,0,0,0,2,1700,3,620
"528","만덕제3동","만덕제3동제2투","대통령선거","부산광역시","북구",2777,2139,819,764,329,127,91,2,0,2,0,0,1,0,1,2136,3,638
"529","만덕제3동","만덕제3동제3투","대통령선거","부산광역시","북구",2054,1360,527,433,211,104,77,2,0,0,0,1,0,0,0,1355,5,694
"530","만덕제3동","만덕제3동제4투","대통령선거","부산광역시","북구",3066,2424,941,716,438,188,122,3,0,1,1,0,0,1,2,2413,11,642
"531","만덕제3동","만덕제3동제5투","대통령선거","부산광역시","북구",2869,2150,704,825,385,157,70,1,0,1,0,0,0,0,0,2143,7,719
"532","금곡동","관내사전투표","대통령선거","부산광역시","북구",3865,3865,1862,959,576,280,163,9,0,3,0,1,1,2,4,3860,5,0
"533","금곡동","금곡동제1투","대통령선거","부산광역시","북구",2395,1805,553,778,279,106,65,4,0,0,1,0,2,3,4,1795,10,590
"534","금곡동","금곡동제2투","대통령선거","부산광역시","북구",2241,1632,593,561,290,116,54,3,0,2,1,3,1,0,4,1628,4,609
"535","금곡동","금곡동제3투","대통령선거","부산광역시","북구",2062,1506,532,580,239,85,52,2,0,4,1,0,1,1,0,1497,9,556
"536","금곡동","금곡동제4투","대통령선거","부산광역시","북구",2150,1715,664,547,273,130,88,2,0,2,1,0,0,0,4,1711,4,435
"537","금곡동","금곡동제5투","대통령선거","부산광역시","북구",1650,1137,267,553,212,46,23,4,2,2,2,2,2,1,8,1124,13,513
"538","금곡동","금곡동제6투","대통령선거","부산광역시","북구",1803,1280,456,414,250,79,65,3,0,1,0,0,0,2,3,1273,7,523
"539","금곡동","금곡동제7투","대통령선거","부산광역시","북구",2404,1703,684,524,280,123,85,0,1,0,0,0,0,3,0,1700,3,701
"540","금곡동","금곡동제8투","대통령선거","부산광역시","북구",2353,1618,444,694,317,79,45,2,1,4,1,2,0,2,4,1595,23,735
"541","금곡동","금곡동제9투","대통령선거","부산광역시","북구",3008,2346,997,661,382,185,103,1,0,0,0,1,1,0,5,2336,10,662
"542","금곡동","금곡동제10투","대통령선거","부산광역시","북구",2124,1491,641,380,271,118,65,2,0,3,1,0,0,0,2,1483,8,633
"543","금곡동","금곡동제11투","대통령선거","부산광역시","북구",3475,2825,1280,730,439,215,140,0,0,1,0,2,0,3,3,2813,12,650
"544","금곡동","금곡동제12투","대통령선거","부산광역시","북구",3364,2739,1247,729,419,195,136,3,0,1,0,0,1,1,1,2733,6,625
"545","화명제1동","관내사전투표","대통령선거","부산광역시","북구",3789,3787,1973,814,449,327,203,6,0,1,1,1,0,1,2,3778,9,2
"546","화명제1동","화명제1동제1투","대통령선거","부산광역시","북구",3100,2451,1118,631,385,185,119,2,0,1,1,0,0,2,3,2447,4,649
"547","화명제1동","화명제1동제2투","대통령선거","부산광역시","북구",3662,2966,1314,798,471,226,141,0,0,5,1,0,0,0,2,2958,8,696
"548","화명제1동","화명제1동제3투","대통령선거","부산광역시","북구",2312,1772,773,494,256,128,106,2,0,0,0,1,1,2,0,1763,9,540
"549","화명제1동","화명제1동제4투","대통령선거","부산광역시","북구",2117,1683,735,432,317,129,67,0,0,0,0,1,0,0,2,1683,0,434
"550","화명제1동","화명제1동제5투","대통령선거","부산광역시","북구",3768,3144,1340,854,515,275,144,3,2,1,0,1,1,2,0,3138,6,624
"551","화명제1동","화명제1동제6투","대통령선거","부산광역시","북구",3311,2738,1049,873,504,201,95,4,0,0,2,0,0,1,2,2731,7,573
"552","화명제1동","화명제1동제7투","대통령선거","부산광역시","북구",3214,2679,1130,753,486,208,95,1,0,0,0,0,1,1,1,2676,3,535
"553","화명제1동","화명제1동제8투","대통령선거","부산광역시","북구",3262,2565,1018,824,427,190,95,2,0,0,0,0,0,1,1,2558,7,697
"554","화명제1동","화명제1동제9투","대통령선거","부산광역시","북구",1983,1577,680,397,301,115,74,2,0,0,0,2,0,0,1,1572,5,406
"555","화명제1동","화명제1동제10투","대통령선거","부산광역시","북구",1246,999,417,265,176,81,54,3,0,0,0,0,0,0,1,997,2,247
"556","화명제2동","관내사전투표","대통령선거","부산광역시","북구",2827,2827,1370,697,372,214,152,3,1,2,2,1,0,2,2,2818,9,0
"557","화명제2동","화명제2동제1투","대통령선거","부산광역시","북구",2046,1430,456,590,215,91,55,4,0,4,3,1,0,2,1,1422,8,616
"558","화명제2동","화명제2동제2투","대통령선거","부산광역시","북구",2342,1638,596,536,287,129,81,0,0,1,0,0,0,2,2,1634,4,704
"559","화명제2동","화명제2동제3투","대통령선거","부산광역시","북구",2469,1808,707,539,291,141,110,6,0,3,0,4,0,0,2,1803,5,661
"560","화명제2동","화명제2동제4투","대통령선거","부산광역시","북구",2147,1444,549,475,218,99,90,3,0,1,0,4,0,0,0,1439,5,703
"561","화명제2동","화명제2동제5투","대통령선거","부산광역시","북구",2172,1780,743,509,269,148,91,4,0,1,0,1,0,1,3,1770,10,392
"562","화명제3동","관내사전투표","대통령선거","부산광역시","북구",4251,4251,2326,763,605,336,205,2,0,1,1,3,0,0,1,4243,8,0
"563","화명제3동","화명제3동제1투","대통령선거","부산광역시","북구",3634,3026,1251,826,570,224,133,4,0,1,1,1,0,1,1,3013,13,608
"564","화명제3동","화명제3동제2투","대통령선거","부산광역시","북구",1932,1597,685,455,254,111,79,4,0,1,0,0,1,0,1,1591,6,335
"565","화명제3동","화명제3동제3투","대통령선거","부산광역시","북구",2836,2203,943,605,375,163,110,2,0,0,0,0,1,0,1,2200,3,633
"566","화명제3동","화명제3동제4투","대통령선거","부산광역시","북구",2425,1964,857,547,333,134,83,0,1,1,0,3,0,0,1,1960,4,461
"567","화명제3동","화명제3동제5투","대통령선거","부산광역시","북구",1352,1123,464,323,188,103,39,0,0,0,0,0,0,1,0,1118,5,229
"568","화명제3동","화명제3동제6투","대통령선거","부산광역시","북구",3367,2754,1168,811,424,196,140,3,0,1,2,1,0,0,2,2748,6,613
"569","화명제3동","화명제3동제7투","대통령선거","부산광역시","북구",3363,2833,1130,809,519,245,110,4,0,2,1,1,0,3,3,2827,6,530
"570","잘못 투입·구분된 투표지","잘못 투입·구분된 투표지","대통령선거","부산광역시","북구",0,2,0,1,1,0,0,0,0,0,0,0,0,0,0,2,0,-2
"571","거소·선상투표","거소·선상투표","대통령선거","부산광역시","해운대구",862,813,276,180,228,53,28,1,2,5,4,1,0,2,7,787,26,49
"572","관외사전투표","관외사전투표","대통령선거","부산광역시","해운대구",26418,26418,11570,5575,4665,2578,1720,28,8,7,8,18,5,17,54,26253,165,0
"573","재외투표","재외투표","대통령선거","부산광역시","해운대구",2674,2081,1203,187,360,95,223,7,0,0,0,0,0,1,0,2076,5,593
"574","우제1동","관내사전투표","대통령선거","부산광역시","해운대구",2594,2594,1022,833,422,174,125,7,0,2,0,0,1,1,2,2589,5,0
"575","우제1동","우제1동제1투","대통령선거","부산광역시","해운대구",2332,1386,412,548,264,99,53,0,0,1,0,0,0,1,3,1381,5,946
"576","우제1동","우제1동제2투","대통령선거","부산광역시","해운대구",3382,2486,892,820,465,166,123,2,0,3,0,0,0,3,3,2477,9,896
"577","우제1동","우제1동제3투","대통령선거","부산광역시","해운대구",2395,1554,414,644,303,95,73,10,0,3,0,2,1,0,2,1547,7,841
"578","우제1동","우제1동제4투","대통령선거","부산광역시","해운대구",3769,2106,677,763,415,160,79,0,1,1,1,0,2,2,2,2103,3,1663
"579","우제1동","우제1동제5투","대통령선거","부산광역시","해운대구",2780,2112,761,782,338,145,77,1,0,0,0,1,0,2,1,2108,4,668
"580","우제2동","관내사전투표","대통령선거","부산광역시","해운대구",4474,4474,1864,1272,749,359,197,12,0,2,1,1,0,2,4,4463,11,0
"581","우제2동","우제2동제1투","대통령선거","부산광역시","해운대구",3409,2754,927,924,542,253,94,0,0,1,1,0,0,3,0,2745,9,655
"582","우제2동","우제2동제2투","대통령선거","부산광역시","해운대구",2534,1811,702,554,321,146,75,3,0,1,1,1,0,2,0,1806,5,723
"583","우제2동","우제2동제3투","대통령선거","부산광역시","해운대구",2590,1733,592,624,300,132,75,3,0,0,0,0,0,0,2,1728,5,857
"584","우제2동","우제2동제4투","대통령선거","부산광역시","해운대구",3257,2465,862,788,474,206,121,6,0,0,0,2,1,1,0,2461,4,792
"585","우제2동","우제2동제5투","대통령선거","부산광역시","해운대구",3088,2383,821,715,533,201,95,10,0,1,0,0,0,1,0,2377,6,705
"586","우제2동","우제2동제6투","대통령선거","부산광역시","해운대구",2359,1654,509,621,336,142,39,2,0,0,0,1,0,1,1,1652,2,705
"587","중제1동","관내사전투표","대통령선거","부산광역시","해운대구",3553,3553,1533,1003,539,286,169,9,0,1,1,0,0,0,0,3541,12,0
"588","중제1동","중제1동제1투","대통령선거","부산광역시","해운대구",3607,2225,685,903,388,160,78,5,0,1,0,0,0,0,1,2221,4,1382
"589","중제1동","중제1동제2투","대통령선거","부산광역시","해운대구",2868,2018,739,691,337,155,83,2,0,0,0,0,1,1,1,2010,8,850
"590","중제1동","중제1동제3투","대통령선거","부산광역시","해운대구",3898,2704,1029,856,478,204,116,4,0,2,0,1,1,0,4,2695,9,1194
"591","중제1동","중제1동제4투","대통령선거","부산광역시","해운대구",3621,2385,901,681,488,178,127,3,0,1,0,0,0,0,0,2379,6,1236
"592","중제2동","관내사전투표","대통령선거","부산광역시","해운대구",2828,2828,1309,688,455,230,126,10,0,0,2,0,0,0,2,2822,6,0
"593","중제2동","중제2동제1투","대통령선거","부산광역시","해운대구",1343,713,203,295,123,60,25,1,0,1,0,0,1,0,0,709,4,630
"594","중제2동","중제2동제2투","대통령선거","부산광역시","해운대구",2845,1746,591,619,320,128,82,3,0,0,0,0,0,0,1,1744,2,1099
"595","중제2동","중제2동제3투","대통령선거","부산광역시","해운대구",2524,1663,505,641,330,114,60,3,1,1,0,2,0,0,1,1658,5,861
"596","중제2동","중제2동제4투","대통령선거","부산광역시","해운대구",2958,2072,765,572,455,183,81,5,0,2,1,0,0,0,1,2065,7,886
"597","좌제1동","관내사전투표","대통령선거","부산광역시","해운대구",3366,3366,1590,696,515,325,221,5,0,1,0,0,1,1,2,3357,9,0
"598","좌제1동","좌제1동제1투","대통령선거","부산광역시","해운대구",2652,1592,634,362,303,179,100,7,0,0,0,0,1,1,2,1589,3,1060
"599","좌제1동","좌제1동제2투","대통령선거","부산광역시","해운대구",2545,1895,621,653,350,169,87,5,0,4,0,0,0,1,1,1891,4,650
"600","좌제1동","좌제1동제3투","대통령선거","부산광역시","해운대구",2722,2100,884,530,393,190,88,1,0,3,0,1,0,0,1,2091,9,622
"601","좌제1동","좌제1동제4투","대통령선거","부산광역시","해운대구",3329,2640,1003,770,505,230,117,4,0,0,0,0,1,4,1,2635,5,689
"602","좌제2동","관내사전투표","대통령선거","부산광역시","해운대구",5174,5174,2515,1087,863,453,235,2,0,1,0,1,0,2,1,5160,14,0
"603","좌제2동","좌제2동제1투","대통령선거","부산광역시","해운대구",3063,2019,799,568,383,151,110,1,0,0,0,0,0,1,0,2013,6,1044
"604","좌제2동","좌제2동제2투","대통령선거","부산광역시","해운대구",3185,2110,820,609,380,194,99,3,0,1,0,0,1,0,1,2108,2,1075
"605","좌제2동","좌제2동제3투","대통령선거","부산광역시","해운대구",2914,2151,816,628,407,181,109,1,0,1,0,0,0,1,1,2145,6,763
"606","좌제2동","좌제2동제4투","대통령선거","부산광역시","해운대구",2576,1917,712,549,400,148,97,3,1,2,0,0,0,0,0,1912,5,659
"607","좌제2동","좌제2동제5투","대통령선거","부산광역시","해운대구",2989,2289,868,664,455,189,97,3,1,0,0,1,1,3,1,2283,6,700
"608","좌제2동","좌제2동제6투","대통령선거","부산광역시","해운대구",2540,1950,732,566,378,169,92,3,0,1,0,0,0,4,0,1945,5,590
"609","좌제2동","좌제2동제7투","대통령선거","부산광역시","해운대구",2520,1928,693,562,398,176,84,1,0,1,0,1,1,0,0,1917,11,592
"610","좌제3동","관내사전투표","대통령선거","부산광역시","해운대구",3473,3473,1526,861,616,284,154,13,0,1,1,3,0,0,0,3459,14,0
"611","좌제3동","좌제3동제1투","대통령선거","부산광역시","해운대구",2685,1952,653,577,432,169,99,6,0,3,0,0,0,0,3,1942,10,733
"612","좌제3동","좌제3동제2투","대통령선거","부산광역시","해운대구",2124,1555,495,556,305,129,58,5,0,0,0,0,0,0,1,1549,6,569
"613","좌제3동","좌제3동제3투","대통령선거","부산광역시","해운대구",2380,1784,664,554,326,157,66,3,1,1,0,0,0,0,1,1773,11,596
"614","좌제3동","좌제3동제4투","대통령선거","부산광역시","해운대구",2560,1988,729,627,414,157,52,3,0,0,1,0,0,0,1,1984,4,572
"615","좌제4동","관내사전투표","대통령선거","부산광역시","해운대구",4501,4501,2222,904,705,401,246,6,0,0,0,1,0,3,2,4490,11,0
"616","좌제4동","좌제4동제1투","대통령선거","부산광역시","해운대구",2307,1702,713,417,341,144,77,3,0,1,0,0,0,1,1,1698,4,605
"617","좌제4동","좌제4동제2투","대통령선거","부산광역시","해운대구",1332,1018,412,269,185,90,59,0,0,1,0,0,0,0,0,1016,2,314
"618","좌제4동","좌제4동제3투","대통령선거","부산광역시","해운대구",2407,1856,759,434,372,187,93,2,1,0,0,0,0,0,3,1851,5,551
"619","좌제4동","좌제4동제4투","대통령선거","부산광역시","해운대구",2899,2241,851,659,441,188,88,2,0,0,0,0,0,0,2,2231,10,658
"620","좌제4동","좌제4동제5투","대통령선거","부산광역시","해운대구",2663,2152,827,675,396,149,91,6,0,3,1,0,0,1,1,2150,2,511
"621","좌제4동","좌제4동제6투","대통령선거","부산광역시","해운대구",2481,2012,785,580,368,182,91,1,0,0,0,1,0,1,1,2010,2,469
"622","송정동","관내사전투표","대통령선거","부산광역시","해운대구",1533,1533,604,493,245,93,82,2,0,2,0,1,0,0,5,1527,6,0
"623","송정동","송정동제1투","대통령선거","부산광역시","해운대구",2479,1425,422,544,293,90,63,1,0,0,1,2,0,2,0,1418,7,1054
"624","송정동","송정동제2투","대통령선거","부산광역시","해운대구",2676,1790,585,629,366,122,73,6,0,1,0,1,1,0,2,1786,4,886
"625","송정동","송정동제3투","대통령선거","부산광역시","해운대구",1760,1187,427,404,206,89,49,7,0,2,0,1,1,0,0,1186,1,573
"626","반여제1동","관내사전투표","대통령선거","부산광역시","해운대구",4314,4314,2165,917,658,316,234,2,0,2,1,1,1,1,4,4302,12,0
"627","반여제1동","반여제1동제1투","대통령선거","부산광역시","해운대구",2262,1475,445,621,242,84,73,2,0,0,0,1,0,1,3,1472,3,787
"628","반여제1동","반여제1동제2투","대통령선거","부산광역시","해운대구",2462,1698,538,642,314,90,97,2,1,0,1,0,2,0,2,1689,9,764
"629","반여제1동","반여제1동제3투","대통령선거","부산광역시","해운대구",3223,2261,860,718,390,166,117,0,1,0,1,0,0,0,2,2255,6,962
"630","반여제1동","반여제1동제4투","대통령선거","부산광역시","해운대구",3193,2259,745,816,398,170,108,4,0,1,0,2,0,3,5,2252,7,934
"631","반여제1동","반여제1동제5투","대통령선거","부산광역시","해운대구",2548,2079,793,640,373,144,113,0,0,0,0,1,2,1,0,2067,12,469
"632","반여제1동","반여제1동제6투","대통령선거","부산광역시","해운대구",2178,1771,753,472,312,137,91,1,0,0,1,1,0,1,0,1769,2,407
"633","반여제1동","반여제1동제7투","대통령선거","부산광역시","해운대구",2174,1776,776,431,325,151,89,1,0,0,0,0,0,0,2,1775,1,398
"634","반여제1동","반여제1동제8투","대통령선거","부산광역시","해운대구",2521,2062,858,588,341,178,86,2,0,0,0,0,1,0,1,2055,7,459
"635","반여제1동","반여제1동제9투","대통령선거","부산광역시","해운대구",2921,2411,1075,545,472,222,87,4,0,0,0,0,1,0,0,2406,5,510
"636","반여제2동","관내사전투표","대통령선거","부산광역시","해운대구",1973,1973,789,609,346,118,92,1,2,0,1,3,0,3,0,1964,9,0
"637","반여제2동","반여제2동제1투","대통령선거","부산광역시","해운대구",2091,1283,400,522,216,80,51,3,1,0,0,0,0,2,2,1277,6,808
"638","반여제2동","반여제2동제2투","대통령선거","부산광역시","해운대구",2187,1333,467,440,252,99,69,1,0,0,0,0,1,1,1,1331,2,854
"639","반여제2동","반여제2동제3투","대통령선거","부산광역시","해운대구",2056,1097,339,427,195,77,43,2,0,0,2,0,2,1,2,1090,7,959
"640","반여제2동","반여제2동제4투","대통령선거","부산광역시","해운대구",2132,1352,440,519,235,77,68,4,0,0,0,2,0,1,0,1346,6,780
"641","반여제2동","반여제2동제5투","대통령선거","부산광역시","해운대구",1493,866,272,321,176,50,37,3,0,0,0,1,0,0,1,861,5,627
"642","반여제3동","관내사전투표","대통령선거","부산광역시","해운대구",1481,1481,594,504,243,65,61,3,0,1,1,0,3,2,1,1478,3,0
"643","반여제3동","반여제3동제1투","대통령선거","부산광역시","해운대구",2568,1574,498,635,278,85,61,4,0,2,1,0,0,0,1,1565,9,994
"644","반여제3동","반여제3동제2투","대통령선거","부산광역시","해운대구",2169,1364,443,531,212,85,71,2,0,4,2,0,0,3,4,1357,7,805
"645","반여제3동","반여제3동제3투","대통령선거","부산광역시","해운대구",2550,1495,486,539,276,100,80,4,0,0,0,1,0,2,1,1489,6,1055
"646","반여제4동","관내사전투표","대통령선거","부산광역시","해운대구",1966,1966,888,553,297,126,84,2,0,2,1,1,0,0,1,1955,11,0
"647","반여제4동","반여제4동제1투","대통령선거","부산광역시","해운대구",1851,1264,404,436,243,92,75,1,0,2,0,0,2,0,3,1258,6,587
"648","반여제4동","반여제4동제2투","대통령선거","부산광역시","해운대구",2512,1731,590,652,273,124,76,3,0,1,0,1,0,2,2,1724,7,781
"649","반여제4동","반여제4동제3투","대통령선거","부산광역시","해운대구",2732,2280,963,559,423,196,125,4,0,0,0,0,0,2,5,2277,3,452
"650","반여제4동","반여제4동제4투","대통령선거","부산광역시","해운대구",2985,2367,974,645,413,177,139,8,1,0,0,0,0,1,2,2360,7,618
"651","반송제1동","관내사전투표","대통령선거","부산광역시","해운대구",2569,2569,979,927,399,133,105,3,2,2,0,3,0,0,4,2557,12,0
"652","반송제1동","반송제1동제1투","대통령선거","부산광역시","해운대구",2041,1223,395,470,214,66,53,5,0,3,1,0,1,0,1,1209,14,818
"653","반송제1동","반송제1동제2투","대통령선거","부산광역시","해운대구",1829,1120,348,459,198,58,46,1,0,0,0,0,0,0,2,1112,8,709
"654","반송제1동","반송제1동제3투","대통령선거","부산광역시","해운대구",1679,1052,337,409,195,55,41,4,0,0,1,0,1,1,2,1046,6,627
"655","반송제1동","반송제1동제4투","대통령선거","부산광역시","해운대구",1866,1079,302,466,188,60,48,4,0,1,0,1,1,1,1,1073,6,787
"656","반송제1동","반송제1동제5투","대통령선거","부산광역시","해운대구",1982,1058,344,406,183,55,55,1,1,2,1,1,0,0,2,1051,7,924
"657","반송제1동","반송제1동제6투","대통령선거","부산광역시","해운대구",2018,1237,404,473,201,82,62,4,0,1,1,0,0,4,1,1233,4,781
"658","반송제1동","반송제1동제7투","대통령선거","부산광역시","해운대구",349,218,57,110,27,12,10,1,0,0,0,0,0,0,0,217,1,131
"659","반송제2동","관내사전투표","대통령선거","부산광역시","해운대구",4087,4087,1628,1311,634,277,181,5,1,8,5,0,2,1,4,4057,30,0
"660","반송제2동","반송제2동제1투","대통령선거","부산광역시","해운대구",2332,1550,414,707,247,94,75,1,1,2,0,1,1,1,0,1544,6,782
"661","반송제2동","반송제2동제2투","대통령선거","부산광역시","해운대구",3183,1946,679,680,337,135,99,1,0,1,3,3,2,0,1,1941,5,1237
"662","반송제2동","반송제2동제3투","대통령선거","부산광역시","해운대구",1738,970,265,424,165,66,41,2,0,4,0,0,0,0,0,967,3,768
"663","반송제2동","반송제2동제4투","대통령선거","부산광역시","해운대구",1432,909,256,389,166,58,36,0,0,0,0,1,0,0,2,908,1,523
"664","반송제2동","반송제2동제5투","대통령선거","부산광역시","해운대구",2711,1782,538,660,365,120,78,4,0,1,0,3,0,0,2,1771,11,929
"665","반송제2동","반송제2동제6투","대통령선거","부산광역시","해운대구",2234,1412,423,559,288,84,44,3,0,1,0,1,0,0,1,1404,8,822
"666","반송제2동","반송제2동제7투","대통령선거","부산광역시","해운대구",1954,1227,295,561,254,71,31,3,0,1,0,0,0,2,1,1219,8,727
"667","반송제2동","반송제2동제8투","대통령선거","부산광역시","해운대구",2645,1796,637,571,339,128,111,0,0,2,1,1,0,1,1,1792,4,849
"668","재송제1동","관내사전투표","대통령선거","부산광역시","해운대구",4073,4073,1892,1003,640,320,199,6,1,0,0,1,0,1,2,4065,8,0
"669","재송제1동","재송제1동제1투","대통령선거","부산광역시","해운대구",2877,1881,650,646,347,147,73,4,0,2,0,0,1,1,2,1873,8,996
"670","재송제1동","재송제1동제2투","대통령선거","부산광역시","해운대구",3077,1984,631,713,375,171,78,4,0,1,0,1,0,1,1,1976,8,1093
"671","재송제1동","재송제1동제3투","대통령선거","부산광역시","해운대구",2892,1936,681,639,370,138,96,3,1,2,0,1,0,0,0,1931,5,956
"672","재송제1동","재송제1동제4투","대통령선거","부산광역시","해운대구",2518,1975,908,463,341,150,105,2,0,0,0,1,0,1,1,1972,3,543
"673","재송제1동","재송제1동제5투","대통령선거","부산광역시","해운대구",4120,3325,1354,885,677,293,103,5,0,2,0,0,1,0,0,3320,5,795
"674","재송제1동","재송제1동제6투","대통령선거","부산광역시","해운대구",3580,2758,1034,801,552,276,87,5,0,0,0,0,0,1,2,2758,0,822
"675","재송제1동","재송제1동제7투","대통령선거","부산광역시","해운대구",2450,1993,875,509,389,136,74,4,1,0,0,0,1,0,0,1989,4,457
"676","재송제2동","관내사전투표","대통령선거","부산광역시","해운대구",3609,3609,1607,1021,561,214,183,2,0,3,1,1,0,1,6,3600,9,0
"677","재송제2동","재송제2동제1투","대통령선거","부산광역시","해운대구",2333,1439,483,537,231,108,69,2,0,2,0,1,0,0,1,1434,5,894
"678","재송제2동","재송제2동제2투","대통령선거","부산광역시","해운대구",2119,1385,518,453,250,88,68,5,0,0,0,1,0,0,1,1384,1,734
"679","재송제2동","재송제2동제3투","대통령선거","부산광역시","해운대구",2677,1702,652,500,304,134,96,4,1,1,0,1,1,0,0,1694,8,975
"680","재송제2동","재송제2동제4투","대통령선거","부산광역시","해운대구",2489,1689,595,571,316,112,86,4,0,0,0,0,0,0,2,1686,3,800
"681","재송제2동","재송제2동제5투","대통령선거","부산광역시","해운대구",2083,1375,490,431,277,96,68,4,0,0,0,1,1,0,2,1370,5,708
"682","재송제2동","재송제2동제6투","대통령선거","부산광역시","해운대구",2100,1312,450,469,203,102,78,2,0,0,0,0,1,0,2,1307,5,788
"683","재송제2동","재송제2동제7투","대통령선거","부산광역시","해운대구",2577,1742,627,561,310,134,102,0,0,0,0,1,0,0,1,1736,6,835
"684","재송제2동","재송제2동제8투","대통령선거","부산광역시","해운대구",2531,1789,639,633,306,132,71,1,0,1,0,0,1,0,2,1786,3,742
"685","우제3동","관내사전투표","대통령선거","부산광역시","해운대구",4083,4083,1561,1254,728,358,153,4,0,0,2,15,0,2,0,4077,6,0
"686","우제3동","우제3동제1투","대통령선거","부산광역시","해운대구",2902,2167,724,800,395,178,65,2,0,0,1,0,0,0,0,2165,2,735
"687","우제3동","우제3동제2투","대통령선거","부산광역시","해운대구",3258,2549,783,989,508,180,79,4,0,0,0,0,0,1,0,2544,5,709
"688","우제3동","우제3동제3투","대통령선거","부산광역시","해운대구",2440,1806,375,886,368,134,35,5,0,0,0,0,0,2,0,1805,1,634
"689","우제3동","우제3동제4투","대통령선거","부산광역시","해운대구",3202,2099,604,827,434,168,57,4,0,0,0,0,0,0,1,2095,4,1103
"690","우제3동","우제3동제5투","대통령선거","부산광역시","해운대구",2483,1812,520,634,448,167,36,3,0,0,0,0,0,0,2,1810,2,671
"691","우제3동","우제3동제6투","대통령선거","부산광역시","해운대구",2163,1588,472,608,323,132,48,2,0,0,0,0,0,0,1,1586,2,575
"692","잘못 투입·구분된 투표지","잘못 투입·구분된 투표지","대통령선거","부산광역시","해운대구",0,1,0,1,0,0,0,0,0,0,0,0,0,0,0,1,0,-1
"693","거소·선상투표","거소·선상투표","대통령선거","부산광역시","기장군",538,502,248,88,100,16,13,3,2,0,0,0,0,0,1,471,31,36
"694","관외사전투표","관외사전투표","대통령선거","부산광역시","기장군",11362,11360,5084,2625,1772,1009,771,12,2,2,2,1,1,6,20,11307,53,2
"695","재외투표","재외투표","대통령선거","부산광역시","기장군",672,504,328,36,58,24,56,2,0,0,0,0,0,0,0,504,0,168
"696","기장읍","관내사전투표","대통령선거","부산광역시","기장군",5886,5886,2673,1595,843,396,326,5,0,3,1,8,3,9,4,5866,20,0
"697","기장읍","기장읍제1투","대통령선거","부산광역시","기장군",2880,1804,647,623,299,108,118,0,0,1,0,0,1,0,2,1799,5,1076
"698","기장읍","기장읍제2투","대통령선거","부산광역시","기장군",3810,2472,859,842,446,180,120,6,1,1,3,1,1,0,0,2460,12,1338
"699","기장읍","기장읍제3투","대통령선거","부산광역시","기장군",3241,2409,947,667,451,169,147,3,2,3,0,1,0,2,5,2397,12,832
"700","기장읍","기장읍제4투","대통령선거","부산광역시","기장군",3958,2510,812,895,475,174,133,2,0,3,2,0,0,0,2,2498,12,1448
"701","기장읍","기장읍제5투","대통령선거","부산광역시","기장군",2770,1841,617,639,355,123,93,1,1,1,0,0,0,4,0,1834,7,929
"702","기장읍","기장읍제6투","대통령선거","부산광역시","기장군",3964,2457,876,717,483,194,161,2,1,3,0,0,1,0,5,2443,14,1507
"703","기장읍","기장읍제7투","대통령선거","부산광역시","기장군",3200,2190,665,849,427,146,85,4,0,0,2,0,0,2,0,2180,10,1010
"704","기장읍","기장읍제8투","대통령선거","부산광역시","기장군",2171,1239,378,485,223,74,60,0,0,1,0,2,1,2,5,1231,8,932
"705","기장읍","기장읍제9투","대통령선거","부산광역시","기장군",1646,965,275,459,150,45,29,3,0,1,0,1,0,0,0,963,2,681
"706","기장읍","기장읍제10투","대통령선거","부산광역시","기장군",2360,1653,526,592,342,129,56,2,0,2,0,0,0,0,2,1651,2,707
"707","기장읍","기장읍제11투","대통령선거","부산광역시","기장군",620,393,97,209,63,10,9,0,0,0,0,1,0,1,1,391,2,227
"708","기장읍","기장읍제12투","대통령선거","부산광역시","기장군",711,689,599,77,5,4,0,0,0,0,0,0,0,0,2,687,2,22
"709","기장읍","기장읍제13투","대통령선거","부산광역시","기장군",2267,1107,327,465,190,65,47,5,0,1,0,0,0,1,0,1101,6,1160
"710","기장읍","기장읍제14투","대통령선거","부산광역시","기장군",2034,1568,512,538,294,132,80,1,0,1,0,0,1,0,5,1564,4,466
"711","장안읍","관내사전투표","대통령선거","부산광역시","기장군",1019,1019,413,305,159,64,62,0,0,1,0,0,1,1,2,1008,11,0
"712","장안읍","장안읍제1투","대통령선거","부산광역시","기장군",1360,797,199,372,145,38,37,0,0,1,1,1,1,0,0,795,2,563
"713","장안읍","장안읍제2투","대통령선거","부산광역시","기장군",817,532,111,282,88,31,13,0,1,1,0,1,0,1,0,529,3,285
"714","장안읍","장안읍제3투","대통령선거","부산광역시","기장군",566,372,84,188,71,17,5,0,0,3,0,0,1,1,0,370,2,194
"715","장안읍","장안읍제4투","대통령선거","부산광역시","기장군",1127,714,178,347,100,44,30,2,0,0,0,1,0,2,1,705,9,413
"716","장안읍","장안읍제5투","대통령선거","부산광역시","기장군",1356,919,211,453,156,47,39,0,0,0,0,2,0,1,1,910,9,437
"717","장안읍","장안읍제6투","대통령선거","부산광역시","기장군",707,592,295,66,107,72,44,2,0,0,0,3,0,0,0,589,3,115
"718","일광면","관내사전투표","대통령선거","부산광역시","기장군",1070,1070,467,342,142,64,46,1,0,1,0,1,0,2,1,1067,3,0
"719","일광면","일광면제1투","대통령선거","부산광역시","기장군",1530,915,227,448,152,51,29,0,0,1,0,0,0,1,1,910,5,615
"720","일광면","일광면제2투","대통령선거","부산광역시","기장군",1615,1026,267,505,177,43,29,0,0,0,0,0,0,1,1,1023,3,589
"721","일광면","일광면제3투","대통령선거","부산광역시","기장군",440,302,65,168,40,20,6,0,1,0,0,0,0,0,0,300,2,138
"722","일광면","일광면제4투","대통령선거","부산광역시","기장군",653,425,87,241,61,18,11,1,0,0,1,1,0,1,0,422,3,228
"723","일광면","일광면제5투","대통령선거","부산광역시","기장군",2167,1414,426,585,242,89,52,1,0,4,0,0,1,2,3,1405,9,753
"724","정관읍","관내사전투표","대통령선거","부산광역시","기장군",8631,8631,4717,1470,1273,645,481,6,1,6,1,3,0,7,2,8612,19,0
"725","정관읍","정관읍제1투","대통령선거","부산광역시","기장군",3391,2169,918,519,392,167,156,6,0,2,0,0,1,0,2,2163,6,1222
"726","정관읍","정관읍제2투","대통령선거","부산광역시","기장군",4781,3398,1524,783,622,254,192,9,0,0,0,2,1,1,6,3394,4,1383
"727","정관읍","정관읍제3투","대통령선거","부산광역시","기장군",625,456,123,225,68,24,13,0,0,0,0,0,0,0,1,454,2,169
"728","정관읍","정관읍제4투","대통령선거","부산광역시","기장군",3187,2389,1178,488,421,173,120,2,0,0,0,3,0,0,0,2385,4,798
"729","정관읍","정관읍제5투","대통령선거","부산광역시","기장군",4034,3107,1564,542,576,250,163,0,0,2,0,3,0,0,3,3103,4,927
"730","정관읍","정관읍제6투","대통령선거","부산광역시","기장군",3737,2680,1096,781,462,188,134,0,1,2,0,1,0,2,5,2672,8,1057
"731","정관읍","정관읍제7투","대통령선거","부산광역시","기장군",2704,2081,1099,360,344,159,113,1,0,0,0,1,0,0,3,2080,1,623
"732","정관읍","정관읍제8투","대통령선거","부산광역시","기장군",4273,3212,1592,601,583,259,170,1,0,1,0,0,1,1,1,3210,2,1061
"733","정관읍","정관읍제9투","대통령선거","부산광역시","기장군",2976,2043,898,499,380,133,117,6,1,4,1,0,0,1,0,2040,3,933
"734","정관읍","정관읍제10투","대통령선거","부산광역시","기장군",3461,2762,1434,466,489,227,137,1,0,1,0,1,1,0,2,2759,3,699
"735","정관읍","정관읍제11투","대통령선거","부산광역시","기장군",4893,3375,1397,829,664,284,182,5,0,0,0,1,0,1,5,3368,7,1518
"736","정관읍","정관읍제12투","대통령선거","부산광역시","기장군",2284,1578,738,348,264,121,96,7,0,0,1,0,1,0,0,1576,2,706
"737","철마면","관내사전투표","대통령선거","부산광역시","기장군",462,462,198,145,67,32,17,0,0,0,0,0,0,1,0,460,2,0
"738","철마면","철마면제1투","대통령선거","부산광역시","기장군",1344,907,241,464,113,46,38,0,1,0,1,0,0,0,1,905,2,437
"739","철마면","철마면제2투","대통령선거","부산광역시","기장군",939,695,206,296,117,50,22,1,0,0,0,0,1,1,0,694,1,244
"740","철마면","철마면제3투","대통령선거","부산광역시","기장군",3884,2802,989,1037,458,167,130,4,2,1,0,3,1,3,0,2795,7,1082
"741","잘못 투입·구분된 투표지","잘못 투입·구분된 투표지","대통령선거","부산광역시","기장군",0,0,0,0,0,0,0,0,0,0,0,0,0,0,0,0,0,0
"742","거소·선상투표","거소·선상투표","대통령선거","부산광역시","사하구",854,800,315,146,237,47,16,4,1,3,2,0,1,0,2,774,26,54
"743","관외사전투표","관외사전투표","대통령선거","부산광역시","사하구",20247,20244,9271,4033,3325,1868,1493,19,5,9,3,10,7,9,34,20086,158,3
"744","재외투표","재외투표","대통령선거","부산광역시","사하구",1405,1056,644,74,163,50,120,2,0,0,0,0,0,0,0,1053,3,349
"745","괴정제1동","관내사전투표","대통령선거","부산광역시","사하구",3065,3065,1382,904,428,198,132,5,0,2,1,0,1,0,2,3055,10,0
"746","괴정제1동","괴정제1동제1투","대통령선거","부산광역시","사하구",2565,1776,599,667,318,110,74,1,0,1,0,0,0,0,0,1770,6,789
"747","괴정제1동","괴정제1동제2투","대통령선거","부산광역시","사하구",2799,1900,594,790,310,124,75,1,0,0,0,1,0,1,1,1897,3,899
"748","괴정제1동","괴정제1동제3투","대통령선거","부산광역시","사하구",2993,2069,726,736,364,147,78,1,0,1,0,2,0,0,1,2056,13,924
"749","괴정제1동","괴정제1동제4투","대통령선거","부산광역시","사하구",2654,1818,565,703,322,124,93,2,0,2,0,0,0,1,2,1814,4,836
"750","괴정제1동","괴정제1동제5투","대통령선거","부산광역시","사하구",2842,2071,743,701,381,133,95,1,0,0,0,1,2,0,3,2060,11,771
"751","괴정제2동","관내사전투표","대통령선거","부산광역시","사하구",1762,1762,745,526,253,128,95,3,1,0,0,1,0,0,2,1754,8,0
"752","괴정제2동","괴정제2동제1투","대통령선거","부산광역시","사하구",2510,1579,472,664,265,96,73,0,0,0,1,2,1,0,0,1574,5,931
"753","괴정제2동","괴정제2동제2투","대통령선거","부산광역시","사하구",3244,2244,831,737,390,154,116,1,0,1,1,0,1,0,1,2233,11,1000
"754","괴정제2동","괴정제2동제3투","대통령선거","부산광역시","사하구",2197,1425,444,533,282,93,60,1,0,0,0,1,2,1,1,1418,7,772
"755","괴정제2동","괴정제2동제4투","대통령선거","부산광역시","사하구",2260,1600,523,616,273,109,65,2,0,0,0,1,1,1,1,1592,8,660
"756","괴정제3동","관내사전투표","대통령선거","부산광역시","사하구",2260,2260,959,665,340,139,118,3,1,5,1,2,3,5,3,2244,16,0
"757","괴정제3동","괴정제3동제1투","대통령선거","부산광역시","사하구",2723,1786,633,648,284,117,83,3,0,3,1,1,0,1,3,1777,9,937
"758","괴정제3동","괴정제3동제2투","대통령선거","부산광역시","사하구",3168,2066,624,885,323,125,89,1,1,0,0,2,0,4,3,2057,9,1102
"759","괴정제3동","괴정제3동제3투","대통령선거","부산광역시","사하구",3478,2289,781,859,392,147,89,4,0,1,3,0,0,0,1,2277,12,1189
"760","괴정제4동","관내사전투표","대통령선거","부산광역시","사하구",2055,2055,849,668,283,135,103,6,0,1,2,0,0,1,0,2048,7,0
"761","괴정제4동","괴정제4동제1투","대통령선거","부산광역시","사하구",2628,1831,603,711,314,122,63,4,0,1,2,0,0,0,1,1821,10,797
"762","괴정제4동","괴정제4동제2투","대통령선거","부산광역시","사하구",2801,1869,629,669,332,114,112,1,0,3,0,1,0,0,1,1862,7,932
"763","괴정제4동","괴정제4동제3투","대통령선거","부산광역시","사하구",1752,1166,349,497,190,66,49,3,0,2,1,0,0,3,1,1161,5,586
"764","괴정제4동","괴정제4동제4투","대통령선거","부산광역시","사하구",1890,1203,386,455,238,80,41,0,0,0,0,0,0,0,0,1200,3,687
"765","당리동","관내사전투표","대통령선거","부산광역시","사하구",4199,4199,1980,1106,582,270,226,7,0,5,1,1,0,2,2,4182,17,0
"766","당리동","당리동제1투","대통령선거","부산광역시","사하구",3464,2709,1135,776,480,178,124,3,0,0,0,1,0,1,4,2702,7,755
"767","당리동","당리동제2투","대통령선거","부산광역시","사하구",3884,2686,1038,826,469,210,135,1,0,0,1,1,0,0,0,2681,5,1198
"768","당리동","당리동제3투","대통령선거","부산광역시","사하구",3918,2815,913,1161,472,148,100,3,0,0,0,0,0,1,4,2802,13,1103
"769","당리동","당리동제4투","대통령선거","부산광역시","사하구",2532,1653,579,578,290,111,85,3,0,1,0,0,0,0,4,1651,2,879
"770","당리동","당리동제5투","대통령선거","부산광역시","사하구",2429,1704,600,637,277,88,84,3,0,5,0,1,0,1,1,1697,7,725
"771","당리동","당리동제6투","대통령선거","부산광역시","사하구",2422,1798,613,643,330,117,75,8,0,1,0,1,1,0,0,1789,9,624
"772","하단제1동","관내사전투표","대통령선거","부산광역시","사하구",3469,3469,1695,747,504,262,234,2,1,0,1,1,1,4,3,3455,14,0
"773","하단제1동","하단제1동제1투","대통령선거","부산광역시","사하구",2653,1885,673,658,318,143,78,3,0,0,0,0,1,1,1,1876,9,768
"774","하단제1동","하단제1동제2투","대통령선거","부산광역시","사하구",2521,1513,549,517,268,98,70,0,0,1,1,0,0,0,1,1505,8,1008
"775","하단제1동","하단제1동제3투","대통령선거","부산광역시","사하구",3584,2321,867,717,400,176,143,0,0,2,2,1,0,1,3,2312,9,1263
"776","하단제1동","하단제1동제4투","대통령선거","부산광역시","사하구",3312,2607,989,882,461,174,93,2,0,0,0,2,0,0,1,2604,3,705
"777","하단제1동","하단제1동제5투","대통령선거","부산광역시","사하구",2742,2217,863,674,372,185,98,2,0,1,2,0,1,0,2,2200,17,525
"778","하단제2동","관내사전투표","대통령선거","부산광역시","사하구",3179,3179,1614,701,466,221,157,2,0,2,0,0,0,2,1,3166,13,0
"779","하단제2동","하단제2동제1투","대통령선거","부산광역시","사하구",3403,2413,948,745,423,167,112,3,0,1,2,0,1,0,0,2402,11,990
"780","하단제2동","하단제2동제2투","대통령선거","부산광역시","사하구",3498,2420,896,793,419,171,124,5,0,1,0,1,0,1,2,2413,7,1078
"781","하단제2동","하단제2동제3투","대통령선거","부산광역시","사하구",3107,1856,710,595,294,156,91,2,0,2,0,0,1,0,1,1852,4,1251
"782","하단제2동","하단제2동제4투","대통령선거","부산광역시","사하구",3554,2523,862,816,498,190,137,4,1,2,0,0,0,0,4,2514,9,1031
"783","하단제2동","하단제2동제5투","대통령선거","부산광역시","사하구",3103,2415,1067,597,435,174,131,0,0,0,0,1,0,0,2,2407,8,688
"784","신평제1동","관내사전투표","대통령선거","부산광역시","사하구",2642,2642,1212,749,388,163,115,2,0,1,2,1,0,3,1,2637,5,0
"785","신평제1동","신평제1동제1투","대통령선거","부산광역시","사하구",3600,2483,906,823,438,179,119,1,0,1,2,0,0,1,6,2476,7,1117
"786","신평제1동","신평제1동제2투","대통령선거","부산광역시","사하구",2965,1821,591,648,359,125,81,2,1,2,0,0,0,2,1,1812,9,1144
"787","신평제1동","신평제1동제3투","대통령선거","부산광역시","사하구",3231,1830,583,685,324,128,94,0,0,0,3,1,2,2,3,1825,5,1401
"788","신평제1동","신평제1동제4투","대통령선거","부산광역시","사하구",2778,1797,616,661,336,100,64,1,0,2,1,1,0,0,6,1788,9,981
"789","신평제2동","관내사전투표","대통령선거","부산광역시","사하구",1940,1940,901,465,293,158,116,0,1,0,1,0,0,0,2,1937,3,0
"790","신평제2동","신평제2동제1투","대통령선거","부산광역시","사하구",2695,1579,545,553,278,107,84,3,1,0,0,0,1,0,3,1575,4,1116
"791","신평제2동","신평제2동제2투","대통령선거","부산광역시","사하구",3357,2554,941,800,495,178,132,1,0,1,0,2,1,0,1,2552,2,803
"792","신평제2동","신평제2동제3투","대통령선거","부산광역시","사하구",1888,1466,542,479,273,92,70,1,1,0,1,0,0,0,0,1459,7,422
"793","신평제2동","신평제2동제4투","대통령선거","부산광역시","사하구",2438,1900,753,577,337,135,90,0,0,0,0,1,1,0,3,1897,3,538
"794","장림제1동","관내사전투표","대통령선거","부산광역시","사하구",1917,1917,876,462,321,128,106,0,0,3,1,2,0,2,6,1907,10,0
"795","장림제1동","장림제1동제1투","대통령선거","부산광역시","사하구",2713,1526,506,579,311,71,41,3,0,2,2,0,0,1,2,1518,8,1187
"796","장림제1동","장림제1동제2투","대통령선거","부산광역시","사하구",2723,1606,503,674,282,68,56,6,0,2,0,0,0,1,4,1596,10,1117
"797","장림제1동","장림제1동제3투","대통령선거","부산광역시","사하구",3375,2497,1145,509,452,202,177,2,0,0,0,0,1,0,2,2490,7,878
"798","장림제2동","관내사전투표","대통령선거","부산광역시","사하구",2643,2643,1222,648,421,177,146,10,0,1,1,1,1,0,2,2630,13,0
"799","장림제2동","장림제2동제1투","대통령선거","부산광역시","사하구",2644,1479,439,595,288,81,59,1,0,3,0,1,1,0,1,1469,10,1165
"800","장림제2동","장림제2동제2투","대통령선거","부산광역시","사하구",3283,2280,939,618,425,178,97,5,0,1,1,0,1,0,3,2268,12,1003
"801","장림제2동","장림제2동제3투","대통령선거","부산광역시","사하구",2676,1878,671,612,361,141,74,1,0,0,0,0,1,0,5,1866,12,798
"802","장림제2동","장림제2동제4투","대통령선거","부산광역시","사하구",3241,2336,774,825,429,162,127,1,0,2,0,1,1,0,3,2325,11,905
"803","장림제2동","장림제2동제5투","대통령선거","부산광역시","사하구",3314,2278,848,697,426,171,117,2,0,1,1,0,1,1,3,2268,10,1036
"804","장림제2동","장림제2동제6투","대통령선거","부산광역시","사하구",3221,2279,953,596,426,163,122,4,1,2,0,1,0,0,3,2271,8,942
"805","다대제1동","관내사전투표","대통령선거","부산광역시","사하구",3974,3974,1885,929,611,303,213,1,0,3,2,2,0,3,6,3958,16,0
"806","다대제1동","다대제1동제1투","대통령선거","부산광역시","사하구",3361,2192,829,630,433,172,108,1,0,2,2,4,0,1,2,2184,8,1169
"807","다대제1동","다대제1동제2투","대통령선거","부산광역시","사하구",3069,1960,643,724,367,114,91,0,2,1,2,0,1,1,3,1949,11,1109
"808","다대제1동","다대제1동제3투","대통령선거","부산광역시","사하구",1838,1117,345,425,202,84,46,2,0,4,0,1,1,0,1,1111,6,721
"809","다대제1동","다대제1동제4투","대통령선거","부산광역시","사하구",2442,1804,637,646,340,100,69,1,1,2,0,0,0,0,1,1797,7,638
"810","다대제1동","다대제1동제5투","대통령선거","부산광역시","사하구",2581,1705,654,488,326,136,85,1,0,2,0,1,2,2,1,1698,7,876
"811","다대제1동","다대제1동제6투","대통령선거","부산광역시","사하구",2096,1367,583,327,264,102,80,2,0,3,0,0,0,1,0,1362,5,729
"812","다대제1동","다대제1동제7투","대통령선거","부산광역시","사하구",2735,2078,773,672,370,154,94,5,0,0,0,0,0,1,2,2071,7,657
"813","다대제1동","다대제1동제8투","대통령선거","부산광역시","사하구",1756,1074,304,475,197,57,25,3,0,0,0,0,3,0,2,1066,8,682
"814","다대제1동","다대제1동제9투","대통령선거","부산광역시","사하구",1651,1083,421,315,221,71,47,0,0,0,0,0,1,1,0,1077,6,568
"815","다대제1동","다대제1동제10투","대통령선거","부산광역시","사하구",3396,2593,1139,608,510,188,135,4,0,2,0,0,0,1,1,2588,5,803
"816","다대제1동","다대제1동제11투","대통령선거","부산광역시","사하구",2649,2070,864,504,408,206,79,2,0,0,0,1,0,0,0,2064,6,579
"817","다대제2동","관내사전투표","대통령선거","부산광역시","사하구",4093,4093,1876,1033,634,279,229,6,0,4,2,1,3,1,4,4072,21,0
"818","다대제2동","다대제2동제1투","대통령선거","부산광역시","사하구",2174,1671,639,478,302,143,101,0,0,2,0,0,0,0,1,1666,5,503
"819","다대제2동","다대제2동제2투","대통령선거","부산광역시","사하구",2276,1773,681,584,295,137,69,1,0,0,1,1,0,0,0,1769,4,503
"820","다대제2동","다대제2동제3투","대통령선거","부산광역시","사하구",2758,1824,608,690,325,105,74,1,0,2,0,0,3,2,1,1811,13,934
"821","다대제2동","다대제2동제4투","대통령선거","부산광역시","사하구",2610,1710,656,501,321,135,78,6,1,1,0,0,0,0,3,1702,8,900
"822","다대제2동","다대제2동제5투","대통령선거","부산광역시","사하구",3885,2795,1070,845,537,187,132,5,0,1,1,1,1,0,3,2783,12,1090
"823","다대제2동","다대제2동제6투","대통령선거","부산광역시","사하구",3121,2286,860,706,425,158,123,1,0,0,3,0,1,1,1,2279,7,835
"824","다대제2동","다대제2동제7투","대통령선거","부산광역시","사하구",2590,1511,445,640,260,83,54,5,1,4,2,2,0,2,3,1501,10,1079
"825","구평동","관내사전투표","대통령선거","부산광역시","사하구",1076,1076,535,247,151,86,55,0,0,0,0,0,1,0,0,1075,1,0
"826","구평동","구평동제1투","대통령선거","부산광역시","사하구",1804,1371,563,359,273,100,69,0,0,1,0,0,0,0,1,1366,5,433
"827","구평동","구평동제2투","대통령선거","부산광역시","사하구",2254,1476,427,591,290,94,61,0,0,1,0,0,1,1,3,1469,7,778
"828","구평동","구평동제3투","대통령선거","부산광역시","사하구",384,261,63,131,44,15,6,0,0,1,1,0,0,0,0,261,0,123
"829","구평동","구평동제4투","대통령선거","부산광역시","사하구",1854,1387,566,286,302,135,94,0,1,1,1,0,0,0,1,1387,0,467
"830","감천제1동","관내사전투표","대통령선거","부산광역시","사하구",2128,2128,887,647,360,121,97,1,0,1,0,1,1,0,2,2118,10,0
"831","감천제1동","감천제1동제1투","대통령선거","부산광역시","사하구",3244,2103,671,822,369,127,89,0,0,6,2,0,1,1,4,2092,11,1141
"832","감천제1동","감천제1동제2투","대통령선거","부산광역시","사하구",2768,1529,464,633,275,82,65,0,0,3,0,0,0,2,0,1524,5,1239
"833","감천제1동","감천제1동제3투","대통령선거","부산광역시","사하구",1922,1284,388,487,242,87,65,1,0,2,2,3,1,0,0,1278,6,638
"834","감천제1동","감천제1동제4투","대통령선거","부산광역시","사하구",2205,1681,683,516,275,134,62,0,1,2,0,0,1,1,3,1678,3,524
"835","감천제1동","감천제1동제5투","대통령선거","부산광역시","사하구",2522,1823,674,570,340,145,80,0,0,1,0,3,0,2,2,1817,6,699
"836","감천제1동","감천제1동제6투","대통령선거","부산광역시","사하구",2665,1931,664,659,338,145,108,0,0,0,0,0,0,0,2,1916,15,734
"837","감천제2동","관내사전투표","대통령선거","부산광역시","사하구",889,888,313,343,148,42,31,1,0,1,1,1,1,3,0,885,3,1
"838","감천제2동","감천제2동제1투","대통령선거","부산광역시","사하구",2094,1175,338,518,199,56,49,3,2,0,0,0,0,1,2,1168,7,919
"839","감천제2동","감천제2동제2투","대통령선거","부산광역시","사하구",1976,1069,307,478,183,53,40,3,0,0,0,0,1,0,0,1065,4,907
"840","감천제2동","감천제2동제3투","대통령선거","부산광역시","사하구",1594,967,273,434,148,50,45,2,0,2,0,1,2,3,1,961,6,627
"841","잘못 투입·구분된 투표지","잘못 투입·구분된 투표지","대통령선거","부산광역시","사하구",0,0,0,0,0,0,0,0,0,0,0,0,0,0,0,0,0,0
"842","거소·선상투표","거소·선상투표","대통령선거","부산광역시","금정구",585,553,206,121,152,30,13,5,0,2,0,4,1,1,4,539,14,32
"843","관외사전투표","관외사전투표","대통령선거","부산광역시","금정구",16705,16705,7365,3550,2753,1635,1179,13,4,9,7,16,4,6,28,16569,136,0
"844","재외투표","재외투표","대통령선거","부산광역시","금정구",1518,1225,720,92,184,53,168,4,0,0,1,1,0,0,0,1223,2,293
"845","서제1동","관내사전투표","대통령선거","부산광역시","금정구",829,829,306,279,128,56,53,0,1,1,0,0,0,1,0,825,4,0
"846","서제1동","서제1동제1투","대통령선거","부산광역시","금정구",2018,1165,323,505,210,81,36,0,0,2,0,1,0,0,1,1159,6,853
"847","서제1동","서제1동제2투","대통령선거","부산광역시","금정구",1755,1143,320,510,161,88,48,0,0,0,2,1,0,4,1,1135,8,612
"848","서제1동","서제1동제3투","대통령선거","부산광역시","금정구",1922,1197,340,504,212,73,57,1,0,1,0,0,1,0,1,1190,7,725
"849","서제2동","관내사전투표","대통령선거","부산광역시","금정구",1377,1377,515,481,199,106,65,1,0,2,0,0,2,1,1,1373,4,0
"850","서제2동","서제2동제1투","대통령선거","부산광역시","금정구",3093,2026,586,828,342,150,93,5,0,4,0,0,1,2,5,2016,10,1067
"851","서제2동","서제2동제2투","대통령선거","부산광역시","금정구",2707,1698,481,750,278,94,72,7,0,0,0,3,0,0,4,1689,9,1009
"852","서제2동","서제2동제3투","대통령선거","부산광역시","금정구",2530,1634,536,637,280,92,74,1,0,0,0,1,0,2,2,1625,9,896
"853","서제3동","관내사전투표","대통령선거","부산광역시","금정구",1513,1513,559,571,194,106,73,1,1,0,1,1,0,1,0,1508,5,0
"854","서제3동","서제3동제1투","대통령선거","부산광역시","금정구",2085,1390,404,601,232,79,59,2,0,0,0,1,0,0,2,1380,10,695
"855","서제3동","서제3동제2투","대통령선거","부산광역시","금정구",2398,1667,514,690,254,122,69,3,1,1,0,1,1,3,2,1661,6,731
"856","서제3동","서제3동제3투","대통령선거","부산광역시","금정구",2269,1305,348,567,235,86,56,1,1,2,0,0,0,1,1,1298,7,964
"857","서제3동","서제3동제4투","대통령선거","부산광역시","금정구",1885,1332,403,569,202,99,52,1,0,1,0,0,0,0,0,1327,5,553
"858","금사동","관내사전투표","대통령선거","부산광역시","금정구",1079,1079,414,411,139,54,47,1,0,3,0,1,0,1,1,1072,7,0
"859","금사동","금사동제1투","대통령선거","부산광역시","금정구",2328,1528,437,684,221,123,50,2,0,1,0,0,1,1,0,1520,8,800
"860","금사동","금사동제2투","대통령선거","부산광역시","금정구",2573,1571,469,649,267,102,69,4,0,1,0,0,0,0,1,1562,9,1002
"861","금사동","금사동제3투","대통령선거","부산광역시","금정구",1965,1330,400,590,193,80,52,3,0,4,1,1,0,0,0,1324,6,635
"862","부곡제1동","관내사전투표","대통령선거","부산광역시","금정구",1949,1949,742,673,277,140,89,8,0,2,0,0,0,2,7,1940,9,0
"863","부곡제1동","부곡제1동제1투","대통령선거","부산광역시","금정구",1719,1065,318,428,197,71,38,2,0,1,0,1,1,1,1,1059,6,654
"864","부곡제1동","부곡제1동제2투","대통령선거","부산광역시","금정구",2992,1982,616,799,345,130,73,4,1,3,0,1,0,1,0,1973,9,1010
"865","부곡제1동","부곡제1동제3투","대통령선거","부산광역시","금정구",1834,1196,341,509,214,72,44,2,0,0,0,1,0,5,4,1192,4,638
"866","부곡제2동","관내사전투표","대통령선거","부산광역시","금정구",2514,2514,1145,629,376,211,132,2,0,1,0,5,1,0,4,2506,8,0
"867","부곡제2동","부곡제2동제1투","대통령선거","부산광역시","금정구",1862,1323,455,441,235,102,76,0,0,1,0,0,1,0,2,1313,10,539
"868","부곡제2동","부곡제2동제2투","대통령선거","부산광역시","금정구",3158,2157,634,834,393,164,98,5,0,2,2,4,1,3,3,2143,14,1001
"869","부곡제2동","부곡제2동제3투","대통령선거","부산광역시","금정구",2881,2125,759,654,402,208,90,4,0,1,0,0,0,1,0,2119,6,756
"870","부곡제2동","부곡제2동제4투","대통령선거","부산광역시","금정구",3264,2719,1025,878,475,219,107,0,0,2,0,3,1,3,1,2714,5,545
"871","부곡제3동","관내사전투표","대통령선거","부산광역시","금정구",3147,3147,1394,763,477,285,201,6,0,4,0,0,0,0,3,3133,14,0
"872","부곡제3동","부곡제3동제1투","대통령선거","부산광역시","금정구",2161,1451,522,535,206,108,65,2,0,2,1,0,0,1,1,1443,8,710
"873","부곡제3동","부곡제3동제2투","대통령선거","부산광역시","금정구",2146,1452,465,535,247,122,74,1,0,0,0,0,0,0,1,1445,7,694
"874","부곡제3동","부곡제3동제3투","대통령선거","부산광역시","금정구",3174,2457,844,847,417,228,105,4,0,0,1,1,0,2,2,2451,6,717
"875","부곡제3동","부곡제3동제4투","대통령선거","부산광역시","금정구",3306,2684,982,842,473,250,120,2,0,1,0,1,0,3,5,2679,5,622
"876","부곡제4동","관내사전투표","대통령선거","부산광역시","금정구",2074,2074,889,652,283,130,104,2,0,0,0,0,0,2,0,2062,12,0
"877","부곡제4동","부곡제4동제1투","대통령선거","부산광역시","금정구",2874,1947,654,684,358,169,68,0,0,2,0,2,0,0,3,1940,7,927
"878","부곡제4동","부곡제4동제2투","대통령선거","부산광역시","금정구",2108,1537,483,627,245,93,71,3,0,1,1,3,0,0,1,1528,9,571
"879","부곡제4동","부곡제4동제3투","대통령선거","부산광역시","금정구",1913,1186,298,563,190,81,40,1,0,1,0,0,1,1,1,1177,9,727
"880","부곡제4동","부곡제4동제4투","대통령선거","부산광역시","금정구",2292,1595,506,585,290,128,70,3,0,1,0,0,0,0,1,1584,11,697
"881","장전제1동","관내사전투표","대통령선거","부산광역시","금정구",3118,3118,1512,511,400,388,279,1,0,0,0,6,0,1,5,3103,15,0
"882","장전제1동","장전제1동제1투","대통령선거","부산광역시","금정구",2268,1567,587,488,226,154,98,2,0,0,0,1,1,1,0,1558,9,701
"883","장전제1동","장전제1동제2투","대통령선거","부산광역시","금정구",3106,2306,868,663,352,249,155,0,0,1,0,1,0,3,5,2297,9,800
"884","장전제1동","장전제1동제3투","대통령선거","부산광역시","금정구",2577,1809,604,711,292,124,63,2,0,0,0,1,1,1,2,1801,8,768
"885","장전제1동","장전제1동제4투","대통령선거","부산광역시","금정구",2972,2409,1057,589,392,243,121,1,0,0,0,0,0,0,0,2403,6,563
"886","장전제2동","관내사전투표","대통령선거","부산광역시","금정구",2372,2372,1125,582,337,184,131,1,1,2,0,2,2,0,1,2368,4,0
"887","장전제2동","장전제2동제1투","대통령선거","부산광역시","금정구",2373,1536,514,605,246,98,46,6,0,1,3,0,0,3,0,1522,14,837
"888","장전제2동","장전제2동제2투","대통령선거","부산광역시","금정구",3012,2218,746,811,405,174,69,4,0,1,0,1,0,1,2,2214,4,794
"889","장전제2동","장전제2동제3투","대통령선거","부산광역시","금정구",3215,2557,1120,650,462,214,106,0,1,0,0,1,1,0,0,2555,2,658
"890","장전제3동","관내사전투표","대통령선거","부산광역시","금정구",1060,1060,455,256,166,97,71,3,0,0,0,1,1,3,4,1057,3,0
"891","장전제3동","장전제3동제1투","대통령선거","부산광역시","금정구",2126,1325,407,498,239,103,64,1,0,0,1,0,1,1,2,1317,8,801
"892","장전제3동","장전제3동제2투","대통령선거","부산광역시","금정구",2345,1539,533,537,260,117,81,2,0,0,1,0,0,1,0,1532,7,806
"893","선두구동","관내사전투표","대통령선거","부산광역시","금정구",513,513,193,200,57,31,23,4,0,0,0,0,0,0,2,510,3,0
"894","선두구동","선두구동투표소","대통령선거","부산광역시","금정구",1751,1147,257,616,160,70,32,1,1,0,1,0,1,2,1,1142,5,604
"895","청룡노포동","관내사전투표","대통령선거","부산광역시","금정구",1935,1935,720,695,294,124,90,1,0,2,0,2,0,2,0,1930,5,0
"896","청룡노포동","청룡노포동제1투","대통령선거","부산광역시","금정구",2919,1987,656,755,326,146,91,3,0,2,0,1,1,0,1,1982,5,932
"897","청룡노포동","청룡노포동제2투","대통령선거","부산광역시","금정구",2927,2127,611,954,338,154,57,0,0,2,0,0,0,1,1,2118,9,800
"898","청룡노포동","청룡노포동제3투","대통령선거","부산광역시","금정구",668,428,110,213,63,28,6,0,0,1,1,0,1,1,2,426,2,240
"899","남산동","관내사전투표","대통령선거","부산광역시","금정구",3960,3960,1659,1239,528,292,205,1,0,4,0,4,0,1,1,3934,26,0
"900","남산동","남산동제1투","대통령선거","부산광역시","금정구",2625,1782,528,710,318,139,69,4,0,2,2,2,1,0,0,1775,7,843
"901","남산동","남산동제2투","대통령선거","부산광역시","금정구",2826,1931,621,752,296,143,95,1,0,2,1,4,0,1,2,1918,13,895
"902","남산동","남산동제3투","대통령선거","부산광역시","금정구",2877,2054,723,711,326,172,110,1,0,0,0,3,0,0,1,2047,7,823
"903","남산동","남산동제4투","대통령선거","부산광역시","금정구",3261,2333,726,854,409,213,110,1,0,2,2,0,1,1,1,2320,13,928
"904","남산동","남산동제5투","대통령선거","부산광역시","금정구",2979,2060,619,779,364,168,112,3,0,1,0,3,0,1,4,2054,6,919
"905","남산동","남산동제6투","대통령선거","부산광역시","금정구",4190,2876,946,1071,481,194,154,4,0,2,2,0,0,1,4,2859,17,1314
"906","남산동","남산동제7투","대통령선거","부산광역시","금정구",2581,1872,587,721,320,149,78,2,0,1,1,5,0,0,1,1865,7,709
"907","구서제1동","관내사전투표","대통령선거","부산광역시","금정구",3982,3982,1843,1008,586,326,193,2,0,3,0,0,0,2,2,3965,17,0
"908","구서제1동","구서제1동제1투","대통령선거","부산광역시","금정구",3024,2265,763,805,375,190,117,1,0,2,1,0,0,0,3,2257,8,759
"909","구서제1동","구서제1동제2투","대통령선거","부산광역시","금정구",3031,2034,640,770,338,169,101,2,0,1,0,1,0,1,1,2024,10,997
"910","구서제1동","구서제1동제3투","대통령선거","부산광역시","금정구",2750,2152,805,627,439,186,88,1,0,0,0,1,1,0,0,2148,4,598
"911","구서제1동","구서제1동제4투","대통령선거","부산광역시","금정구",2650,1946,724,637,348,141,78,3,0,0,0,1,0,1,6,1939,7,704
"912","구서제2동","관내사전투표","대통령선거","부산광역시","금정구",4746,4746,2184,1220,695,339,270,8,0,4,0,2,2,4,3,4731,15,0
"913","구서제2동","구서제2동제1투","대통령선거","부산광역시","금정구",3296,2173,762,741,390,157,108,1,0,0,0,2,0,2,1,2164,9,1123
"914","구서제2동","구서제2동제2투","대통령선거","부산광역시","금정구",2634,1950,629,722,347,149,92,2,0,0,0,0,0,2,0,1943,7,684
"915","구서제2동","구서제2동제3투","대통령선거","부산광역시","금정구",2971,2150,743,769,337,179,108,0,0,0,0,0,0,0,4,2140,10,821
"916","구서제2동","구서제2동제4투","대통령선거","부산광역시","금정구",3049,2346,840,819,347,198,123,3,0,1,1,1,0,3,1,2337,9,703
"917","구서제2동","구서제2동제5투","대통령선거","부산광역시","금정구",3090,2398,888,761,418,191,127,3,0,2,0,0,1,0,1,2392,6,692
"918","구서제2동","구서제2동제6투","대통령선거","부산광역시","금정구",3179,2726,1027,880,487,225,103,1,0,1,1,0,0,0,0,2725,1,453
"919","구서제2동","구서제2동제7투","대통령선거","부산광역시","금정구",3491,2870,883,1117,541,239,76,7,0,0,0,1,0,1,1,2866,4,621
"920","금성동","관내사전투표","대통령선거","부산광역시","금정구",235,235,82,86,35,14,13,1,1,0,0,0,0,0,0,232,3,0
"921","금성동","금성동투표소","대통령선거","부산광역시","금정구",695,506,154,218,53,52,25,0,0,0,0,2,0,0,0,504,2,189
"922","잘못 투입·구분된 투표지","잘못 투입·구분된 투표지","대통령선거","부산광역시","금정구",0,0,0,0,0,0,0,0,0,0,0,0,0,0,0,0,0,0
"923","거소·선상투표","거소·선상투표","대통령선거","부산광역시","강서구",204,185,72,35,45,17,6,1,0,1,1,0,0,0,2,180,5,19
"924","관외사전투표","관외사전투표","대통령선거","부산광역시","강서구",9386,9385,4538,2129,1335,746,554,12,1,3,5,4,4,4,12,9347,38,1
"925","재외투표","재외투표","대통령선거","부산광역시","강서구",583,392,235,35,53,21,45,1,1,0,0,0,0,0,0,391,1,191
"926","대저1동","관내사전투표","대통령선거","부산광역시","강서구",866,866,342,315,116,44,34,2,1,0,0,0,0,0,1,855,11,0
"927","대저1동","대저1동제1투","대통령선거","부산광역시","강서구",1268,698,247,299,102,28,13,1,0,3,1,0,0,3,0,697,1,570
"928","대저1동","대저1동제2투","대통령선거","부산광역시","강서구",1037,668,193,333,90,20,16,1,0,2,0,0,1,2,0,658,10,369
"929","대저1동","대저1동제3투","대통령선거","부산광역시","강서구",1276,839,259,392,120,40,19,0,1,0,1,0,0,1,2,835,4,437
"930","대저1동","대저1동제4투","대통령선거","부산광역시","강서구",967,627,192,276,103,28,22,0,0,1,0,0,0,2,0,624,3,340
"931","대저1동","대저1동제5투","대통령선거","부산광역시","강서구",827,523,186,206,100,19,11,0,0,0,0,0,0,0,0,522,1,304
"932","대저2동","관내사전투표","대통령선거","부산광역시","강서구",1062,1062,453,302,144,93,58,4,1,1,0,0,0,1,3,1060,2,0
"933","대저2동","대저2동제1투","대통령선거","부산광역시","강서구",1529,1046,383,331,183,92,48,0,0,1,0,1,0,1,1,1041,5,483
"934","대저2동","대저2동제2투","대통령선거","부산광역시","강서구",1286,846,260,385,128,42,25,0,0,1,0,0,0,0,0,841,5,440
"935","대저2동","대저2동제3투","대통령선거","부산광역시","강서구",1437,970,347,432,120,42,23,0,0,0,0,1,1,0,0,966,4,467
"936","대저2동","대저2동제4투","대통령선거","부산광역시","강서구",1157,761,242,347,100,40,27,0,0,1,1,0,0,1,0,759,2,396
"937","강동동","관내사전투표","대통령선거","부산광역시","강서구",686,686,283,251,87,39,20,0,0,1,0,0,0,1,2,684,2,0
"938","강동동","강동동제1투","대통령선거","부산광역시","강서구",947,582,203,244,89,23,17,0,0,0,1,0,0,0,0,577,5,365
"939","강동동","강동동제2투","대통령선거","부산광역시","강서구",1005,685,224,316,85,28,20,1,0,0,0,0,0,3,1,678,7,320
"940","강동동","강동동제3투","대통령선거","부산광역시","강서구",785,503,138,249,73,30,11,0,0,0,0,1,0,0,1,503,0,282
"941","강동동","강동동제4투","대통령선거","부산광역시","강서구",1163,681,252,278,92,30,25,1,0,0,0,0,1,0,1,680,1,482
"942","명지동","관내사전투표","대통령선거","부산광역시","강서구",5134,5134,2941,875,664,379,257,1,0,1,0,1,1,1,2,5123,11,0
"943","명지동","명지동제1투","대통령선거","부산광역시","강서구",2792,1696,462,844,237,81,51,3,0,4,0,0,2,2,1,1687,9,1096
"944","명지동","명지동제2투","대통령선거","부산광역시","강서구",2525,1949,981,330,343,176,112,0,0,0,0,1,0,0,2,1945,4,576
"945","명지동","명지동제3투","대통령선거","부산광역시","강서구",1820,1447,721,247,241,153,82,0,0,1,0,1,0,0,0,1446,1,373
"946","명지동","명지동제4투","대통령선거","부산광역시","강서구",1636,1217,611,240,193,95,70,4,0,0,0,0,0,0,0,1213,4,419
"947","명지동","명지동제5투","대통령선거","부산광역시","강서구",3452,2745,1374,566,466,206,125,2,0,0,1,0,2,0,0,2742,3,707
"948","명지동","명지동제6투","대통령선거","부산광역시","강서구",1895,1543,808,236,280,137,78,0,1,0,1,0,0,0,1,1542,1,352
"949","명지동","명지동제7투","대통령선거","부산광역시","강서구",2086,1734,799,409,300,157,64,0,0,0,0,0,0,2,1,1732,2,352
"950","명지동","명지동제8투","대통령선거","부산광역시","강서구",1963,1550,543,521,299,124,56,5,0,0,0,0,0,0,0,1548,2,413
"951","명지동","명지동제9투","대통령선거","부산광역시","강서구",2133,1761,739,490,303,140,83,4,0,1,0,0,0,0,0,1760,1,372
"952","명지동","명지동제10투","대통령선거","부산광역시","강서구",1951,1604,799,341,272,128,59,1,0,0,1,0,0,1,1,1603,1,347
"953","명지동","명지동제11투","대통령선거","부산광역시","강서구",2079,1661,840,302,292,149,73,0,0,0,0,0,0,0,2,1658,3,418
"954","명지동","명지동제12투","대통령선거","부산광역시","강서구",3067,2425,1256,475,380,189,115,1,0,1,1,0,0,1,2,2421,4,642
"955","명지동","명지동제13투","대통령선거","부산광역시","강서구",3298,2659,1402,502,409,219,119,0,0,0,1,1,1,1,1,2656,3,639
"956","가락동","관내사전투표","대통령선거","부산광역시","강서구",378,378,184,112,61,9,11,0,0,0,0,0,0,0,0,377,1,0
"957","가락동","가락동제1투","대통령선거","부산광역시","강서구",1034,654,221,315,70,34,11,1,0,2,0,0,0,0,0,654,0,380
"958","가락동","가락동제2투","대통령선거","부산광역시","강서구",746,499,154,223,84,21,13,1,0,0,0,0,0,0,1,497,2,247
"959","녹산동","관내사전투표","대통령선거","부산광역시","강서구",1341,1341,698,298,193,80,62,2,0,2,0,0,1,0,1,1337,4,0
"960","녹산동","녹산동제1투","대통령선거","부산광역시","강서구",761,460,124,240,64,14,9,1,0,2,0,0,0,1,2,457,3,301
"961","녹산동","녹산동제2투","대통령선거","부산광역시","강서구",1556,906,278,406,130,50,30,1,0,1,1,2,0,1,1,901,5,650
"962","녹산동","녹산동제3투","대통령선거","부산광역시","강서구",839,506,155,246,50,30,20,0,0,0,0,2,0,1,1,505,1,333
"963","녹산동","녹산동제4투","대통령선거","부산광역시","강서구",2129,1488,690,262,287,144,97,1,0,0,0,1,1,1,1,1485,3,641
"964","녹산동","녹산동제5투","대통령선거","부산광역시","강서구",2928,1859,784,510,334,120,94,3,0,0,1,0,1,3,2,1852,7,1069
"965","녹산동","녹산동제6투","대통령선거","부산광역시","강서구",3840,2698,1267,598,464,208,149,0,1,0,2,0,1,1,2,2693,5,1142
"966","녹산동","녹산동제7투","대통령선거","부산광역시","강서구",3921,2843,1314,637,499,209,164,4,1,0,1,2,0,0,3,2834,9,1078
"967","녹산동","녹산동제8투","대통령선거","부산광역시","강서구",2851,2018,935,500,341,128,97,3,1,3,0,1,1,0,2,2012,6,833
"968","가덕도동","관내사전투표","대통령선거","부산광역시","강서구",354,354,179,107,33,17,14,0,0,0,0,0,0,0,1,351,3,0
"969","가덕도동","가덕도동제1투","대통령선거","부산광역시","강서구",1124,645,230,271,75,33,26,0,0,1,0,1,0,3,1,641,4,479
"970","가덕도동","가덕도동제2투","대통령선거","부산광역시","강서구",858,531,146,288,55,21,10,2,0,0,1,0,1,1,2,527,4,327
"971","가덕도동","가덕도동제3투","대통령선거","부산광역시","강서구",556,323,99,165,45,2,9,0,0,0,0,0,0,0,0,320,3,233
"972","잘못 투입·구분된 투표지","잘못 투입·구분된 투표지","대통령선거","부산광역시","강서구",0,0,0,0,0,0,0,0,0,0,0,0,0,0,0,0,0,0
"973","거소·선상투표","거소·선상투표","대통령선거","부산광역시","연제구",417,383,136,88,117,21,9,1,1,1,0,0,0,0,1,375,8,34
"974","관외사전투표","관외사전투표","대통령선거","부산광역시","연제구",15105,15105,6912,3178,2528,1343,996,13,4,9,1,9,2,7,22,15024,81,0
"975","재외투표","재외투표","대통령선거","부산광역시","연제구",1045,825,519,41,132,41,90,0,0,2,0,0,0,0,0,825,0,220
"976","거제제1동","관내사전투표","대통령선거","부산광역시","연제구",2718,2718,1371,577,406,196,157,5,0,1,0,2,0,0,1,2716,2,0
"977","거제제1동","거제제1동제1투","대통령선거","부산광역시","연제구",2629,2108,850,604,375,161,111,2,0,0,0,0,0,1,1,2105,3,521
"978","거제제1동","거제제1동제2투","대통령선거","부산광역시","연제구",3452,2802,1048,970,446,207,117,3,0,0,1,0,0,1,0,2793,9,650
"979","거제제1동","거제제1동제3투","대통령선거","부산광역시","연제구",2452,1802,614,657,348,98,70,1,0,0,0,0,0,1,0,1789,13,650
"980","거제제1동","거제제1동제4투","대통령선거","부산광역시","연제구",2288,1890,799,526,357,133,66,0,0,0,0,0,0,0,1,1882,8,398
"981","거제제1동","거제제1동제5투","대통령선거","부산광역시","연제구",2619,2209,947,602,389,169,89,5,0,0,0,0,0,0,1,2202,7,410
"982","거제제1동","거제제1동제6투","대통령선거","부산광역시","연제구",1567,965,307,376,171,63,44,1,0,0,1,0,0,0,0,963,2,602
"983","거제제1동","거제제1동제7투","대통령선거","부산광역시","연제구",2612,2224,762,703,482,179,92,0,0,0,0,0,0,0,1,2219,5,388
"984","거제제2동","관내사전투표","대통령선거","부산광역시","연제구",2006,2006,842,631,298,139,87,1,0,0,1,0,0,1,0,2000,6,0
"985","거제제2동","거제제2동제1투","대통령선거","부산광역시","연제구",2177,1504,509,582,218,121,66,2,0,0,0,0,1,2,0,1501,3,673
"986","거제제2동","거제제2동제2투","대통령선거","부산광역시","연제구",1782,1390,529,412,261,137,45,0,0,0,0,0,0,1,1,1386,4,392
"987","거제제2동","거제제2동제3투","대통령선거","부산광역시","연제구",1998,1539,533,560,268,100,64,7,0,0,0,1,0,0,1,1534,5,459
"988","거제제2동","거제제2동제4투","대통령선거","부산광역시","연제구",1412,1118,400,367,216,87,37,0,0,1,0,1,1,1,3,1114,4,294
"989","거제제3동","관내사전투표","대통령선거","부산광역시","연제구",1831,1831,753,601,270,116,78,0,0,0,0,0,1,2,2,1823,8,0
"990","거제제3동","거제제3동제1투","대통령선거","부산광역시","연제구",2417,1775,610,623,302,142,91,0,1,0,0,1,0,1,1,1772,3,642
"991","거제제3동","거제제3동제2투","대통령선거","부산광역시","연제구",2399,1595,453,704,281,88,60,0,0,2,0,0,1,4,0,1593,2,804
"992","거제제3동","거제제3동제3투","대통령선거","부산광역시","연제구",2232,1653,525,669,275,105,65,3,0,1,0,0,0,0,2,1645,8,579
"993","거제제4동","관내사전투표","대통령선거","부산광역시","연제구",1622,1622,725,430,242,130,86,0,0,1,0,1,0,1,0,1616,6,0
"994","거제제4동","거제제4동제1투","대통령선거","부산광역시","연제구",3492,2556,873,921,433,197,112,3,0,2,1,3,0,2,1,2548,8,936
"995","거제제4동","거제제4동제2투","대통령선거","부산광역시","연제구",1402,1008,383,304,199,61,54,1,0,0,3,0,0,0,0,1005,3,394
"996","거제제4동","거제제4동제3투","대통령선거","부산광역시","연제구",2407,1751,537,723,268,120,80,2,0,1,1,2,1,0,3,1738,13,656
"997","연산제1동","관내사전투표","대통령선거","부산광역시","연제구",2198,2198,1002,565,344,160,112,1,0,0,0,3,0,1,2,2190,8,0
"998","연산제1동","연산제1동제1투","대통령선거","부산광역시","연제구",2681,2008,613,810,359,116,96,0,1,3,1,1,0,0,1,2001,7,673
"999","연산제1동","연산제1동제2투","대통령선거","부산광역시","연제구",2494,1649,556,655,270,93,64,0,0,1,0,0,0,2,2,1643,6,845
"1000","연산제1동","연산제1동제3투","대통령선거","부산광역시","연제구",2396,1580,491,660,262,93,64,0,0,1,0,1,1,0,2,1575,5,816
"1001","연산제1동","연산제1동제4투","대통령선거","부산광역시","연제구",2912,2426,991,682,453,209,81,4,0,0,0,0,0,0,0,2420,6,486
"1002","연산제2동","관내사전투표","대통령선거","부산광역시","연제구",2539,2539,1208,597,379,187,152,2,0,0,0,0,0,1,1,2527,12,0
"1003","연산제2동","연산제2동제1투","대통령선거","부산광역시","연제구",2306,1721,587,672,285,103,68,0,0,0,0,0,2,0,2,1719,2,585
"1004","연산제2동","연산제2동제2투","대통령선거","부산광역시","연제구",1827,1237,334,555,205,72,62,2,0,0,0,0,2,1,1,1234,3,590
"1005","연산제2동","연산제2동제3투","대통령선거","부산광역시","연제구",2315,1607,490,709,250,98,51,2,0,1,0,0,0,1,2,1604,3,708
"1006","연산제2동","연산제2동제4투","대통령선거","부산광역시","연제구",2325,1515,520,522,265,122,77,0,0,1,0,0,1,2,2,1512,3,810
"1007","연산제3동","관내사전투표","대통령선거","부산광역시","연제구",1127,1127,475,322,177,78,62,1,0,0,0,0,1,1,0,1117,10,0
"1008","연산제3동","연산제3동제1투","대통령선거","부산광역시","연제구",2336,1539,457,651,259,99,63,0,1,1,0,0,2,1,0,1534,5,797
"1009","연산제3동","연산제3동제2투","대통령선거","부산광역시","연제구",2819,1890,560,743,338,122,108,5,1,1,0,0,1,0,2,1881,9,929
"1010","연산제3동","연산제3동제3투","대통령선거","부산광역시","연제구",1736,1132,417,429,173,62,38,0,0,2,0,0,2,1,1,1125,7,604
"1011","연산제4동","관내사전투표","대통령선거","부산광역시","연제구",2433,2432,1023,784,338,159,118,2,1,2,0,1,0,0,0,2428,4,1
"1012","연산제4동","연산제4동제1투","대통령선거","부산광역시","연제구",3526,2493,879,895,424,160,125,1,0,0,0,1,0,0,3,2488,5,1033
"1013","연산제4동","연산제4동제2투","대통령선거","부산광역시","연제구",2724,1749,566,729,289,91,61,2,0,2,0,1,1,1,1,1744,5,975
"1014","연산제4동","연산제4동제3투","대통령선거","부산광역시","연제구",3159,2042,616,824,385,121,76,2,0,1,0,0,0,0,2,2027,15,1117
"1015","연산제4동","연산제4동제4투","대통령선거","부산광역시","연제구",2572,1850,605,677,336,144,77,0,0,1,0,0,0,0,1,1841,9,722
"1016","연산제5동","관내사전투표","대통령선거","부산광역시","연제구",2007,2007,948,507,258,143,135,1,0,2,0,1,0,0,2,1997,10,0
"1017","연산제5동","연산제5동제1투","대통령선거","부산광역시","연제구",3591,2337,831,763,413,187,129,3,0,0,0,0,0,0,0,2326,11,1254
"1018","연산제5동","연산제5동제2투","대통령선거","부산광역시","연제구",3852,2553,914,835,461,157,165,1,0,1,1,0,2,0,2,2539,14,1299
"1019","연산제5동","연산제5동제3투","대통령선거","부산광역시","연제구",2371,1509,570,511,217,111,88,3,1,1,0,0,0,0,0,1502,7,862
"1020","연산제6동","관내사전투표","대통령선거","부산광역시","연제구",1555,1555,683,471,236,94,61,3,0,0,1,0,0,2,0,1551,4,0
"1021","연산제6동","연산제6동제1투","대통령선거","부산광역시","연제구",1764,1200,378,493,207,73,40,3,0,0,1,0,0,0,0,1195,5,564
"1022","연산제6동","연산제6동제2투","대통령선거","부산광역시","연제구",2791,1934,560,827,320,102,102,2,1,2,0,1,2,2,3,1924,10,857
"1023","연산제6동","연산제6동제3투","대통령선거","부산광역시","연제구",2186,1253,406,496,225,80,41,0,0,1,1,0,0,0,1,1251,2,933
"1024","연산제6동","연산제6동제4투","대통령선거","부산광역시","연제구",1899,1308,419,518,244,68,46,2,0,2,0,2,0,0,0,1301,7,591
"1025","연산제6동","연산제6동제5투","대통령선거","부산광역시","연제구",2312,1641,570,592,282,106,80,0,0,0,0,3,1,0,1,1635,6,671
"1026","연산제8동","관내사전투표","대통령선거","부산광역시","연제구",1744,1744,937,300,242,139,113,2,0,3,0,0,0,2,3,1741,3,0
"1027","연산제8동","연산제8동제1투","대통령선거","부산광역시","연제구",2552,1690,513,677,312,101,73,3,0,2,0,0,0,1,1,1683,7,862
"1028","연산제8동","연산제8동제2투","대통령선거","부산광역시","연제구",2626,1803,577,677,326,105,105,0,0,2,1,0,0,1,4,1798,5,823
"1029","연산제8동","연산제8동제3투","대통령선거","부산광역시","연제구",1769,1219,361,532,201,63,50,4,1,0,0,2,0,1,0,1215,4,550
"1030","연산제8동","연산제8동제4투","대통령선거","부산광역시","연제구",2759,2245,998,497,418,207,106,6,0,1,0,0,1,1,2,2237,8,514
"1031","연산제9동","관내사전투표","대통령선거","부산광역시","연제구",3634,3634,1687,935,510,265,213,6,1,0,0,4,0,1,4,3626,8,0
"1032","연산제9동","연산제9동제1투","대통령선거","부산광역시","연제구",2359,1514,456,599,273,110,65,4,1,0,1,0,0,1,0,1510,4,845
"1033","연산제9동","연산제9동제2투","대통령선거","부산광역시","연제구",2303,1767,591,630,308,155,73,0,0,1,0,1,0,0,2,1761,6,536
"1034","연산제9동","연산제9동제3투","대통령선거","부산광역시","연제구",2316,1732,583,623,319,101,96,0,0,0,1,3,0,1,1,1728,4,584
"1035","연산제9동","연산제9동제4투","대통령선거","부산광역시","연제구",2960,2340,928,715,394,190,104,1,0,0,0,0,0,0,3,2335,5,620
"1036","연산제9동","연산제9동제5투","대통령선거","부산광역시","연제구",3421,2564,824,896,464,233,123,3,0,1,2,0,1,3,2,2552,12,857
"1037","연산제9동","연산제9동제6투","대통령선거","부산광역시","연제구",2521,1699,591,633,286,113,67,1,0,0,0,1,0,0,3,1695,4,822
"1038","연산제9동","연산제9동제7투","대통령선거","부산광역시","연제구",2431,1590,565,527,295,111,81,1,0,0,0,2,0,1,1,1584,6,841
"1039","연산제9동","연산제9동제8투","대통령선거","부산광역시","연제구",3059,2412,879,749,439,188,137,5,0,2,0,5,0,1,2,2407,5,647
"1040","연산제9동","연산제9동제9투","대통령선거","부산광역시","연제구",1217,1020,283,424,220,65,26,1,0,0,0,0,0,0,0,1019,1,197
"1041","연산제9동","연산제9동제10투","대통령선거","부산광역시","연제구",2760,2219,1075,464,378,190,105,1,0,0,1,0,0,0,1,2215,4,541
"1042","잘못 투입·구분된 투표지","잘못 투입·구분된 투표지","대통령선거","부산광역시","연제구",0,0,0,0,0,0,0,0,0,0,0,0,0,0,0,0,0,0
"1043","거소·선상투표","거소·선상투표","대통령선거","부산광역시","수영구",386,361,126,79,116,22,8,1,0,0,0,1,0,1,0,354,7,25
"1044","관외사전투표","관외사전투표","대통령선거","부산광역시","수영구",13409,13408,6067,2923,2150,1193,952,18,2,8,2,4,5,1,17,13342,66,1
"1045","재외투표","재외투표","대통령선거","부산광역시","수영구",1197,888,561,78,115,42,88,3,0,0,0,0,0,0,0,887,1,309
"1046","남천제1동","관내사전투표","대통령선거","부산광역시","수영구",1597,1597,716,424,226,127,99,1,0,0,0,1,0,0,0,1594,3,0
"1047","남천제1동","남천제1동제1투","대통령선거","부산광역시","수영구",2027,1336,376,565,239,84,64,3,0,0,0,0,0,1,0,1332,4,691
"1048","남천제1동","남천제1동제2투","대통령선거","부산광역시","수영구",2766,2074,685,749,383,177,67,6,0,0,0,1,1,1,0,2070,4,692
"1049","남천제1동","남천제1동제3투","대통령선거","부산광역시","수영구",2631,1936,658,658,359,138,104,4,1,0,1,0,1,1,0,1925,11,695
"1050","남천제1동","남천제1동제4투","대통령선거","부산광역시","수영구",2483,1739,614,622,299,118,76,3,0,0,0,1,1,1,0,1735,4,744
"1051","남천제2동","관내사전투표","대통령선거","부산광역시","수영구",2630,2630,1110,741,403,220,142,2,0,1,0,2,0,2,1,2624,6,0
"1052","남천제2동","남천제2동제1투","대통령선거","부산광역시","수영구",2525,1869,655,636,373,132,59,6,0,1,0,0,0,0,0,1862,7,656
"1053","남천제2동","남천제2동제2투","대통령선거","부산광역시","수영구",2884,2060,623,811,393,135,77,6,1,3,0,4,0,1,1,2055,5,824
"1054","남천제2동","남천제2동제3투","대통령선거","부산광역시","수영구",2881,1985,593,795,387,145,59,1,0,0,0,3,0,0,1,1984,1,896
"1055","수영동","관내사전투표","대통령선거","부산광역시","수영구",2395,2395,955,851,308,138,119,6,0,4,0,0,1,3,5,2390,5,0
"1056","수영동","수영동제1투","대통령선거","부산광역시","수영구",2773,1677,503,721,287,87,67,4,0,2,0,0,0,0,1,1672,5,1096
"1057","수영동","수영동제2투","대통령선거","부산광역시","수영구",3191,2240,700,905,383,154,83,4,0,2,1,1,0,0,3,2236,4,951
"1058","수영동","수영동제3투","대통령선거","부산광역시","수영구",2747,1964,585,863,314,128,65,2,0,1,0,0,0,2,1,1961,3,783
"1059","수영동","수영동제4투","대통령선거","부산광역시","수영구",2279,1794,606,689,302,131,55,3,0,0,0,2,0,0,2,1790,4,485
"1060","망미제1동","관내사전투표","대통령선거","부산광역시","수영구",3371,3371,1381,1057,534,223,158,2,0,1,0,1,0,0,3,3360,11,0
"1061","망미제1동","망미제1동제1투","대통령선거","부산광역시","수영구",3201,2298,718,878,415,184,86,2,0,4,1,2,1,0,0,2291,7,903
"1062","망미제1동","망미제1동제2투","대통령선거","부산광역시","수영구",2373,1764,526,728,301,127,71,3,1,0,0,0,0,0,1,1758,6,609
"1063","망미제1동","망미제1동제3투","대통령선거","부산광역시","수영구",2685,1892,603,800,298,118,61,1,0,1,0,0,0,1,3,1886,6,793
"1064","망미제1동","망미제1동제4투","대통령선거","부산광역시","수영구",2530,1773,576,677,310,109,87,0,0,0,0,2,1,2,2,1766,7,757
"1065","망미제1동","망미제1동제5투","대통령선거","부산광역시","수영구",2065,1423,441,602,223,83,67,3,0,0,0,0,0,0,0,1419,4,642
"1066","망미제1동","망미제1동제6투","대통령선거","부산광역시","수영구",2464,1649,540,644,277,105,77,1,0,0,0,0,0,1,0,1645,4,815
"1067","망미제1동","망미제1동제7투","대통령선거","부산광역시","수영구",2423,1743,559,662,321,106,82,4,0,1,0,1,1,0,1,1738,5,680
"1068","망미제2동","관내사전투표","대통령선거","부산광역시","수영구",1151,1151,484,330,184,68,71,3,0,3,0,0,0,1,1,1145,6,0
"1069","망미제2동","망미제2동제1투","대통령선거","부산광역시","수영구",2681,1749,513,743,306,87,80,3,0,1,0,4,1,1,3,1742,7,932
"1070","망미제2동","망미제2동제2투","대통령선거","부산광역시","수영구",2952,2334,928,641,446,191,109,8,0,0,0,0,1,1,4,2329,5,618
"1071","망미제2동","망미제2동제3투","대통령선거","부산광역시","수영구",2971,2103,643,849,389,122,85,0,1,2,0,1,0,2,4,2098,5,868
"1072","광안제1동","관내사전투표","대통령선거","부산광역시","수영구",3475,3474,1589,859,539,237,228,6,0,0,1,1,1,2,1,3464,10,1
"1073","광안제1동","광안제1동제1투","대통령선거","부산광역시","수영구",4077,2674,1021,859,454,183,141,2,1,5,0,0,1,1,1,2669,5,1403
"1074","광안제1동","광안제1동제2투","대통령선거","부산광역시","수영구",3062,2328,835,792,424,145,115,2,0,0,1,0,0,2,3,2319,9,734
"1075","광안제1동","광안제1동제3투","대통령선거","부산광역시","수영구",3027,2333,807,765,445,199,104,4,0,0,1,0,0,0,2,2327,6,694
"1076","광안제1동","광안제1동제4투","대통령선거","부산광역시","수영구",3480,2247,838,708,391,169,124,1,0,2,0,1,0,0,2,2236,11,1233
"1077","광안제1동","광안제1동제5투","대통령선거","부산광역시","수영구",3151,2102,732,763,348,117,124,6,0,3,0,0,0,0,3,2096,6,1049
"1078","광안제2동","관내사전투표","대통령선거","부산광역시","수영구",2967,2967,1286,830,463,202,164,6,1,5,1,0,0,3,1,2962,5,0
"1079","광안제2동","광안제2동제1투","대통령선거","부산광역시","수영구",3701,2502,855,839,486,203,108,1,0,0,2,0,0,1,2,2497,5,1199
"1080","광안제2동","광안제2동제2투","대통령선거","부산광역시","수영구",2159,1445,490,523,244,102,72,1,0,1,1,0,1,2,2,1439,6,714
"1081","광안제2동","광안제2동제3투","대통령선거","부산광역시","수영구",2870,1963,671,656,399,130,98,3,1,0,0,0,0,0,0,1958,5,907
"1082","광안제2동","광안제2동제4투","대통령선거","부산광역시","수영구",2946,1966,698,650,339,150,111,1,0,0,1,1,0,0,2,1953,13,980
"1083","광안제3동","관내사전투표","대통령선거","부산광역시","수영구",1489,1489,663,424,202,105,86,1,0,1,0,0,0,0,2,1484,5,0
"1084","광안제3동","광안제3동제1투","대통령선거","부산광역시","수영구",2889,1751,625,574,288,133,119,3,0,0,2,3,0,1,1,1749,2,1138
"1085","광안제3동","광안제3동제2투","대통령선거","부산광역시","수영구",2374,1629,484,658,309,90,76,0,0,0,1,0,2,0,1,1621,8,745
"1086","광안제3동","광안제3동제3투","대통령선거","부산광역시","수영구",1847,1251,337,553,222,82,43,0,1,1,0,0,0,1,0,1240,11,596
"1087","광안제4동","관내사전투표","대통령선거","부산광역시","수영구",2238,2238,911,672,357,170,120,0,0,2,0,0,0,0,0,2232,6,0
"1088","광안제4동","광안제4동제1투","대통령선거","부산광역시","수영구",3491,2316,821,772,380,183,138,4,0,3,1,0,0,1,3,2306,10,1175
"1089","광안제4동","광안제4동제2투","대통령선거","부산광역시","수영구",1982,1411,481,520,253,78,70,3,0,0,0,0,0,1,1,1407,4,571
"1090","광안제4동","광안제4동제3투","대통령선거","부산광역시","수영구",2661,1810,636,650,313,114,81,4,0,3,0,0,0,2,1,1804,6,851
"1091","민락동","관내사전투표","대통령선거","부산광역시","수영구",2956,2956,1207,1019,425,153,136,1,0,1,0,0,1,3,1,2947,9,0
"1092","민락동","민락동제1투","대통령선거","부산광역시","수영구",3222,1953,656,730,335,142,76,1,0,1,0,0,0,0,5,1946,7,1269
"1093","민락동","민락동제2투","대통령선거","부산광역시","수영구",2505,1582,509,622,278,90,74,2,0,2,0,0,0,3,0,1580,2,923
"1094","민락동","민락동제3투","대통령선거","부산광역시","수영구",2643,1677,553,608,295,133,80,1,0,2,0,0,1,1,1,1675,2,966
"1095","민락동","민락동제4투","대통령선거","부산광역시","수영구",3002,2041,655,801,359,116,92,6,0,2,1,0,1,0,1,2034,7,961
"1096","민락동","민락동제5투","대통령선거","부산광역시","수영구",3003,2344,802,834,435,162,101,6,0,0,0,0,0,0,1,2341,3,659
"1097","민락동","민락동제6투","대통령선거","부산광역시","수영구",1752,1411,495,430,294,132,53,3,0,1,0,1,0,0,0,1409,2,341
"1098","잘못 투입·구분된 투표지","잘못 투입·구분된 투표지","대통령선거","부산광역시","수영구",0,1,0,0,1,0,0,0,0,0,0,0,0,0,0,1,0,-1
"1099","거소·선상투표","거소·선상투표","대통령선거","부산광역시","사상구",482,453,172,84,125,27,21,0,3,2,0,1,2,1,1,439,14,29
"1100","관외사전투표","관외사전투표","대통령선거","부산광역시","사상구",14428,14421,6988,2805,2164,1329,954,12,3,5,2,10,6,3,30,14311,110,7
"1101","재외투표","재외투표","대통령선거","부산광역시","사상구",784,629,408,42,88,21,68,1,0,0,0,0,0,1,0,629,0,155
"1102","삼락동","관내사전투표","대통령선거","부산광역시","사상구",660,660,295,186,96,30,45,0,0,1,0,0,1,1,1,656,4,0
"1103","삼락동","삼락동제1투","대통령선거","부산광역시","사상구",839,574,162,263,93,25,24,3,0,0,1,0,0,0,1,572,2,265
"1104","삼락동","삼락동제2투","대통령선거","부산광역시","사상구",2142,1191,446,439,180,60,53,0,0,1,0,0,1,1,2,1183,8,951
"1105","삼락동","삼락동제3투","대통령선거","부산광역시","사상구",2007,1241,459,452,202,59,54,1,0,1,0,0,1,1,1,1231,10,766
"1106","모라제1동","관내사전투표","대통령선거","부산광역시","사상구",3407,3407,1692,887,426,208,175,1,0,2,0,3,0,2,2,3398,9,0
"1107","모라제1동","모라제1동제1투","대통령선거","부산광역시","사상구",3057,2288,895,727,372,154,121,1,1,2,0,1,0,1,3,2278,10,769
"1108","모라제1동","모라제1동제2투","대통령선거","부산광역시","사상구",2991,2290,897,758,345,148,114,4,0,2,1,2,0,1,3,2275,15,701
"1109","모라제1동","모라제1동제3투","대통령선거","부산광역시","사상구",2615,1923,711,672,306,140,82,1,0,0,0,1,0,0,1,1914,9,692
"1110","모라제1동","모라제1동제4투","대통령선거","부산광역시","사상구",3061,2220,898,695,324,182,106,0,0,2,0,0,0,0,1,2208,12,841
"1111","모라제1동","모라제1동제5투","대통령선거","부산광역시","사상구",2666,1635,560,621,259,102,81,0,0,0,3,1,2,0,2,1631,4,1031
"1112","모라제1동","모라제1동제6투","대통령선거","부산광역시","사상구",1946,1255,411,521,179,78,44,2,0,4,2,1,1,0,5,1248,7,691
"1113","모라제1동","모라제1동제7투","대통령선거","부산광역시","사상구",1712,1165,365,489,200,59,39,2,0,0,1,1,1,1,0,1158,7,547
"1114","모라제1동","모라제1동제8투","대통령선거","부산광역시","사상구",1738,1119,357,493,154,66,36,0,0,1,1,0,1,0,1,1110,9,619
"1115","모라제3동","관내사전투표","대통령선거","부산광역시","사상구",1772,1771,807,536,250,107,53,1,2,4,0,1,0,2,0,1763,8,1
"1116","모라제3동","모라제3동제1투","대통령선거","부산광역시","사상구",2837,1942,732,691,312,105,75,2,0,2,0,0,1,1,2,1923,19,895
"1117","모라제3동","모라제3동제2투","대통령선거","부산광역시","사상구",2267,1487,439,650,257,82,36,4,0,3,1,0,2,0,2,1476,11,780
"1118","모라제3동","모라제3동제3투","대통령선거","부산광역시","사상구",2052,1237,425,469,209,76,46,0,0,2,3,1,0,0,1,1232,5,815
"1119","모라제3동","모라제3동제4투","대통령선거","부산광역시","사상구",2209,1535,581,538,250,106,49,2,1,1,0,0,0,0,2,1530,5,674
"1120","덕포제1동","관내사전투표","대통령선거","부산광역시","사상구",2026,2026,850,661,296,121,86,2,0,1,0,2,0,4,1,2024,2,0
"1121","덕포제1동","덕포제1동제1투","대통령선거","부산광역시","사상구",2410,1499,532,562,275,74,42,1,0,2,1,3,0,0,0,1492,7,911
"1122","덕포제1동","덕포제1동제2투","대통령선거","부산광역시","사상구",2432,1385,464,554,237,67,52,1,0,0,0,0,0,0,1,1376,9,1047
"1123","덕포제1동","덕포제1동제3투","대통령선거","부산광역시","사상구",3207,2357,1017,653,393,178,99,3,0,2,0,0,0,0,5,2350,7,850
"1124","덕포제2동","관내사전투표","대통령선거","부산광역시","사상구",1559,1559,742,410,210,112,71,2,0,1,0,0,2,1,0,1551,8,0
"1125","덕포제2동","덕포제2동제1투","대통령선거","부산광역시","사상구",1959,1327,479,460,219,104,51,1,0,4,0,0,0,1,1,1320,7,632
"1126","덕포제2동","덕포제2동제2투","대통령선거","부산광역시","사상구",2027,1415,570,471,218,87,55,0,0,3,0,0,0,2,2,1408,7,612
"1127","덕포제2동","덕포제2동제3투","대통령선거","부산광역시","사상구",2889,1968,766,664,334,109,80,0,0,0,0,1,0,1,2,1957,11,921
"1128","덕포제2동","덕포제2동제4투","대통령선거","부산광역시","사상구",2722,1931,758,640,314,121,84,4,0,2,0,0,1,1,1,1926,5,791
"1129","괘법동","관내사전투표","대통령선거","부산광역시","사상구",2081,2081,1086,477,251,140,114,2,1,1,0,2,1,0,2,2077,4,0
"1130","괘법동","괘법동제1투","대통령선거","부산광역시","사상구",3160,1976,702,731,300,131,99,1,0,0,1,0,0,0,1,1966,10,1184
"1131","괘법동","괘법동제2투","대통령선거","부산광역시","사상구",2780,1562,568,578,248,93,61,0,0,1,0,1,0,3,3,1556,6,1218
"1132","괘법동","괘법동제3투","대통령선거","부산광역시","사상구",3762,2311,876,802,365,151,95,2,2,0,0,1,3,1,3,2301,10,1451
"1133","괘법동","괘법동제4투","대통령선거","부산광역시","사상구",2965,2142,877,665,353,131,98,3,0,3,0,1,0,0,4,2135,7,823
"1134","괘법동","괘법동제5투","대통령선거","부산광역시","사상구",3063,2296,965,709,337,173,95,0,0,1,1,2,0,0,2,2285,11,767
"1135","감전동","관내사전투표","대통령선거","부산광역시","사상구",1643,1643,731,503,217,94,85,1,0,0,0,0,0,1,2,1634,9,0
"1136","감전동","감전동제1투","대통령선거","부산광역시","사상구",2993,1866,672,729,271,125,58,1,1,1,0,1,0,0,2,1861,5,1127
"1137","감전동","감전동제2투","대통령선거","부산광역시","사상구",2562,1631,524,771,208,70,40,0,2,1,0,1,1,1,1,1620,11,931
"1138","감전동","감전동제3투","대통령선거","부산광역시","사상구",2614,1632,538,681,234,91,76,2,0,1,0,1,0,0,4,1628,4,982
"1139","감전동","감전동제4투","대통령선거","부산광역시","사상구",2346,1409,466,554,236,81,58,0,1,1,0,0,0,0,2,1399,10,937
"1140","주례제1동","관내사전투표","대통령선거","부산광역시","사상구",1768,1768,859,454,232,124,88,1,1,2,0,3,1,0,0,1765,3,0
"1141","주례제1동","주례제1동제1투","대통령선거","부산광역시","사상구",1553,884,307,356,133,47,32,2,0,1,0,0,0,1,0,879,5,669
"1142","주례제1동","주례제1동제2투","대통령선거","부산광역시","사상구",2744,1943,724,706,296,122,84,2,0,0,0,0,0,1,3,1938,5,801
"1143","주례제1동","주례제1동제3투","대통령선거","부산광역시","사상구",2994,2191,844,750,324,157,98,2,0,0,0,0,2,3,2,2182,9,803
"1144","주례제1동","주례제1동제4투","대통령선거","부산광역시","사상구",3109,2272,901,744,349,150,112,2,0,0,0,0,1,2,6,2267,5,837
"1145","주례제2동","관내사전투표","대통령선거","부산광역시","사상구",1665,1665,821,371,201,128,131,1,0,3,0,1,0,0,2,1659,6,0
"1146","주례제2동","주례제2동제1투","대통령선거","부산광역시","사상구",2173,1455,526,523,191,110,88,4,0,0,0,2,0,0,3,1447,8,718
"1147","주례제2동","주례제2동제2투","대통령선거","부산광역시","사상구",2713,1520,530,547,222,110,96,1,0,1,0,1,1,0,1,1510,10,1193
"1148","주례제2동","주례제2동제3투","대통령선거","부산광역시","사상구",2164,1481,534,549,232,76,79,0,0,0,0,1,2,1,2,1476,5,683
"1149","주례제2동","주례제2동제4투","대통령선거","부산광역시","사상구",1379,854,304,349,119,46,26,1,0,0,0,2,0,0,1,848,6,525
"1150","주례제2동","주례제2동제5투","대통령선거","부산광역시","사상구",2703,2187,906,607,384,183,100,2,0,0,0,0,0,0,1,2183,4,516
"1151","주례제2동","주례제2동제6투","대통령선거","부산광역시","사상구",2977,2356,1031,686,370,169,85,0,0,3,0,1,1,1,2,2349,7,621
"1152","주례제2동","주례제2동제7투","대통령선거","부산광역시","사상구",3248,2713,1214,719,467,165,134,2,0,2,0,0,0,1,3,2707,6,535
"1153","주례제3동","관내사전투표","대통령선거","부산광역시","사상구",1930,1930,960,424,260,151,117,0,0,1,0,0,0,0,0,1913,17,0
"1154","주례제3동","주례제3동제1투","대통령선거","부산광역시","사상구",2322,1524,559,562,241,93,52,2,0,1,1,0,1,0,1,1513,11,798
"1155","주례제3동","주례제3동제2투","대통령선거","부산광역시","사상구",3451,2702,1085,834,460,172,138,1,0,2,0,1,1,0,1,2695,7,749
"1156","주례제3동","주례제3동제3투","대통령선거","부산광역시","사상구",2200,1661,623,562,267,119,76,4,0,0,0,1,1,0,1,1654,7,539
"1157","주례제3동","주례제3동제4투","대통령선거","부산광역시","사상구",1677,1143,355,485,168,77,46,0,0,2,1,0,0,0,3,1137,6,534
"1158","학장동","관내사전투표","대통령선거","부산광역시","사상구",2818,2818,1452,646,376,181,145,2,0,4,0,0,0,1,2,2809,9,0
"1159","학장동","학장동제1투","대통령선거","부산광역시","사상구",2647,2029,807,658,342,119,89,2,0,2,3,1,0,0,1,2024,5,618
"1160","학장동","학장동제2투","대통령선거","부산광역시","사상구",1881,1088,355,465,173,56,31,0,0,0,0,2,0,0,1,1083,5,793
"1161","학장동","학장동제3투","대통령선거","부산광역시","사상구",3830,2908,1199,924,433,185,146,2,0,1,1,2,1,0,3,2897,11,922
"1162","학장동","학장동제4투","대통령선거","부산광역시","사상구",2387,1678,678,550,264,94,71,6,0,1,0,0,0,1,5,1670,8,709
"1163","학장동","학장동제5투","대통령선거","부산광역시","사상구",2908,2236,859,742,387,149,87,2,0,2,0,0,1,1,1,2231,5,672
"1164","학장동","학장동제6투","대통령선거","부산광역시","사상구",2179,1470,569,504,218,91,67,1,0,4,1,3,0,2,2,1462,8,709
"1165","학장동","학장동제7투","대통령선거","부산광역시","사상구",2706,2007,848,607,300,145,89,5,0,3,0,2,1,0,0,2000,7,699
"1166","학장동","학장동제8투","대통령선거","부산광역시","사상구",3463,2688,1142,716,465,205,137,3,0,2,0,3,0,0,5,2678,10,775
"1167","엄궁동","관내사전투표","대통령선거","부산광역시","사상구",4091,4091,2043,1004,536,274,207,2,1,3,0,1,1,0,1,4073,18,0
"1168","엄궁동","엄궁동제1투","대통령선거","부산광역시","사상구",2629,1825,749,538,312,107,106,1,0,3,0,0,0,1,3,1820,5,804
"1169","엄궁동","엄궁동제2투","대통령선거","부산광역시","사상구",2393,1419,481,539,249,73,64,1,0,0,1,1,1,0,1,1411,8,974
"1170","엄궁동","엄궁동제3투","대통령선거","부산광역시","사상구",2796,1942,721,659,302,140,99,0,1,3,1,1,0,0,3,1930,12,854
"1171","엄궁동","엄궁동제4투","대통령선거","부산광역시","사상구",2542,1642,635,550,243,116,88,3,0,0,0,2,0,0,3,1640,2,900
"1172","엄궁동","엄궁동제5투","대통령선거","부산광역시","사상구",3256,2586,1200,623,397,205,145,1,0,1,0,2,1,0,3,2578,8,670
"1173","엄궁동","엄궁동제6투","대통령선거","부산광역시","사상구",2544,1909,849,484,319,139,103,3,0,1,0,1,1,3,1,1904,5,635
"1174","엄궁동","엄궁동제7투","대통령선거","부산광역시","사상구",3486,2824,1190,810,484,201,125,1,0,1,1,2,1,1,1,2818,6,662
"1175","잘못 투입·구분된 투표지","잘못 투입·구분된 투표지","대통령선거","부산광역시","사상구",0,0,0,0,0,0,0,0,0,0,0,0,0,0,0,0,0,0
"1176","거소·선상투표","거소·선상투표","대통령선거","충청북도","청주시상당구",373,353,126,67,96,15,13,4,3,2,2,1,1,2,4,336,17,20
"1177","관외사전투표","관외사전투표","대통령선거","충청북도","청주시상당구",11477,11476,5328,1832,2261,931,979,12,2,1,6,9,8,2,20,11391,85,1
"1178","재외투표","재외투표","대통령선거","충청북도","청주시상당구",577,444,267,36,73,18,48,0,0,0,0,0,1,0,0,443,1,133
"1179","중앙동","관내사전투표","대통령선거","충청북도","청주시상당구",992,992,445,271,158,51,59,4,0,0,0,0,0,1,1,990,2,0
"1180","중앙동","중앙동제1투","대통령선거","충청북도","청주시상당구",2030,1274,398,433,279,78,75,2,0,2,0,0,0,1,0,1268,6,756
"1181","중앙동","중앙동제2투","대통령선거","충청북도","청주시상당구",2165,1421,397,558,319,70,69,1,0,0,0,0,1,0,2,1417,4,744
"1182","성안동","관내사전투표","대통령선거","충청북도","청주시상당구",1449,1449,572,446,242,75,103,1,0,0,0,3,1,0,1,1444,5,0
"1183","성안동","성안동제1투","대통령선거","충청북도","청주시상당구",2231,1274,346,523,287,51,52,3,1,2,1,1,0,2,2,1271,3,957
"1184","성안동","성안동제2투","대통령선거","충청북도","청주시상당구",2312,1438,378,597,305,64,79,6,1,2,0,0,0,1,1,1434,4,874
"1185","탑·대성동","관내사전투표","대통령선거","충청북도","청주시상당구",1108,1108,450,344,201,51,54,1,0,1,0,2,0,2,0,1106,2,0
"1186","탑·대성동","탑·대성동제1투","대통령선거","충청북도","청주시상당구",2303,1440,413,529,317,81,88,0,0,1,3,1,1,0,1,1435,5,863
"1187","탑·대성동","탑·대성동제2투","대통령선거","충청북도","청주시상당구",2182,1460,443,505,327,87,89,1,0,1,0,1,1,1,0,1456,4,722
"1188","탑·대성동","탑·대성동제3투","대통령선거","충청북도","청주시상당구",2269,1353,455,413,287,92,82,4,1,0,1,3,1,2,3,1344,9,916
"1189","용담·명암·산성동","관내사전투표","대통령선거","충청북도","청주시상당구",1904,1904,893,371,374,115,140,2,0,0,1,0,2,2,1,1901,3,0
"1190","용담·명암·산성동","용담·명암·산성동제1투","대통령선거","충청북도","청주시상당구",2260,1400,474,438,294,89,96,0,0,0,1,0,0,1,0,1393,7,860
"1191","용담·명암·산성동","용담·명암·산성동제2투","대통령선거","충청북도","청주시상당구",3905,2974,1323,599,609,206,212,5,2,0,0,0,2,1,3,2962,12,931
"1192","금천동","관내사전투표","대통령선거","충청북도","청주시상당구",4163,4163,1877,917,727,293,321,1,0,0,1,5,1,1,1,4145,18,0
"1193","금천동","금천동제1투","대통령선거","충청북도","청주시상당구",1991,1262,361,506,271,43,64,3,0,1,2,2,1,1,2,1257,5,729
"1194","금천동","금천동제2투","대통령선거","충청북도","청주시상당구",2079,1360,476,415,310,72,71,1,0,2,0,3,0,0,2,1352,8,719
"1195","금천동","금천동제3투","대통령선거","충청북도","청주시상당구",3325,2504,983,642,550,153,163,0,0,0,2,0,0,2,2,2497,7,821
"1196","금천동","금천동제4투","대통령선거","충청북도","청주시상당구",2296,1515,536,427,343,94,100,0,1,2,0,0,1,0,1,1505,10,781
"1197","금천동","금천동제5투","대통령선거","충청북도","청주시상당구",2320,1673,663,392,369,107,127,0,0,2,1,0,3,1,1,1666,7,647
"1198","금천동","금천동제6투","대통령선거","충청북도","청주시상당구",3225,2315,1018,451,481,156,196,2,1,0,2,0,0,2,2,2311,4,910
"1199","금천동","금천동제7투","대통령선거","충청북도","청주시상당구",2305,1729,798,304,377,114,131,1,0,0,1,1,0,1,0,1728,1,576
"1200","금천동","금천동제8투","대통령선거","충청북도","청주시상당구",2333,1858,892,360,365,117,117,0,0,0,1,1,0,1,2,1856,2,475
"1201","영운동","관내사전투표","대통령선거","충청북도","청주시상당구",1645,1644,717,388,311,90,120,4,0,1,0,1,1,3,1,1637,7,1
"1202","영운동","영운동제1투","대통령선거","충청북도","청주시상당구",2673,1737,564,535,422,90,110,3,1,1,1,3,1,0,1,1732,5,936
"1203","영운동","영운동제2투","대통령선거","충청북도","청주시상당구",2622,1677,606,476,365,87,127,0,0,1,1,0,0,2,1,1666,11,945
"1204","영운동","영운동제3투","대통령선거","충청북도","청주시상당구",2439,1641,599,471,365,87,103,2,1,2,1,2,0,0,2,1635,6,798
"1205","용암제1동","관내사전투표","대통령선거","충청북도","청주시상당구",4524,4524,2189,870,797,305,339,5,1,4,2,1,1,1,2,4517,7,0
"1206","용암제1동","용암제1동제1투","대통령선거","충청북도","청주시상당구",2896,1881,658,493,473,110,131,1,0,1,1,0,1,0,3,1872,9,1015
"1207","용암제1동","용암제1동제2투","대통령선거","충청북도","청주시상당구",3810,2682,1064,668,569,171,192,6,1,2,0,0,0,1,3,2677,5,1128
"1208","용암제1동","용암제1동제3투","대통령선거","충청북도","청주시상당구",2916,1945,728,484,417,152,144,1,0,2,1,2,0,3,3,1937,8,971
"1209","용암제1동","용암제1동제4투","대통령선거","충청북도","청주시상당구",2392,1608,483,549,386,72,82,5,1,1,2,0,1,4,2,1588,20,784
"1210","용암제1동","용암제1동제5투","대통령선거","충청북도","청주시상당구",3391,2456,1165,451,511,156,160,1,0,1,0,2,2,0,1,2450,6,935
"1211","용암제1동","용암제1동제6투","대통령선거","충청북도","청주시상당구",3054,1862,773,400,421,116,145,3,0,1,0,1,0,1,0,1861,1,1192
"1212","용암제1동","용암제1동제7투","대통령선거","충청북도","청주시상당구",3165,2458,1037,510,531,167,199,1,0,1,0,1,0,0,1,2448,10,707
"1213","용암제1동","용암제1동제8투","대통령선거","충청북도","청주시상당구",4158,2941,1277,598,612,206,235,5,1,1,0,1,0,0,1,2937,4,1217
"1214","용암제2동","관내사전투표","대통령선거","충청북도","청주시상당구",3025,3025,1525,503,525,191,261,1,0,2,2,3,0,0,1,3014,11,0
"1215","용암제2동","용암제2동제1투","대통령선거","충청북도","청주시상당구",2609,1656,693,330,374,113,129,6,0,1,0,0,0,1,4,1651,5,953
"1216","용암제2동","용암제2동제2투","대통령선거","충청북도","청주시상당구",3220,2401,1033,463,549,164,173,0,1,2,0,3,2,0,3,2393,8,819
"1217","용암제2동","용암제2동제3투","대통령선거","충청북도","청주시상당구",3264,2532,1059,559,533,158,200,2,1,1,1,2,2,2,2,2522,10,732
"1218","용암제2동","용암제2동제4투","대통령선거","충청북도","청주시상당구",1700,1101,359,346,252,52,51,2,2,0,1,1,2,7,5,1080,21,599
"1219","용암제2동","용암제2동제5투","대통령선거","충청북도","청주시상당구",3311,2339,1067,438,474,166,179,4,0,0,0,1,2,3,1,2335,4,972
"1220","낭성면","관내사전투표","대통령선거","충청북도","청주시상당구",390,390,130,144,73,13,26,1,0,0,0,0,0,1,1,389,1,0
"1221","낭성면","낭성면투표소","대통령선거","충청북도","청주시상당구",1570,998,238,489,182,40,36,1,1,0,0,3,1,1,2,994,4,572
"1222","미원면","관내사전투표","대통령선거","충청북도","청주시상당구",1014,1014,316,388,197,35,40,5,1,1,1,7,2,3,8,1004,10,0
"1223","미원면","미원면제1투","대통령선거","충청북도","청주시상당구",1332,725,218,276,158,30,29,1,0,0,2,1,0,2,2,719,6,607
"1224","미원면","미원면제2투","대통령선거","충청북도","청주시상당구",1583,1002,289,402,202,40,38,0,1,2,0,19,1,0,4,998,4,581
"1225","미원면","미원면제3투","대통령선거","충청북도","청주시상당구",617,442,111,201,92,18,15,1,0,2,0,0,0,0,2,442,0,175
"1226","가덕면","관내사전투표","대통령선거","충청북도","청주시상당구",477,477,183,153,81,29,25,0,0,0,0,0,1,1,1,474,3,0
"1227","가덕면","가덕면제1투","대통령선거","충청북도","청주시상당구",1341,887,247,347,186,43,47,2,0,1,0,2,0,4,3,882,5,454
"1228","가덕면","가덕면제2투","대통령선거","충청북도","청주시상당구",751,493,158,188,96,19,27,0,0,1,0,0,0,4,0,493,0,258
"1229","가덕면","가덕면제3투","대통령선거","충청북도","청주시상당구",1078,722,229,267,154,21,26,3,0,2,1,1,2,1,1,708,14,356
"1230","남일면","관내사전투표","대통령선거","충청북도","청주시상당구",1090,1090,462,271,193,69,85,2,0,1,0,0,0,2,0,1085,5,0
"1231","남일면","남일면제1투","대통령선거","충청북도","청주시상당구",2288,1532,509,492,324,106,84,1,0,1,0,1,4,2,1,1525,7,756
"1232","남일면","남일면제2투","대통령선거","충청북도","청주시상당구",790,533,157,193,118,22,34,4,0,2,1,0,1,0,0,532,1,257
"1233","남일면","남일면제3투","대통령선거","충청북도","청주시상당구",1752,1194,365,400,295,50,68,0,1,0,0,0,4,1,3,1187,7,558
"1234","문의면","관내사전투표","대통령선거","충청북도","청주시상당구",741,741,261,250,147,29,38,0,0,3,0,1,0,4,5,738,3,0
"1235","문의면","문의면제1투","대통령선거","충청북도","청주시상당구",2136,1341,366,536,293,49,69,4,1,0,0,2,5,4,5,1334,7,795
"1236","문의면","문의면제2투","대통령선거","충청북도","청주시상당구",742,486,161,203,83,20,11,1,0,0,1,1,2,2,0,485,1,256
"1237","잘못 투입·구분된 투표지","잘못 투입·구분된 투표지","대통령선거","충청북도","청주시상당구",0,0,0,0,0,0,0,0,0,0,0,0,0,0,0,0,0,0
"1238","거소·선상투표","거소·선상투표","대통령선거","충청북도","청주시서원구",461,428,158,70,131,27,11,4,3,1,3,0,4,3,1,416,12,33
"1239","관외사전투표","관외사전투표","대통령선거","충청북도","청주시서원구",16458,16455,7745,2494,3326,1275,1406,10,2,7,6,18,6,4,30,16329,126,3
"1240","재외투표","재외투표","대통령선거","충청북도","청주시서원구",739,585,401,26,77,22,56,1,0,0,0,1,0,1,0,585,0,154
"1241","남이면","관내사전투표","대통령선거","충청북도","청주시서원구",936,936,392,261,186,31,54,7,0,0,0,0,0,1,1,933,3,0
"1242","남이면","남이면제1투","대통령선거","충청북도","청주시서원구",2325,1442,465,510,336,62,52,3,0,1,0,0,2,3,2,1436,6,883
"1243","남이면","남이면제2투","대통령선거","충청북도","청주시서원구",984,639,188,247,136,26,36,1,1,0,0,0,1,0,0,636,3,345
"1244","남이면","남이면제3투","대통령선거","충청북도","청주시서원구",2777,1908,663,519,435,140,136,2,1,1,1,0,0,0,4,1902,6,869
"1245","현도면","관내사전투표","대통령선거","충청북도","청주시서원구",512,512,170,132,159,24,22,0,1,0,1,0,0,0,1,510,2,0
"1246","현도면","현도면제1투","대통령선거","충청북도","청주시서원구",1584,1020,249,405,289,23,35,0,1,1,0,0,1,4,3,1011,9,564
"1247","현도면","현도면제2투","대통령선거","충청북도","청주시서원구",938,545,165,188,144,14,28,0,0,0,0,0,0,1,3,543,2,393
"1248","사직1동","관내사전투표","대통령선거","충청북도","청주시서원구",1188,1188,488,310,237,64,77,2,0,1,1,2,1,0,0,1183,5,0
"1249","사직1동","사직1동제1투","대통령선거","충청북도","청주시서원구",1882,1124,324,424,258,50,57,2,0,1,0,1,1,1,1,1120,4,758
"1250","사직1동","사직1동제2투","대통령선거","충청북도","청주시서원구",1989,1302,424,430,306,57,74,2,0,1,1,1,1,0,0,1297,5,687
"1251","사직1동","사직1동제3투","대통령선거","충청북도","청주시서원구",2500,1823,607,576,446,103,76,1,2,0,2,4,0,0,0,1817,6,677
"1252","사직2동","관내사전투표","대통령선거","충청북도","청주시서원구",1394,1394,618,329,268,65,99,1,0,0,1,2,0,0,3,1386,8,0
"1253","사직2동","사직2동제1투","대통령선거","충청북도","청주시서원구",1497,976,287,362,219,41,56,2,1,1,1,1,0,1,0,972,4,521
"1254","사직2동","사직2동제2투","대통령선거","충청북도","청주시서원구",1889,1198,374,393,276,51,88,4,0,0,0,3,0,1,3,1193,5,691
"1255","사직2동","사직2동제3투","대통령선거","충청북도","청주시서원구",3087,2504,954,659,588,153,137,2,0,1,0,1,1,0,0,2496,8,583
"1256","사직2동","사직2동제4투","대통령선거","충청북도","청주시서원구",2914,2391,990,525,550,175,138,7,0,0,0,1,1,0,0,2387,4,523
"1257","사창동","관내사전투표","대통령선거","충청북도","청주시서원구",3825,3825,1815,696,698,290,294,2,0,2,0,5,1,0,4,3807,18,0
"1258","사창동","사창동제1투","대통령선거","충청북도","청주시서원구",2813,1557,575,402,358,113,96,3,1,1,0,1,1,1,1,1553,4,1256
"1259","사창동","사창동제2투","대통령선거","충청북도","청주시서원구",3039,2142,854,556,431,127,154,2,0,0,1,4,2,1,5,2137,5,897
"1260","사창동","사창동제3투","대통령선거","충청북도","청주시서원구",3054,1973,649,628,457,107,115,2,0,0,2,3,1,1,1,1966,7,1081
"1261","사창동","사창동제4투","대통령선거","충청북도","청주시서원구",1739,1054,365,324,228,51,83,0,0,0,0,0,0,0,0,1051,3,685
"1262","모충동","관내사전투표","대통령선거","충청북도","청주시서원구",1547,1547,645,374,280,104,125,4,1,2,1,1,0,1,0,1538,9,0
"1263","모충동","모충동제1투","대통령선거","충청북도","청주시서원구",3429,2074,715,627,480,128,106,5,0,1,1,0,0,3,1,2067,7,1355
"1264","모충동","모충동제2투","대통령선거","충청북도","청주시서원구",1841,1081,367,336,232,70,70,0,1,2,0,1,0,0,0,1079,2,760
"1265","모충동","모충동제3투","대통령선거","충청북도","청주시서원구",3458,2359,919,631,514,127,151,3,3,1,0,3,1,0,1,2354,5,1099
"1266","모충동","모충동제4투","대통령선거","충청북도","청주시서원구",2634,1679,496,635,361,87,87,4,0,0,1,2,1,1,0,1675,4,955
"1267","산남동","관내사전투표","대통령선거","충청북도","청주시서원구",3421,3421,1841,472,575,236,285,1,0,1,0,1,0,0,3,3415,6,0
"1268","산남동","산남동제1투","대통령선거","충청북도","청주시서원구",2813,1827,697,437,448,112,123,3,0,1,1,0,0,0,2,1824,3,986
"1269","산남동","산남동제2투","대통령선거","충청북도","청주시서원구",2813,2064,694,649,442,138,125,0,0,0,0,2,1,2,1,2054,10,749
"1270","산남동","산남동제3투","대통령선거","충청북도","청주시서원구",3530,2693,1340,410,563,154,211,1,0,1,1,1,0,1,1,2684,9,837
"1271","산남동","산남동제4투","대통령선거","충청북도","청주시서원구",3315,2407,1110,490,497,157,144,0,0,1,0,2,0,0,0,2401,6,908
"1272","산남동","산남동제5투","대통령선거","충청북도","청주시서원구",3031,2412,1181,338,542,166,174,1,1,0,0,0,1,0,2,2406,6,619
"1273","분평동","관내사전투표","대통령선거","충청북도","청주시서원구",5983,5983,2884,984,1152,435,484,9,1,2,1,10,1,2,2,5967,16,0
"1274","분평동","분평동제1투","대통령선거","충청북도","청주시서원구",877,592,181,236,119,32,19,0,0,2,0,0,0,1,0,590,2,285
"1275","분평동","분평동제2투","대통령선거","충청북도","청주시서원구",3189,2322,1009,426,531,146,196,3,0,1,1,2,0,1,2,2318,4,867
"1276","분평동","분평동제3투","대통령선거","충청북도","청주시서원구",2908,2083,904,384,484,141,149,2,2,1,0,1,2,0,2,2072,11,825
"1277","분평동","분평동제4투","대통령선거","충청북도","청주시서원구",2759,2065,928,370,428,144,176,2,0,1,0,5,1,1,2,2058,7,694
"1278","분평동","분평동제5투","대통령선거","충청북도","청주시서원구",2620,1935,749,445,453,141,131,4,1,0,0,2,3,1,3,1933,2,685
"1279","분평동","분평동제6투","대통령선거","충청북도","청주시서원구",2633,1991,900,369,440,148,128,0,0,0,0,0,0,0,0,1985,6,642
"1280","분평동","분평동제7투","대통령선거","충청북도","청주시서원구",3030,2353,1032,444,535,142,191,0,0,0,0,2,0,1,0,2347,6,677
"1281","수곡1동","관내사전투표","대통령선거","충청북도","청주시서원구",1809,1808,821,379,340,123,122,8,1,4,3,1,1,1,3,1807,1,1
"1282","수곡1동","수곡1동제1투","대통령선거","충청북도","청주시서원구",2601,1717,619,479,381,98,114,3,1,0,5,0,2,1,1,1704,13,884
"1283","수곡1동","수곡1동제2투","대통령선거","충청북도","청주시서원구",2669,1737,652,490,398,79,98,4,1,1,2,1,3,1,2,1732,5,932
"1284","수곡1동","수곡1동제3투","대통령선거","충청북도","청주시서원구",2613,1673,535,568,398,59,96,4,2,1,1,1,2,0,1,1668,5,940
"1285","수곡1동","수곡1동제4투","대통령선거","충청북도","청주시서원구",2441,1628,584,541,326,66,96,1,0,4,1,0,1,0,0,1620,8,813
"1286","수곡2동","관내사전투표","대통령선거","충청북도","청주시서원구",2740,2740,1111,645,579,168,205,4,0,2,2,2,1,1,0,2720,20,0
"1287","수곡2동","수곡2동제1투","대통령선거","충청북도","청주시서원구",2578,1627,635,401,348,112,110,1,0,7,1,0,0,0,1,1616,11,951
"1288","수곡2동","수곡2동제2투","대통령선거","충청북도","청주시서원구",2555,1757,624,481,408,109,125,1,0,0,2,2,2,0,0,1754,3,798
"1289","수곡2동","수곡2동제3투","대통령선거","충청북도","청주시서원구",2443,1704,570,499,427,86,101,3,1,2,1,1,1,2,3,1697,7,739
"1290","수곡2동","수곡2동제4투","대통령선거","충청북도","청주시서원구",2160,1456,490,464,347,69,69,3,0,0,1,0,0,0,2,1445,11,704
"1291","성화·개신·죽림동","관내사전투표","대통령선거","충청북도","청주시서원구",5284,5284,2715,822,943,363,401,4,1,2,0,6,1,1,5,5264,20,0
"1292","성화·개신·죽림동","성화·개신·죽림동제1투","대통령선거","충청북도","청주시서원구",3802,2553,1111,511,577,143,193,2,0,2,0,1,0,2,0,2542,11,1249
"1293","성화·개신·죽림동","성화·개신·죽림동제2투","대통령선거","충청북도","청주시서원구",2876,2145,822,579,439,153,141,2,0,0,0,0,1,1,0,2138,7,731
"1294","성화·개신·죽림동","성화·개신·죽림동제3투","대통령선거","충청북도","청주시서원구",2766,2046,743,610,429,109,142,3,0,2,0,0,3,0,0,2041,5,720
"1295","성화·개신·죽림동","성화·개신·죽림동제4투","대통령선거","충청북도","청주시서원구",3450,2743,1265,509,574,166,217,0,0,3,0,2,1,0,2,2739,4,707
"1296","성화·개신·죽림동","성화·개신·죽림동제5투","대통령선거","충청북도","청주시서원구",3083,2300,1071,416,481,145,170,2,0,4,0,0,0,1,3,2293,7,783
"1297","성화·개신·죽림동","성화·개신·죽림동제6투","대통령선거","충청북도","청주시서원구",1794,1338,543,295,304,85,100,2,0,2,2,0,0,1,1,1335,3,456
"1298","성화·개신·죽림동","성화·개신·죽림동제7투","대통령선거","충청북도","청주시서원구",2682,1673,691,374,397,87,115,0,0,0,0,1,1,0,2,1668,5,1009
"1299","성화·개신·죽림동","성화·개신·죽림동제8투","대통령선거","충청북도","청주시서원구",2229,1595,678,278,400,117,115,2,0,0,0,0,0,0,1,1591,4,634
"1300","성화·개신·죽림동","성화·개신·죽림동제9투","대통령선거","충청북도","청주시서원구",2659,1616,727,314,352,82,130,0,0,1,0,1,1,0,2,1610,6,1043
"1301","성화·개신·죽림동","성화·개신·죽림동제10투","대통령선거","충청북도","청주시서원구",2611,2031,1002,293,449,141,139,6,0,0,0,1,0,0,0,2031,0,580
"1302","잘못 투입·구분된 투표지","잘못 투입·구분된 투표지","대통령선거","충청북도","청주시서원구",0,0,0,0,0,0,0,0,0,0,0,0,0,0,0,0,0,0
"1303","거소·선상투표","거소·선상투표","대통령선거","충청북도","청주시흥덕구",427,406,130,68,118,24,17,3,1,1,3,3,6,1,3,378,28,21
"1304","관외사전투표","관외사전투표","대통령선거","충청북도","청주시흥덕구",17703,17695,8301,2429,3609,1465,1617,17,5,5,7,16,9,11,48,17539,156,8
"1305","재외투표","재외투표","대통령선거","충청북도","청주시흥덕구",900,728,443,39,128,30,82,2,0,0,0,0,1,1,0,726,2,172
"1306","오송읍","관내사전투표","대통령선거","충청북도","청주시흥덕구",2322,2322,1291,304,414,132,165,3,0,0,0,5,0,3,1,2318,4,0
"1307","오송읍","오송읍제1투","대통령선거","충청북도","청주시흥덕구",1456,917,310,243,222,60,66,3,0,0,0,3,0,2,2,911,6,539
"1308","오송읍","오송읍제2투","대통령선거","충청북도","청주시흥덕구",1486,946,317,305,218,42,51,0,0,0,0,3,2,1,2,941,5,540
"1309","오송읍","오송읍제3투","대통령선거","충청북도","청주시흥덕구",2059,1337,526,334,307,73,78,3,2,1,2,0,3,1,2,1332,5,722
"1310","오송읍","오송읍제4투","대통령선거","충청북도","청주시흥덕구",2294,1697,870,277,341,83,116,1,1,0,0,2,2,0,1,1694,3,597
"1311","오송읍","오송읍제5투","대통령선거","충청북도","청주시흥덕구",2025,1637,847,233,372,89,89,1,0,2,0,1,0,0,1,1635,2,388
"1312","오송읍","오송읍제6투","대통령선거","충청북도","청주시흥덕구",2038,1626,867,180,340,120,106,0,0,1,0,4,0,1,2,1621,5,412
"1313","오송읍","오송읍제7투","대통령선거","충청북도","청주시흥덕구",1054,699,216,223,168,36,36,0,2,0,1,2,1,1,4,690,9,355
"1314","강내면","관내사전투표","대통령선거","충청북도","청주시흥덕구",1826,1826,906,322,354,107,121,2,0,0,0,5,0,1,3,1821,5,0
"1315","강내면","강내면제1투","대통령선거","충청북도","청주시흥덕구",2447,1675,701,356,381,95,123,1,0,0,2,3,0,2,1,1665,10,772
"1316","강내면","강내면제2투","대통령선거","충청북도","청주시흥덕구",1542,991,313,330,224,57,51,2,0,2,0,2,3,0,1,985,6,551
"1317","강내면","강내면제3투","대통령선거","충청북도","청주시흥덕구",2325,1615,598,416,392,84,111,1,1,0,0,4,0,2,1,1610,5,710
"1318","옥산면","관내사전투표","대통령선거","충청북도","청주시흥덕구",1517,1517,707,324,272,70,132,2,1,0,2,0,1,0,1,1512,5,0
"1319","옥산면","옥산면제1투","대통령선거","충청북도","청주시흥덕구",2203,1390,441,469,331,56,81,1,0,0,0,0,1,1,3,1384,6,813
"1320","옥산면","옥산면제2투","대통령선거","충청북도","청주시흥덕구",1546,971,334,330,219,32,44,2,0,0,1,1,0,3,0,966,5,575
"1321","옥산면","옥산면제3투","대통령선거","충청북도","청주시흥덕구",2254,1389,552,324,310,80,108,2,0,2,2,1,1,0,1,1383,6,865
"1322","옥산면","옥산면제4투","대통령선거","충청북도","청주시흥덕구",1520,1184,594,166,237,90,89,2,1,1,0,0,0,0,0,1180,4,336
"1323","운천·신봉동","관내사전투표","대통령선거","충청북도","청주시흥덕구",2028,2028,939,382,383,131,164,1,0,1,2,3,1,2,4,2013,15,0
"1324","운천·신봉동","운천·신봉동제1투","대통령선거","충청북도","청주시흥덕구",2248,1424,492,494,268,75,85,2,0,1,0,0,0,2,2,1421,3,824
"1325","운천·신봉동","운천·신봉동제2투","대통령선거","충청북도","청주시흥덕구",2953,1927,771,432,433,123,151,0,2,4,0,2,1,1,0,1920,7,1026
"1326","운천·신봉동","운천·신봉동제3투","대통령선거","충청북도","청주시흥덕구",3200,2212,851,552,533,112,138,4,0,2,3,4,1,0,3,2203,9,988
"1327","운천·신봉동","운천·신봉동제4투","대통령선거","충청북도","청주시흥덕구",1699,1050,334,339,252,53,60,1,0,4,1,3,0,0,1,1048,2,649
"1328","운천·신봉동","운천·신봉동제5투","대통령선거","충청북도","청주시흥덕구",2941,2125,827,539,436,145,146,1,1,0,2,2,1,0,1,2101,24,816
"1329","복대제1동","관내사전투표","대통령선거","충청북도","청주시흥덕구",6046,6046,3126,811,1132,426,504,3,0,6,2,3,1,0,8,6022,24,0
"1330","복대제1동","복대제1동제1투","대통령선거","충청북도","청주시흥덕구",2617,1703,841,223,384,116,130,0,0,1,0,0,0,2,3,1700,3,914
"1331","복대제1동","복대제1동제2투","대통령선거","충청북도","청주시흥덕구",2456,1930,860,370,432,110,152,0,0,0,0,2,0,0,0,1926,4,526
"1332","복대제1동","복대제1동제3투","대통령선거","충청북도","청주시흥덕구",3144,2134,920,408,441,148,198,3,0,0,0,1,1,2,3,2125,9,1010
"1333","복대제1동","복대제1동제4투","대통령선거","충청북도","청주시흥덕구",1587,987,366,278,197,73,70,0,0,1,1,0,0,0,0,986,1,600
"1334","복대제1동","복대제1동제5투","대통령선거","충청북도","청주시흥덕구",2143,1174,403,341,277,65,82,1,1,0,0,0,0,0,1,1171,3,969
"1335","복대제1동","복대제1동제6투","대통령선거","충청북도","청주시흥덕구",3088,1754,725,328,435,99,155,0,2,1,1,0,0,2,2,1750,4,1334
"1336","복대제1동","복대제1동제7투","대통령선거","충청북도","청주시흥덕구",2670,1986,982,242,437,151,161,3,1,0,0,0,0,0,1,1978,8,684
"1337","복대제1동","복대제1동제8투","대통령선거","충청북도","청주시흥덕구",2661,2081,939,397,453,155,127,1,0,1,1,1,0,0,1,2076,5,580
"1338","복대제1동","복대제1동제9투","대통령선거","충청북도","청주시흥덕구",2385,1763,934,202,356,123,139,0,0,1,0,0,0,0,5,1760,3,622
"1339","복대제1동","복대제1동제10투","대통령선거","충청북도","청주시흥덕구",3824,3017,1325,599,732,212,138,2,0,1,0,1,2,0,2,3014,3,807
"1340","복대제1동","복대제1동제11투","대통령선거","충청북도","청주시흥덕구",3299,2661,1306,371,585,200,188,1,0,0,0,1,0,1,2,2655,6,638
"1341","복대제2동","관내사전투표","대통령선거","충청북도","청주시흥덕구",1955,1955,841,414,366,141,177,3,0,0,0,1,0,0,5,1948,7,0
"1342","복대제2동","복대제2동제1투","대통령선거","충청북도","청주시흥덕구",2769,1782,623,468,433,117,134,2,1,0,0,0,0,0,0,1778,4,987
"1343","복대제2동","복대제2동제2투","대통령선거","충청북도","청주시흥덕구",2104,1324,413,430,309,90,71,0,0,1,0,2,2,0,1,1319,5,780
"1344","복대제2동","복대제2동제3투","대통령선거","충청북도","청주시흥덕구",2635,1609,528,454,408,91,107,4,1,0,1,3,2,0,4,1603,6,1026
"1345","복대제2동","복대제2동제4투","대통령선거","충청북도","청주시흥덕구",2415,1626,586,436,357,112,111,1,0,4,0,6,2,1,1,1617,9,789
"1346","복대제2동","복대제2동제5투","대통령선거","충청북도","청주시흥덕구",2387,1535,556,421,357,100,89,2,1,0,2,0,0,0,1,1529,6,852
"1347","가경동","관내사전투표","대통령선거","충청북도","청주시흥덕구",5945,5945,2885,1052,1064,379,509,9,4,0,4,6,3,2,6,5923,22,0
"1348","가경동","가경동제1투","대통령선거","충청북도","청주시흥덕구",1751,1059,354,331,240,51,68,1,0,2,0,1,0,0,0,1048,11,692
"1349","가경동","가경동제2투","대통령선거","충청북도","청주시흥덕구",2501,1794,635,536,392,105,115,1,0,1,0,1,0,1,2,1789,5,707
"1350","가경동","가경동제3투","대통령선거","충청북도","청주시흥덕구",2876,1998,778,444,460,133,164,3,0,2,0,2,0,1,3,1990,8,878
"1351","가경동","가경동제4투","대통령선거","충청북도","청주시흥덕구",3072,2268,956,418,539,153,182,0,0,2,0,1,1,4,3,2259,9,804
"1352","가경동","가경동제5투","대통령선거","충청북도","청주시흥덕구",3230,2144,860,485,508,115,159,2,0,0,2,1,0,0,0,2132,12,1086
"1353","가경동","가경동제6투","대통령선거","충청북도","청주시흥덕구",3350,2441,1021,432,612,153,206,2,0,2,2,3,0,2,2,2437,4,909
"1354","가경동","가경동제7투","대통령선거","충청북도","청주시흥덕구",2935,1966,820,448,418,120,142,3,0,1,0,1,0,1,1,1955,11,969
"1355","가경동","가경동제8투","대통령선거","충청북도","청주시흥덕구",3664,2716,1288,466,590,162,197,2,0,0,0,1,0,0,4,2710,6,948
"1356","가경동","가경동제9투","대통령선거","충청북도","청주시흥덕구",3116,2252,998,455,482,122,182,3,0,0,1,0,1,0,2,2246,6,864
"1357","가경동","가경동제10투","대통령선거","충청북도","청주시흥덕구",3327,2403,1029,436,576,188,164,0,0,0,1,0,0,0,4,2398,5,924
"1358","봉명제1동","관내사전투표","대통령선거","충청북도","청주시흥덕구",1802,1802,830,313,369,119,157,3,1,0,2,0,0,0,4,1798,4,0
"1359","봉명제1동","봉명제1동제1투","대통령선거","충청북도","청주시흥덕구",2454,1337,507,328,320,68,110,0,0,1,0,0,0,0,0,1334,3,1117
"1360","봉명제1동","봉명제1동제2투","대통령선거","충청북도","청주시흥덕구",2885,1786,635,478,424,110,122,2,0,1,1,0,0,1,4,1778,8,1099
"1361","봉명제1동","봉명제1동제3투","대통령선거","충청북도","청주시흥덕구",2599,1564,561,410,357,92,126,1,1,0,3,0,1,2,2,1556,8,1035
"1362","봉명제2·송정동","관내사전투표","대통령선거","충청북도","청주시흥덕구",2980,2980,1436,500,558,197,261,4,1,2,2,3,0,2,2,2968,12,0
"1363","봉명제2·송정동","봉명제2·송정동제1투","대통령선거","충청북도","청주시흥덕구",2794,1754,565,547,390,114,122,3,0,0,5,0,0,0,2,1748,6,1040
"1364","봉명제2·송정동","봉명제2·송정동제2투","대통령선거","충청북도","청주시흥덕구",2550,1609,551,458,352,89,144,3,2,0,0,3,0,0,1,1603,6,941
"1365","봉명제2·송정동","봉명제2·송정동제3투","대통령선거","충청북도","청주시흥덕구",3368,1918,767,412,458,100,159,2,1,1,2,4,2,0,3,1911,7,1450
"1366","봉명제2·송정동","봉명제2·송정동제4투","대통령선거","충청북도","청주시흥덕구",2181,1467,698,230,276,113,142,0,0,1,0,2,1,0,1,1464,3,714
"1367","봉명제2·송정동","봉명제2·송정동제5투","대통령선거","충청북도","청주시흥덕구",2748,2236,1027,440,453,140,161,2,0,3,0,0,0,0,1,2227,9,512
"1368","봉명제2·송정동","봉명제2·송정동제6투","대통령선거","충청북도","청주시흥덕구",3199,1773,787,315,370,134,156,0,0,0,3,0,0,0,0,1765,8,1426
"1369","강서제1동","관내사전투표","대통령선거","충청북도","청주시흥덕구",3347,3347,1638,599,636,203,248,4,0,1,0,1,1,0,2,3333,14,0
"1370","강서제1동","강서제1동제1투","대통령선거","충청북도","청주시흥덕구",3854,2304,923,574,487,147,154,3,1,1,1,3,2,1,1,2298,6,1550
"1371","강서제1동","강서제1동제2투","대통령선거","충청북도","청주시흥덕구",818,530,136,229,116,21,19,0,1,1,0,0,1,1,2,527,3,288
"1372","강서제1동","강서제1동제3투","대통령선거","충청북도","청주시흥덕구",1156,716,227,261,161,29,28,0,0,3,0,0,1,1,0,711,5,440
"1373","강서제1동","강서제1동제4투","대통령선거","충청북도","청주시흥덕구",3114,2247,1035,369,490,145,195,3,0,2,1,0,0,1,1,2242,5,867
"1374","강서제1동","강서제1동제5투","대통령선거","충청북도","청주시흥덕구",1777,1113,410,280,257,69,81,0,2,2,1,0,2,1,2,1107,6,664
"1375","강서제1동","강서제1동제6투","대통령선거","충청북도","청주시흥덕구",3564,2467,1020,578,547,168,139,3,1,1,1,0,0,0,3,2461,6,1097
"1376","강서제2동","관내사전투표","대통령선거","충청북도","청주시흥덕구",1136,1136,632,84,138,131,139,1,0,0,3,0,0,0,1,1129,7,0
"1377","강서제2동","강서제2동제1투","대통령선거","충청북도","청주시흥덕구",1576,961,355,248,221,64,67,1,1,0,0,0,0,1,0,958,3,615
"1378","강서제2동","강서제2동제2투","대통령선거","충청북도","청주시흥덕구",934,630,165,264,142,24,23,0,0,0,2,0,0,5,1,626,4,304
"1379","잘못 투입·구분된 투표지","잘못 투입·구분된 투표지","대통령선거","충청북도","청주시흥덕구",0,0,0,0,0,0,0,0,0,0,0,0,0,0,0,0,0,0
"1380","거소·선상투표","거소·선상투표","대통령선거","충청북도","청주시청원구",358,334,119,72,98,19,6,0,0,3,1,3,1,0,2,324,10,24
"1381","관외사전투표","관외사전투표","대통령선거","충청북도","청주시청원구",13452,13450,6607,1866,2653,1051,1118,14,2,2,2,8,10,3,33,13369,81,2
"1382","재외투표","재외투표","대통령선거","충청북도","청주시청원구",614,488,326,25,63,20,46,3,1,1,0,0,1,0,0,486,2,126
"1383","내수읍","관내사전투표","대통령선거","충청북도","청주시청원구",2459,2459,1111,549,473,127,156,3,4,3,2,4,1,2,5,2440,19,0
"1384","내수읍","내수읍제1투","대통령선거","충청북도","청주시청원구",2212,1350,520,338,297,71,100,2,1,3,0,3,0,1,3,1339,11,862
"1385","내수읍","내수읍제2투","대통령선거","충청북도","청주시청원구",1315,823,211,308,226,37,29,0,0,0,2,1,0,3,1,818,5,492
"1386","내수읍","내수읍제3투","대통령선거","충청북도","청주시청원구",840,556,170,196,134,21,33,0,0,0,0,0,0,1,0,555,1,284
"1387","내수읍","내수읍제4투","대통령선거","충청북도","청주시청원구",2817,1925,799,336,485,137,152,2,0,0,0,0,0,4,3,1918,7,892
"1388","내수읍","내수읍제5투","대통령선거","충청북도","청주시청원구",1860,1220,416,352,287,60,98,0,0,1,0,0,1,0,1,1216,4,640
"1389","내수읍","내수읍제6투","대통령선거","충청북도","청주시청원구",2852,1709,654,442,382,96,117,2,0,0,1,3,1,1,3,1702,7,1143
"1390","내수읍","내수읍제7투","대통령선거","충청북도","청주시청원구",1256,721,227,259,139,37,44,3,0,0,1,1,1,1,2,715,6,535
"1391","오창읍","관내사전투표","대통령선거","충청북도","청주시청원구",5399,5399,3063,608,952,357,390,1,0,5,2,0,0,1,6,5385,14,0
"1392","오창읍","오창읍제1투","대통령선거","충청북도","청주시청원구",2226,1337,385,467,323,64,84,2,0,0,0,0,3,1,2,1331,6,889
"1393","오창읍","오창읍제2투","대통령선거","충청북도","청주시청원구",2024,1262,422,382,292,75,80,1,0,1,0,0,0,2,1,1256,6,762
"1394","오창읍","오창읍제3투","대통령선거","충청북도","청주시청원구",875,557,172,195,138,25,22,0,1,0,0,0,0,1,1,555,2,318
"1395","오창읍","오창읍제4투","대통령선거","충청북도","청주시청원구",2778,2108,978,369,453,133,165,0,1,2,1,0,0,1,1,2104,4,670
"1396","오창읍","오창읍제5투","대통령선거","충청북도","청주시청원구",2153,1815,865,294,389,130,131,0,0,2,0,0,1,0,1,1813,2,338
"1397","오창읍","오창읍제6투","대통령선거","충청북도","청주시청원구",2335,1933,1034,243,374,142,134,1,1,0,0,1,0,0,0,1930,3,402
"1398","오창읍","오창읍제7투","대통령선거","충청북도","청주시청원구",2649,2172,1189,237,454,156,126,1,0,0,1,2,1,2,1,2170,2,477
"1399","오창읍","오창읍제8투","대통령선거","충청북도","청주시청원구",2395,1960,1064,236,381,133,136,1,0,2,0,1,0,1,1,1956,4,435
"1400","오창읍","오창읍제9투","대통령선거","충청북도","청주시청원구",2519,2088,1131,233,417,121,176,3,0,1,0,1,0,1,0,2084,4,431
"1401","오창읍","오창읍제10투","대통령선거","충청북도","청주시청원구",2576,1627,787,243,328,133,128,1,0,1,1,1,0,1,1,1625,2,949
"1402","오창읍","오창읍제11투","대통령선거","충청북도","청주시청원구",2313,1344,626,222,249,100,134,2,0,1,0,1,1,1,3,1340,4,969
"1403","오창읍","오창읍제12투","대통령선거","충청북도","청주시청원구",2808,1566,735,202,325,155,138,2,0,0,0,1,0,0,2,1560,6,1242
"1404","오창읍","오창읍제13투","대통령선거","충청북도","청주시청원구",2734,1983,1016,257,397,151,153,2,0,1,2,1,0,0,1,1981,2,751
"1405","오창읍","오창읍제14투","대통령선거","충청북도","청주시청원구",1923,1474,804,154,277,108,123,0,0,1,0,2,0,0,2,1471,3,449
"1406","오창읍","오창읍제15투","대통령선거","충청북도","청주시청원구",2398,1880,996,171,392,140,168,3,0,1,0,1,1,1,2,1876,4,518
"1407","북이면","관내사전투표","대통령선거","충청북도","청주시청원구",521,521,210,142,99,24,27,2,1,2,3,4,0,1,4,519,2,0
"1408","북이면","북이면제1투","대통령선거","충청북도","청주시청원구",938,566,172,200,123,24,29,3,1,0,1,2,1,4,2,562,4,372
"1409","북이면","북이면제2투","대통령선거","충청북도","청주시청원구",781,504,130,194,128,16,23,0,0,2,1,2,0,0,2,498,6,277
"1410","북이면","북이면제3투","대통령선거","충청북도","청주시청원구",959,654,209,236,133,22,29,3,0,2,0,1,3,2,3,643,11,305
"1411","북이면","북이면제4투","대통령선거","충청북도","청주시청원구",1009,649,194,237,126,31,34,0,2,1,2,9,1,2,2,641,8,360
"1412","우암동","관내사전투표","대통령선거","충청북도","청주시청원구",1924,1924,794,498,391,93,128,1,2,1,0,0,0,1,2,1911,13,0
"1413","우암동","우암동제1투","대통령선거","충청북도","청주시청원구",1996,1174,356,415,260,61,75,0,0,0,0,1,0,1,1,1170,4,822
"1414","우암동","우암동제2투","대통령선거","충청북도","청주시청원구",1921,1281,411,411,303,67,79,0,0,4,0,0,0,0,1,1276,5,640
"1415","우암동","우암동제3투","대통령선거","충청북도","청주시청원구",1972,1266,346,480,272,81,72,3,2,1,0,0,0,1,1,1259,7,706
"1416","우암동","우암동제4투","대통령선거","충청북도","청주시청원구",2726,1743,549,584,386,97,104,1,1,3,1,0,2,4,6,1738,5,983
"1417","내덕제1동","관내사전투표","대통령선거","충청북도","청주시청원구",1914,1914,775,559,338,101,118,8,0,0,0,2,0,2,3,1906,8,0
"1418","내덕제1동","내덕제1동제1투","대통령선거","충청북도","청주시청원구",2142,1252,383,444,291,57,62,2,0,4,0,0,0,1,0,1244,8,890
"1419","내덕제1동","내덕제1동제2투","대통령선거","충청북도","청주시청원구",2230,1472,457,506,337,92,67,1,0,0,0,0,3,2,2,1467,5,758
"1420","내덕제1동","내덕제1동제3투","대통령선거","충청북도","청주시청원구",2361,1627,483,549,360,101,114,2,0,0,1,3,1,0,2,1616,11,734
"1421","내덕제2동","관내사전투표","대통령선거","충청북도","청주시청원구",1895,1895,820,445,366,105,141,0,0,0,0,2,2,1,2,1884,11,0
"1422","내덕제2동","내덕제2동제1투","대통령선거","충청북도","청주시청원구",2339,1430,452,492,296,79,99,0,0,0,0,0,2,1,2,1423,7,909
"1423","내덕제2동","내덕제2동제2투","대통령선거","충청북도","청주시청원구",2336,1508,542,451,323,82,86,2,0,0,0,1,0,2,10,1499,9,828
"1424","내덕제2동","내덕제2동제3투","대통령선거","충청북도","청주시청원구",3232,2246,883,597,498,102,152,2,1,0,0,1,1,1,3,2241,5,986
"1425","율량·사천동","관내사전투표","대통령선거","충청북도","청주시청원구",6460,6460,3286,1034,1174,446,479,10,2,3,0,5,3,0,5,6447,13,0
"1426","율량·사천동","율량·사천동제1투","대통령선거","충청북도","청주시청원구",2285,1625,644,398,350,104,113,2,0,2,2,1,0,1,2,1619,6,660
"1427","율량·사천동","율량·사천동제2투","대통령선거","충청북도","청주시청원구",2716,1710,655,402,377,114,146,5,0,0,0,4,1,1,1,1706,4,1006
"1428","율량·사천동","율량·사천동제3투","대통령선거","충청북도","청주시청원구",3038,2092,764,511,503,146,149,8,0,2,0,0,1,3,1,2088,4,946
"1429","율량·사천동","율량·사천동제4투","대통령선거","충청북도","청주시청원구",1799,1390,505,378,324,79,93,2,0,1,0,0,1,0,2,1385,5,409
"1430","율량·사천동","율량·사천동제5투","대통령선거","충청북도","청주시청원구",3073,2056,819,482,471,119,138,3,1,4,0,0,2,2,5,2046,10,1017
"1431","율량·사천동","율량·사천동제6투","대통령선거","충청북도","청주시청원구",2332,1680,766,312,354,108,130,0,0,0,0,1,1,0,2,1674,6,652
"1432","율량·사천동","율량·사천동제7투","대통령선거","충청북도","청주시청원구",2728,2024,802,458,451,121,175,0,0,2,3,2,0,1,1,2016,8,704
"1433","율량·사천동","율량·사천동제8투","대통령선거","충청북도","청주시청원구",2357,1680,615,473,383,92,98,0,0,3,0,3,2,2,1,1672,8,677
"1434","율량·사천동","율량·사천동제9투","대통령선거","충청북도","청주시청원구",1366,1108,501,215,224,84,79,0,0,0,0,1,1,0,0,1105,3,258
"1435","율량·사천동","율량·사천동제10투","대통령선거","충청북도","청주시청원구",1629,1140,586,134,252,72,94,0,0,0,0,0,0,0,0,1138,2,489
"1436","율량·사천동","율량·사천동제11투","대통령선거","충청북도","청주시청원구",2127,1602,654,323,383,98,138,0,0,0,1,2,0,0,1,1600,2,525
"1437","율량·사천동","율량·사천동제12투","대통령선거","충청북도","청주시청원구",1907,1440,639,228,339,104,120,1,0,2,0,3,0,1,0,1437,3,467
"1438","율량·사천동","율량·사천동제13투","대통령선거","충청북도","청주시청원구",2001,1428,644,279,307,91,98,0,1,1,1,3,1,0,1,1427,1,573
"1439","오근장동","관내사전투표","대통령선거","충청북도","청주시청원구",810,810,368,177,169,33,55,0,1,0,0,0,2,0,0,805,5,0
"1440","오근장동","오근장동제1투","대통령선거","충청북도","청주시청원구",2076,1265,412,439,292,45,60,1,1,0,0,4,4,1,0,1259,6,811
"1441","오근장동","오근장동제2투","대통령선거","충청북도","청주시청원구",3057,2452,1234,357,517,149,183,3,2,1,1,2,1,0,0,2450,2,605
"1442","오근장동","오근장동제3투","대통령선거","충청북도","청주시청원구",3295,2241,976,461,514,120,150,0,0,0,1,1,4,0,2,2229,12,1054
"1443","오근장동","오근장동제4투","대통령선거","충청북도","청주시청원구",2389,1958,1024,269,411,126,125,0,0,1,0,0,0,0,1,1957,1,431
"1444","잘못 투입·구분된 투표지","잘못 투입·구분된 투표지","대통령선거","충청북도","청주시청원구",0,0,0,0,0,0,0,0,0,0,0,0,0,0,0,0,0,0
"1445","거소·선상투표","거소·선상투표","대통령선거","충청북도","충주시",323,303,93,63,91,20,10,0,0,1,0,0,2,2,3,285,18,20
"1446","관외사전투표","관외사전투표","대통령선거","충청북도","충주시",11511,11511,4951,1848,2443,983,1105,17,3,8,2,8,4,7,27,11406,105,0
"1447","재외투표","재외투표","대통령선거","충청북도","충주시",669,551,335,36,74,23,81,2,0,0,0,0,0,0,0,551,0,118
"1448","주덕읍","관내사전투표","대통령선거","충청북도","충주시",862,862,287,269,202,42,50,0,0,1,1,2,0,0,2,856,6,0
"1449","주덕읍","주덕읍제1투","대통령선거","충청북도","충주시",1243,760,204,301,189,31,28,0,0,0,0,0,0,0,0,753,7,483
"1450","주덕읍","주덕읍제2투","대통령선거","충청북도","충주시",1447,844,213,321,223,36,41,1,0,1,0,0,3,1,0,840,4,603
"1451","주덕읍","주덕읍제3투","대통령선거","충청북도","충주시",1169,756,207,284,190,26,26,1,0,1,2,2,1,3,2,745,11,413
"1452","살미면","관내사전투표","대통령선거","충청북도","충주시",422,422,151,129,95,23,22,0,0,0,0,0,0,0,0,420,2,0
"1453","살미면","살미면투표소","대통령선거","충청북도","충주시",1500,989,236,432,223,46,43,1,0,0,1,1,0,2,2,987,2,511
"1454","수안보면","관내사전투표","대통령선거","충청북도","충주시",541,541,162,223,97,28,21,3,1,0,0,0,1,2,1,539,2,0
"1455","수안보면","수안보면제1투","대통령선거","충청북도","충주시",1741,1086,263,504,226,38,37,1,1,0,0,0,3,2,3,1078,8,655
"1456","수안보면","수안보면제2투","대통령선거","충청북도","충주시",565,381,101,147,93,14,17,0,0,0,0,0,1,2,1,376,5,184
"1457","대소원면","관내사전투표","대통령선거","충청북도","충주시",1179,1179,480,296,227,71,86,3,0,1,0,1,3,2,1,1171,8,0
"1458","대소원면","대소원면제1투","대통령선거","충청북도","충주시",2564,1503,492,445,368,84,94,2,1,0,2,3,1,3,0,1495,8,1061
"1459","대소원면","대소원면제2투","대통령선거","충청북도","충주시",1611,917,232,344,245,40,44,0,0,0,0,4,3,2,0,914,3,694
"1460","대소원면","대소원면제3투","대통령선거","충청북도","충주시",460,316,62,152,64,12,18,1,2,0,1,0,2,1,0,315,1,144
"1461","신니면","관내사전투표","대통령선거","충청북도","충주시",628,628,210,222,116,36,36,1,1,0,1,1,0,1,0,625,3,0
"1462","신니면","신니면제1투","대통령선거","충청북도","충주시",1326,823,182,364,201,30,32,2,0,0,1,0,2,2,3,819,4,503
"1463","신니면","신니면제2투","대통령선거","충청북도","충주시",1002,669,187,268,159,28,22,0,0,0,0,1,1,0,0,666,3,333
"1464","노은면","관내사전투표","대통령선거","충청북도","충주시",519,519,158,186,119,25,26,1,1,0,0,1,1,1,0,519,0,0
"1465","노은면","노은면투표소","대통령선거","충청북도","충주시",1636,998,213,439,246,48,26,3,1,3,0,1,3,2,1,986,12,638
"1466","앙성면","관내사전투표","대통령선거","충청북도","충주시",701,701,223,260,145,25,38,1,0,1,0,1,0,0,1,695,6,0
"1467","앙성면","앙성면제1투","대통령선거","충청북도","충주시",643,433,77,222,105,9,11,3,0,0,1,0,0,3,0,431,2,210
"1468","앙성면","앙성면제2투","대통령선거","충청북도","충주시",1767,1088,262,479,241,41,53,0,0,3,0,1,0,3,0,1083,5,679
"1469","앙성면","앙성면제3투","대통령선거","충청북도","충주시",544,367,68,182,88,12,12,0,1,0,0,0,0,3,0,366,1,177
"1470","중앙탑면","관내사전투표","대통령선거","충청북도","충주시",520,520,183,165,112,27,30,0,0,0,0,0,0,0,0,517,3,0
"1471","중앙탑면","중앙탑면제1투","대통령선거","충청북도","충주시",688,450,92,191,130,12,19,0,1,0,0,0,0,2,1,448,2,238
"1472","중앙탑면","중앙탑면제2투","대통령선거","충청북도","충주시",1267,784,177,318,232,21,26,1,0,0,0,0,2,1,1,779,5,483
"1473","금가면","관내사전투표","대통령선거","충청북도","충주시",693,693,260,152,165,57,54,0,0,1,0,0,1,1,1,692,1,0
"1474","금가면","금가면제1투","대통령선거","충청북도","충주시",1321,913,247,313,257,37,45,0,0,0,0,1,0,2,1,903,10,408
"1475","금가면","금가면제2투","대통령선거","충청북도","충주시",1088,698,180,244,179,62,29,0,0,0,1,0,0,2,1,698,0,390
"1476","동량면","관내사전투표","대통령선거","충청북도","충주시",514,514,146,198,110,22,31,0,0,1,0,0,2,0,0,510,4,0
"1477","동량면","동량면제1투","대통령선거","충청북도","충주시",1307,859,185,374,220,30,36,1,0,2,1,2,2,0,3,856,3,448
"1478","동량면","동량면제2투","대통령선거","충청북도","충주시",1485,990,251,400,238,41,45,0,1,2,0,0,1,2,1,982,8,495
"1479","산척면","관내사전투표","대통령선거","충청북도","충주시",587,587,167,248,111,21,34,0,0,0,0,1,0,4,0,586,1,0
"1480","산척면","산척면투표소","대통령선거","충청북도","충주시",1691,1096,243,546,216,45,33,0,0,1,1,0,2,0,4,1091,5,595
"1481","엄정면","관내사전투표","대통령선거","충청북도","충주시",758,758,229,336,126,22,30,3,1,0,1,1,0,2,1,752,6,0
"1482","엄정면","엄정면투표소","대통령선거","충청북도","충주시",2267,1462,328,679,330,55,50,2,0,1,1,0,2,5,2,1455,7,805
"1483","소태면","관내사전투표","대통령선거","충청북도","충주시",262,262,75,89,67,16,11,0,0,0,1,0,0,0,0,259,3,0
"1484","소태면","소태면제1투","대통령선거","충청북도","충주시",770,536,137,216,137,9,25,1,1,1,1,1,1,2,1,533,3,234
"1485","소태면","소태면제2투","대통령선거","충청북도","충주시",587,419,69,206,96,20,23,0,0,3,0,0,1,1,0,419,0,168
"1486","성내·충인동","관내사전투표","대통령선거","충청북도","충주시",925,925,292,336,186,49,56,2,0,0,0,0,0,2,0,923,2,0
"1487","성내·충인동","성내·충인동제1투","대통령선거","충청북도","충주시",652,444,91,218,101,17,11,0,0,0,0,0,0,1,0,439,5,208
"1488","성내·충인동","성내·충인동제2투","대통령선거","충청북도","충주시",1682,960,254,417,214,38,30,2,0,0,0,0,0,0,1,956,4,722
"1489","교현·안림동","관내사전투표","대통령선거","충청북도","충주시",3445,3445,1486,750,709,231,242,5,1,0,1,3,2,3,1,3434,11,0
"1490","교현·안림동","교현·안림동제1투","대통령선거","충청북도","충주시",1653,1040,299,365,239,53,73,1,0,0,0,1,0,1,0,1032,8,613
"1491","교현·안림동","교현·안림동제2투","대통령선거","충청북도","충주시",2075,1256,330,449,312,70,78,1,1,3,0,0,1,2,2,1249,7,819
"1492","교현·안림동","교현·안림동제3투","대통령선거","충청북도","충주시",2455,1687,534,561,396,93,85,3,0,1,1,1,0,1,2,1678,9,768
"1493","교현·안림동","교현·안림동제4투","대통령선거","충청북도","충주시",1982,1200,336,453,298,48,56,3,1,0,0,0,0,0,1,1196,4,782
"1494","교현·안림동","교현·안림동제5투","대통령선거","충청북도","충주시",3032,2018,677,592,480,110,133,3,0,1,0,2,1,1,4,2004,14,1014
"1495","교현·안림동","교현·안림동제6투","대통령선거","충청북도","충주시",4266,2835,1027,773,638,189,189,4,0,1,1,0,1,0,3,2826,9,1431
"1496","교현2동","관내사전투표","대통령선거","충청북도","충주시",1231,1231,486,347,232,73,86,1,0,1,0,0,0,1,1,1228,3,0
"1497","교현2동","교현2동제1투","대통령선거","충청북도","충주시",1274,792,237,334,159,33,20,1,0,0,0,1,1,0,1,787,5,482
"1498","교현2동","교현2동제2투","대통령선거","충청북도","충주시",1968,1173,318,429,282,55,73,2,0,0,1,1,1,5,1,1168,5,795
"1499","교현2동","교현2동제3투","대통령선거","충청북도","충주시",2263,1471,430,547,318,80,76,3,0,1,1,3,0,0,2,1461,10,792
"1500","용산동","관내사전투표","대통령선거","충청북도","충주시",2318,2318,945,576,465,124,180,8,0,3,3,2,2,1,2,2311,7,0
"1501","용산동","용산동제1투","대통령선거","충청북도","충주시",2108,1336,416,402,342,70,95,0,0,0,1,1,0,2,2,1331,5,772
"1502","용산동","용산동제2투","대통령선거","충청북도","충주시",1744,1074,354,342,258,47,66,1,0,0,0,1,0,0,3,1072,2,670
"1503","용산동","용산동제3투","대통령선거","충청북도","충주시",2000,1328,441,400,328,78,70,1,0,3,0,0,0,2,2,1325,3,672
"1504","용산동","용산동제4투","대통령선거","충청북도","충주시",3407,2359,972,481,569,156,165,0,0,2,1,2,1,2,4,2355,4,1048
"1505","지현동","관내사전투표","대통령선거","충청북도","충주시",758,758,295,231,139,41,45,0,0,0,0,0,1,2,0,754,4,0
"1506","지현동","지현동제1투","대통령선거","충청북도","충주시",2006,1341,403,481,319,55,68,0,0,1,0,0,2,1,2,1332,9,665
"1507","지현동","지현동제2투","대통령선거","충청북도","충주시",1929,1261,335,490,295,66,66,1,0,0,0,2,1,0,0,1256,5,668
"1508","문화동","관내사전투표","대통령선거","충청북도","충주시",1549,1549,572,462,347,71,85,2,1,0,3,0,0,0,2,1545,4,0
"1509","문화동","문화동제1투","대통령선거","충청북도","충주시",1859,1106,303,460,234,51,44,2,0,0,0,0,2,3,1,1100,6,753
"1510","문화동","문화동제2투","대통령선거","충청북도","충주시",1906,1485,387,585,341,75,83,4,0,0,0,1,0,1,1,1478,7,421
"1511","문화동","문화동제3투","대통령선거","충청북도","충주시",1639,1047,276,420,241,51,47,1,0,2,0,1,0,2,1,1042,5,592
"1512","문화동","문화동제4투","대통령선거","충청북도","충주시",1924,1185,357,411,270,59,74,1,0,5,0,0,0,2,1,1180,5,739
"1513","호암·직동","관내사전투표","대통령선거","충청북도","충주시",1589,1589,729,323,296,94,131,1,2,0,1,3,1,0,1,1582,7,0
"1514","호암·직동","호암·직동제1투","대통령선거","충청북도","충주시",3271,2161,760,552,541,143,139,1,1,3,0,2,2,0,1,2145,16,1110
"1515","호암·직동","호암·직동제2투","대통령선거","충청북도","충주시",1086,719,231,241,163,34,46,0,0,0,0,0,0,1,0,716,3,367
"1516","호암·직동","호암·직동제3투","대통령선거","충청북도","충주시",1574,990,380,235,242,67,58,1,0,1,0,1,0,0,0,985,5,584
"1517","달천동","관내사전투표","대통령선거","충청북도","충주시",710,710,247,204,139,61,52,1,0,1,1,0,0,1,0,707,3,0
"1518","달천동","달천동제1투","대통령선거","충청북도","충주시",2106,1241,333,459,302,70,64,1,1,1,0,0,3,1,0,1235,6,865
"1519","달천동","달천동제2투","대통령선거","충청북도","충주시",761,457,102,158,135,26,30,0,0,1,0,0,0,0,1,453,4,304
"1520","봉방동","관내사전투표","대통령선거","충청북도","충주시",2010,2010,741,606,401,106,129,5,2,0,0,3,0,1,1,1995,15,0
"1521","봉방동","봉방동제1투","대통령선거","충청북도","충주시",1484,911,230,372,199,48,50,0,1,1,0,0,0,1,1,903,8,573
"1522","봉방동","봉방동제2투","대통령선거","충청북도","충주시",2456,1622,553,493,394,83,85,4,0,1,0,3,1,0,2,1619,3,834
"1523","봉방동","봉방동제3투","대통령선거","충청북도","충주시",2557,1539,456,560,369,64,69,0,2,3,1,2,1,3,3,1533,6,1018
"1524","칠금·금릉동","관내사전투표","대통령선거","충청북도","충주시",2738,2738,1275,499,490,205,243,2,0,1,1,2,0,1,3,2722,16,0
"1525","칠금·금릉동","칠금·금릉동제1투","대통령선거","충청북도","충주시",913,569,151,231,136,23,22,0,0,1,0,0,2,1,0,567,2,344
"1526","칠금·금릉동","칠금·금릉동제2투","대통령선거","충청북도","충주시",1519,1025,327,356,219,47,68,1,0,1,0,0,0,2,1,1022,3,494
"1527","칠금·금릉동","칠금·금릉동제3투","대통령선거","충청북도","충주시",2266,1462,539,375,343,87,110,1,1,1,0,0,0,0,1,1458,4,804
"1528","칠금·금릉동","칠금·금릉동제4투","대통령선거","충청북도","충주시",2428,1588,559,450,363,88,117,4,0,0,0,0,2,1,1,1585,3,840
"1529","칠금·금릉동","칠금·금릉동제5투","대통령선거","충청북도","충주시",2703,2051,756,489,512,132,146,2,0,1,1,2,1,2,2,2046,5,652
"1530","연수동","관내사전투표","대통령선거","충청북도","충주시",5321,5321,2290,1195,997,337,459,3,2,3,3,2,2,4,6,5303,18,0
"1531","연수동","연수동제1투","대통령선거","충청북도","충주시",2220,1331,383,509,295,69,64,1,0,0,1,2,2,0,0,1326,5,889
"1532","연수동","연수동제2투","대통령선거","충청북도","충주시",2125,1314,492,327,322,70,91,2,0,1,0,0,0,1,0,1306,8,811
"1533","연수동","연수동제3투","대통령선거","충청북도","충주시",2529,1893,737,418,483,138,111,1,0,0,0,0,0,0,2,1890,3,636
"1534","연수동","연수동제4투","대통령선거","충청북도","충주시",1972,1359,499,389,276,95,87,2,1,0,0,1,0,1,3,1354,5,613
"1535","연수동","연수동제5투","대통령선거","충청북도","충주시",1458,891,260,315,210,47,52,1,0,1,0,1,0,1,1,889,2,567
"1536","연수동","연수동제6투","대통령선거","충청북도","충주시",2155,1218,320,512,267,39,50,5,0,2,1,3,3,1,4,1207,11,937
"1537","연수동","연수동제7투","대통령선거","충청북도","충주시",2065,1442,582,307,338,98,112,0,0,0,0,1,1,0,1,1440,2,623
"1538","연수동","연수동제8투","대통령선거","충청북도","충주시",2072,1404,535,340,316,91,115,3,0,0,1,0,0,0,0,1401,3,668
"1539","연수동","연수동제9투","대통령선거","충청북도","충주시",3384,2108,816,539,439,131,169,0,0,0,0,2,1,0,4,2101,7,1276
"1540","연수동","연수동제10투","대통령선거","충청북도","충주시",1876,1382,484,348,338,105,98,1,0,0,0,0,0,1,2,1377,5,494
"1541","연수동","연수동제11투","대통령선거","충청북도","충주시",2074,1424,498,431,322,80,86,3,0,0,0,2,1,0,0,1423,1,650
"1542","목행·용탄동","관내사전투표","대통령선거","충청북도","충주시",1202,1202,534,229,235,83,112,1,0,1,0,2,2,0,2,1201,1,0
"1543","목행·용탄동","목행·용탄동제1투","대통령선거","충청북도","충주시",2204,1505,615,328,352,90,109,0,0,2,0,0,2,0,0,1498,7,699
"1544","목행·용탄동","목행·용탄동제2투","대통령선거","충청북도","충주시",1544,938,266,339,246,31,45,1,0,2,1,0,0,2,0,933,5,606
"1545","잘못 투입·구분된 투표지","잘못 투입·구분된 투표지","대통령선거","충청북도","충주시",0,0,0,0,0,0,0,0,0,0,0,0,0,0,0,0,0,0
"1546","거소·선상투표","거소·선상투표","대통령선거","충청북도","제천시",333,314,95,64,80,17,16,2,3,3,1,2,2,0,2,287,27,19
"1547","관외사전투표","관외사전투표","대통령선거","충청북도","제천시",8217,8211,3623,1258,1652,752,786,8,1,6,3,7,5,8,25,8134,77,6
"1548","재외투표","재외투표","대통령선거","충청북도","제천시",395,299,191,16,42,8,40,1,0,0,0,0,0,0,1,299,0,96
"1549","봉양읍","관내사전투표","대통령선거","충청북도","제천시",1088,1088,381,378,211,48,55,4,2,0,1,0,1,2,1,1084,4,0
"1550","봉양읍","봉양읍제1투","대통령선거","충청북도","제천시",2811,1705,436,698,380,67,83,6,1,3,0,0,0,3,8,1685,20,1106
"1551","봉양읍","봉양읍제2투","대통령선거","충청북도","제천시",1260,858,249,302,177,54,66,1,1,1,0,0,0,3,0,854,4,402
"1552","봉양읍","봉양읍제3투","대통령선거","충청북도","제천시",723,488,111,201,120,24,22,0,0,1,1,2,1,0,1,484,4,235
"1553","금성면","관내사전투표","대통령선거","충청북도","제천시",313,313,100,129,57,13,12,0,0,1,0,0,0,0,0,312,1,0
"1554","금성면","금성면제1투","대통령선거","충청북도","제천시",721,466,127,201,79,29,24,1,0,0,1,0,0,0,2,464,2,255
"1555","금성면","금성면제2투","대통령선거","충청북도","제천시",797,544,158,226,113,15,20,0,0,0,0,1,1,2,0,536,8,253
"1556","청풍면","관내사전투표","대통령선거","충청북도","제천시",229,229,64,95,41,12,12,0,0,0,0,0,0,0,0,224,5,0
"1557","청풍면","청풍면제1투","대통령선거","충청북도","제천시",762,524,96,246,137,26,15,0,0,0,0,1,1,1,0,523,1,238
"1558","청풍면","청풍면제2투","대통령선거","충청북도","제천시",161,125,17,69,23,4,4,2,1,0,0,1,1,1,0,123,2,36
"1559","수산면","관내사전투표","대통령선거","충청북도","제천시",279,279,73,110,67,13,13,2,0,0,0,0,0,0,0,278,1,0
"1560","수산면","수산면제1투","대통령선거","충청북도","제천시",1251,838,159,409,194,30,32,6,1,1,1,0,0,1,1,835,3,413
"1561","수산면","수산면제2투","대통령선거","충청북도","제천시",300,208,49,87,51,6,6,1,0,1,0,0,3,0,0,204,4,92
"1562","덕산면","관내사전투표","대통령선거","충청북도","제천시",368,368,118,129,80,18,15,0,0,1,0,1,1,0,1,364,4,0
"1563","덕산면","덕산면제1투","대통령선거","충청북도","제천시",1182,798,204,334,189,22,26,2,0,0,3,0,4,3,4,791,7,384
"1564","덕산면","덕산면제2투","대통령선거","충청북도","제천시",372,262,49,125,59,4,18,0,0,1,1,2,0,0,3,262,0,110
"1565","한수면","관내사전투표","대통령선거","충청북도","제천시",106,106,49,32,13,4,7,0,1,0,0,0,0,0,0,106,0,0
"1566","한수면","한수면투표소","대통령선거","충청북도","제천시",509,340,62,184,69,6,13,0,0,0,0,0,1,1,0,336,4,169
"1567","백운면","관내사전투표","대통령선거","충청북도","제천시",566,566,187,202,116,29,29,0,0,0,0,0,0,2,0,565,1,0
"1568","백운면","백운면제1투","대통령선거","충청북도","제천시",1490,980,229,393,237,46,52,4,0,0,1,1,2,5,5,975,5,510
"1569","백운면","백운면제2투","대통령선거","충청북도","제천시",767,520,116,220,135,23,21,0,0,0,1,1,0,2,0,519,1,247
"1570","송학면","관내사전투표","대통령선거","충청북도","제천시",658,658,233,207,149,24,37,1,0,0,1,0,0,2,2,656,2,0
"1571","송학면","송학면제1투","대통령선거","충청북도","제천시",2021,1303,306,567,288,57,58,1,0,6,1,1,3,3,3,1294,9,718
"1572","송학면","송학면제2투","대통령선거","충청북도","제천시",1144,781,165,357,169,27,49,3,0,0,0,1,3,1,0,775,6,363
"1573","송학면","송학면제3투","대통령선거","충청북도","제천시",417,296,66,120,84,12,8,1,0,0,0,0,0,2,1,294,2,121
"1574","교동","관내사전투표","대통령선거","충청북도","제천시",2274,2274,1011,523,422,144,154,3,0,3,1,4,0,0,1,2266,8,0
"1575","교동","교동제1투","대통령선거","충청북도","제천시",1831,1234,307,488,294,77,56,2,0,0,3,0,0,2,1,1230,4,597
"1576","교동","교동제2투","대통령선거","충청북도","제천시",3511,2259,864,520,528,151,170,3,0,1,0,2,0,0,4,2243,16,1252
"1577","교동","교동제3투","대통령선거","충청북도","제천시",2283,1566,558,448,343,96,105,1,1,4,0,1,2,1,0,1560,6,717
"1578","교동","교동제4투","대통령선거","충청북도","제천시",2425,1618,503,555,365,78,103,2,0,1,1,0,0,2,1,1611,7,807
"1579","남현동","관내사전투표","대통령선거","충청북도","제천시",929,929,358,270,163,68,58,3,0,1,0,0,0,2,3,926,3,0
"1580","남현동","남현동제1투","대통령선거","충청북도","제천시",1395,927,219,445,175,50,26,0,0,0,1,0,1,2,1,920,7,468
"1581","남현동","남현동제2투","대통령선거","충청북도","제천시",2396,1510,407,609,311,89,82,3,0,0,1,1,2,2,2,1509,1,886
"1582","영서동","관내사전투표","대통령선거","충청북도","제천시",1634,1634,610,512,320,87,92,2,0,2,0,1,1,2,4,1633,1,0
"1583","영서동","영서동제1투","대통령선거","충청북도","제천시",1556,945,232,431,197,43,32,0,0,0,1,0,0,1,2,939,6,611
"1584","영서동","영서동제2투","대통령선거","충청북도","제천시",2467,1482,399,648,292,80,52,0,0,0,0,0,1,4,0,1476,6,985
"1585","영서동","영서동제3투","대통령선거","충청북도","제천시",1587,1030,278,365,218,67,83,0,0,0,0,0,4,1,5,1021,9,557
"1586","용두동","관내사전투표","대통령선거","충청북도","제천시",2973,2973,1245,747,554,183,205,1,0,3,3,3,2,7,7,2960,13,0
"1587","용두동","용두동제1투","대통령선거","충청북도","제천시",2168,1412,490,431,297,91,97,0,2,1,0,1,0,1,0,1411,1,756
"1588","용두동","용두동제2투","대통령선거","충청북도","제천시",2638,1745,667,405,377,144,132,2,1,0,1,3,1,3,3,1739,6,893
"1589","용두동","용두동제3투","대통령선거","충청북도","제천시",2751,1572,460,536,381,80,85,0,1,1,2,1,3,2,4,1556,16,1179
"1590","용두동","용두동제4투","대통령선거","충청북도","제천시",2553,1877,816,458,353,141,97,0,0,0,0,2,0,2,1,1870,7,676
"1591","신백동","관내사전투표","대통령선거","충청북도","제천시",1376,1376,602,292,256,83,123,0,0,1,0,2,0,2,1,1362,14,0
"1592","신백동","신백동제1투","대통령선거","충청북도","제천시",1949,1331,525,316,305,80,93,0,0,3,0,2,0,0,4,1328,3,618
"1593","신백동","신백동제2투","대통령선거","충청북도","제천시",1855,1072,309,343,250,71,88,2,0,1,0,0,1,1,1,1067,5,783
"1594","신백동","신백동제3투","대통령선거","충청북도","제천시",2171,1485,558,369,329,95,120,1,1,3,0,0,0,0,1,1477,8,686
"1595","신백동","신백동제4투","대통령선거","충청북도","제천시",1122,746,204,291,169,32,27,2,0,1,0,1,9,2,1,739,7,376
"1596","신백동","신백동제5투","대통령선거","충청북도","제천시",723,452,108,207,86,15,22,0,0,2,0,1,2,3,0,446,6,271
"1597","청전동","관내사전투표","대통령선거","충청북도","제천시",3393,3393,1288,1010,640,211,219,0,0,5,1,1,1,3,0,3379,14,0
"1598","청전동","청전동제1투","대통령선거","충청북도","제천시",2012,1324,383,500,286,69,70,2,0,0,1,3,1,4,0,1319,5,688
"1599","청전동","청전동제2투","대통령선거","충청북도","제천시",1831,1284,413,467,235,83,73,0,0,0,0,0,3,1,0,1275,9,547
"1600","청전동","청전동제3투","대통령선거","충청북도","제천시",1389,935,242,362,210,53,51,2,1,1,2,2,1,0,0,927,8,454
"1601","청전동","청전동제4투","대통령선거","충청북도","제천시",2209,1209,309,494,260,58,71,1,0,0,1,2,2,1,1,1200,9,1000
"1602","청전동","청전동제5투","대통령선거","충청북도","제천시",2142,1561,450,575,338,111,77,1,0,1,1,0,0,0,2,1556,5,581
"1603","청전동","청전동제6투","대통령선거","충청북도","제천시",1628,1082,278,417,265,58,53,1,0,3,0,0,0,1,0,1076,6,546
"1604","화산동","관내사전투표","대통령선거","충청북도","제천시",1733,1733,723,501,291,95,104,2,0,0,1,2,0,2,4,1725,8,0
"1605","화산동","화산동제1투","대통령선거","충청북도","제천시",2664,1686,516,581,382,92,104,2,0,1,1,1,2,3,0,1685,1,978
"1606","화산동","화산동제2투","대통령선거","충청북도","제천시",4086,2589,922,750,602,148,146,2,0,2,0,0,2,2,3,2579,10,1497
"1607","화산동","화산동제3투","대통령선거","충청북도","제천시",1795,1065,259,506,202,49,42,0,1,0,0,0,0,0,3,1062,3,730
"1608","의림지동","관내사전투표","대통령선거","충청북도","제천시",1569,1569,698,337,308,95,117,0,0,2,0,1,1,0,2,1561,8,0
"1609","의림지동","의림지동제1투","대통령선거","충청북도","제천시",2820,2030,768,503,444,150,142,0,0,3,0,4,1,1,4,2020,10,790
"1610","의림지동","의림지동제2투","대통령선거","충청북도","제천시",1116,743,239,233,172,47,42,1,0,0,0,1,2,2,2,741,2,373
"1611","의림지동","의림지동제3투","대통령선거","충청북도","제천시",1464,997,255,370,243,77,39,3,0,0,0,0,0,2,4,993,4,467
"1612","중앙동","관내사전투표","대통령선거","충청북도","제천시",1925,1925,661,667,329,109,143,1,0,2,1,1,0,0,0,1914,11,0
"1613","중앙동","중앙동제1투","대통령선거","충청북도","제천시",2734,1750,455,740,371,88,75,6,0,2,1,0,0,0,3,1741,9,984
"1614","중앙동","중앙동제2투","대통령선거","충청북도","제천시",1518,909,215,396,193,57,40,2,0,1,0,0,0,0,0,904,5,609
"1615","잘못 투입·구분된 투표지","잘못 투입·구분된 투표지","대통령선거","충청북도","제천시",0,0,0,0,0,0,0,0,0,0,0,0,0,0,0,0,0,0
"1616","거소·선상투표","거소·선상투표","대통령선거","충청북도","단양군",103,102,30,23,22,4,3,1,4,0,0,1,0,0,0,88,14,1
"1617","관외사전투표","관외사전투표","대통령선거","충청북도","단양군",2144,2143,892,450,435,168,174,2,1,0,1,1,1,2,1,2128,15,1
"1618","재외투표","재외투표","대통령선거","충청북도","단양군",100,75,56,4,8,1,5,0,0,0,0,0,0,1,0,75,0,25
"1619","단양읍","관내사전투표","대통령선거","충청북도","단양군",1815,1815,744,530,294,121,114,2,0,2,0,0,1,0,1,1809,6,0
"1620","단양읍","단양읍제1투","대통령선거","충청북도","단양군",2040,1310,375,536,260,65,62,1,1,3,0,1,3,0,2,1309,1,730
"1621","단양읍","단양읍제2투","대통령선거","충청북도","단양군",1592,1102,266,513,221,50,40,4,0,1,0,0,0,1,0,1096,6,490
"1622","단양읍","단양읍제3투","대통령선거","충청북도","단양군",2827,1812,535,734,343,83,91,3,0,1,2,1,4,2,2,1801,11,1015
"1623","매포읍","관내사전투표","대통령선거","충청북도","단양군",913,913,308,358,140,41,59,2,0,0,0,0,1,2,0,911,2,0
"1624","매포읍","매포읍제1투","대통령선거","충청북도","단양군",2204,1477,347,616,328,75,87,7,1,0,0,0,4,2,2,1469,8,727
"1625","매포읍","매포읍제2투","대통령선거","충청북도","단양군",1013,642,177,241,158,24,34,4,0,1,0,0,0,0,0,639,3,371
"1626","매포읍","매포읍제3투","대통령선거","충청북도","단양군",779,546,127,269,103,24,18,0,0,0,0,0,0,2,0,543,3,233
"1627","단성면","관내사전투표","대통령선거","충청북도","단양군",260,260,81,81,73,12,12,0,0,0,0,1,0,0,0,260,0,0
"1628","단성면","단성면제1투","대통령선거","충청북도","단양군",913,568,129,271,113,18,32,0,0,0,0,0,1,1,0,565,3,345
"1629","단성면","단성면제2투","대통령선거","충청북도","단양군",344,251,43,134,43,9,10,0,0,0,2,0,2,3,2,248,3,93
"1630","대강면","관내사전투표","대통령선거","충청북도","단양군",503,503,131,233,84,31,13,1,1,0,0,0,1,1,0,496,7,0
"1631","대강면","대강면제1투","대통령선거","충청북도","단양군",1219,735,145,372,147,27,27,2,0,0,1,2,0,3,2,728,7,484
"1632","대강면","대강면제2투","대통령선거","충청북도","단양군",462,329,52,172,76,10,15,0,0,0,1,1,0,0,0,327,2,133
"1633","가곡면","관내사전투표","대통령선거","충청북도","단양군",386,386,125,146,72,20,18,0,0,0,0,0,3,1,0,385,1,0
"1634","가곡면","가곡면투표소","대통령선거","충청북도","단양군",1357,871,204,376,205,32,37,3,0,4,0,1,0,3,2,867,4,486
"1635","영춘면","관내사전투표","대통령선거","충청북도","단양군",585,585,120,327,76,24,20,0,0,1,0,0,7,5,1,581,4,0
"1636","영춘면","영춘면제1투","대통령선거","충청북도","단양군",1261,801,149,445,128,26,22,3,0,1,0,0,13,5,0,792,9,460
"1637","영춘면","영춘면제2투","대통령선거","충청북도","단양군",150,126,26,42,42,8,2,0,0,0,1,0,1,1,2,125,1,24
"1638","영춘면","영춘면제3투","대통령선거","충청북도","단양군",844,578,162,231,132,28,16,0,1,0,1,0,3,1,0,575,3,266
"1639","어상천면","관내사전투표","대통령선거","충청북도","단양군",252,252,86,70,63,18,10,2,0,2,0,0,0,1,0,252,0,0
"1640","어상천면","어상천면투표소","대통령선거","충청북도","단양군",1360,821,198,303,257,29,17,3,0,1,0,0,3,2,2,815,6,539
"1641","적성면","관내사전투표","대통령선거","충청북도","단양군",151,151,42,69,26,7,4,0,1,0,0,0,0,0,0,149,2,0
"1642","적성면","적성면제1투","대통령선거","충청북도","단양군",483,323,59,181,64,5,5,1,0,1,0,2,0,2,0,320,3,160
"1643","적성면","적성면제2투","대통령선거","충청북도","단양군",639,428,99,174,113,18,17,3,0,0,0,0,1,2,0,427,1,211
"1644","잘못 투입·구분된 투표지","잘못 투입·구분된 투표지","대통령선거","충청북도","단양군",0,0,0,0,0,0,0,0,0,0,0,0,0,0,0,0,0,0
"1645","거소·선상투표","거소·선상투표","대통령선거","충청북도","영동군",169,156,45,45,33,4,5,1,0,0,1,2,1,4,3,144,12,13
"1646","관외사전투표","관외사전투표","대통령선거","충청북도","영동군",4275,4274,1851,724,840,377,430,6,0,1,4,2,3,3,12,4253,21,1
"1647","재외투표","재외투표","대통령선거","충청북도","영동군",227,123,67,10,34,2,7,0,0,0,1,1,0,1,0,123,0,104
"1648","영동읍","관내사전투표","대통령선거","충청북도","영동군",4137,4137,1702,1089,718,252,317,1,2,7,0,7,3,2,7,4107,30,0
"1649","영동읍","영동읍제1투","대통령선거","충청북도","영동군",2090,1255,394,444,266,64,71,1,1,1,1,5,0,4,2,1254,1,835
"1650","영동읍","영동읍제2투","대통령선거","충청북도","영동군",1991,1265,359,479,276,65,73,1,0,1,1,1,1,0,1,1258,7,726
"1651","영동읍","영동읍제3투","대통령선거","충청북도","영동군",1095,702,207,263,164,30,31,1,0,0,0,2,1,0,1,700,2,393
"1652","영동읍","영동읍제4투","대통령선거","충청북도","영동군",2506,1579,502,538,362,94,68,1,0,2,0,1,1,1,1,1571,8,927
"1653","영동읍","영동읍제5투","대통령선거","충청북도","영동군",2200,1290,442,319,317,61,124,0,1,5,1,2,2,1,5,1280,10,910
"1654","영동읍","영동읍제6투","대통령선거","충청북도","영동군",2290,1514,482,503,325,86,90,6,0,0,0,1,2,1,4,1500,14,776
"1655","용산면","관내사전투표","대통령선거","충청북도","영동군",856,856,260,294,199,41,45,0,0,2,1,2,1,3,1,849,7,0
"1656","용산면","용산면투표소","대통령선거","충청북도","영동군",2073,1122,274,480,249,41,59,0,1,0,1,2,1,2,3,1113,9,951
"1657","황간면","관내사전투표","대통령선거","충청북도","영동군",654,654,244,172,142,41,38,0,0,0,0,1,1,6,2,647,7,0
"1658","황간면","황간면제1투","대통령선거","충청북도","영동군",1777,1131,295,450,267,47,45,1,1,4,1,0,1,3,4,1119,12,646
"1659","황간면","황간면제2투","대통령선거","충청북도","영동군",1271,853,201,363,198,41,30,1,2,2,0,1,0,4,3,846,7,418
"1660","추풍령면","관내사전투표","대통령선거","충청북도","영동군",373,373,135,144,51,17,21,2,0,0,1,0,1,0,0,372,1,0
"1661","추풍령면","추풍령면투표소","대통령선거","충청북도","영동군",1674,1107,223,544,218,60,46,3,0,0,0,1,1,6,1,1103,4,567
"1662","매곡면","관내사전투표","대통령선거","충청북도","영동군",404,404,103,151,109,17,16,1,1,0,0,1,0,0,0,399,5,0
"1663","매곡면","매곡면투표소","대통령선거","충청북도","영동군",1329,890,177,402,231,30,34,0,1,2,0,4,1,0,2,884,6,439
"1664","상촌면","관내사전투표","대통령선거","충청북도","영동군",455,455,119,194,82,29,20,0,1,1,1,3,0,4,0,454,1,0
"1665","상촌면","상촌면투표소","대통령선거","충청북도","영동군",1597,1065,282,464,236,28,39,3,0,0,0,1,0,0,5,1058,7,532
"1666","양강면","관내사전투표","대통령선거","충청북도","영동군",538,538,156,180,132,24,34,1,1,2,0,2,1,2,1,536,2,0
"1667","양강면","양강면투표소","대통령선거","충청북도","영동군",2081,1279,295,539,325,51,45,0,2,0,1,5,1,5,5,1274,5,802
"1668","용화면","관내사전투표","대통령선거","충청북도","영동군",242,242,87,76,43,18,12,0,1,1,0,1,2,1,0,242,0,0
"1669","용화면","용화면투표소","대통령선거","충청북도","영동군",625,406,138,152,78,14,16,1,1,0,0,0,1,1,1,403,3,219
"1670","학산면","관내사전투표","대통령선거","충청북도","영동군",534,534,201,183,97,16,32,2,0,0,0,0,0,1,0,532,2,0
"1671","학산면","학산면제1투","대통령선거","충청북도","영동군",1593,960,237,400,245,38,20,4,1,0,1,0,1,2,3,952,8,633
"1672","학산면","학산면제2투","대통령선거","충청북도","영동군",420,276,64,116,69,14,10,0,0,0,0,0,0,1,0,274,2,144
"1673","양산면","관내사전투표","대통령선거","충청북도","영동군",359,359,147,112,74,8,9,2,0,2,0,0,0,3,2,359,0,0
"1674","양산면","양산면투표소","대통령선거","충청북도","영동군",1266,822,186,353,215,34,22,0,1,1,0,1,0,3,2,818,4,444
"1675","심천면","관내사전투표","대통령선거","충청북도","영동군",634,634,201,242,130,31,18,0,0,0,0,0,0,2,0,624,10,0
"1676","심천면","심천면제1투","대통령선거","충청북도","영동군",1720,1008,285,407,214,45,41,3,0,1,1,1,2,1,4,1005,3,712
"1677","심천면","심천면제2투","대통령선거","충청북도","영동군",429,291,71,126,78,6,5,0,0,0,0,0,0,3,2,291,0,138
"1678","잘못 투입·구분된 투표지","잘못 투입·구분된 투표지","대통령선거","충청북도","영동군",0,0,0,0,0,0,0,0,0,0,0,0,0,0,0,0,0,0
"1679","거소·선상투표","거소·선상투표","대통령선거","충청북도","보은군",157,143,41,40,31,6,11,3,1,1,0,0,0,0,3,137,6,14
"1680","관외사전투표","관외사전투표","대통령선거","충청북도","보은군",2500,2500,1045,504,492,187,241,2,0,1,1,1,1,0,4,2479,21,0
"1681","재외투표","재외투표","대통령선거","충청북도","보은군",121,77,49,8,9,4,6,0,0,1,0,0,0,0,0,77,0,44
"1682","보은읍","관내사전투표","대통령선거","충청북도","보은군",3136,3136,1264,875,572,149,230,5,2,2,1,3,1,3,5,3112,24,0
"1683","보은읍","보은읍제1투","대통령선거","충청북도","보은군",1677,989,284,394,212,43,39,1,0,3,0,0,1,0,2,979,10,688
"1684","보은읍","보은읍제2투","대통령선거","충청북도","보은군",1051,627,164,251,160,25,19,1,0,1,0,2,1,0,0,624,3,424
"1685","보은읍","보은읍제3투","대통령선거","충청북도","보은군",1931,1184,387,437,241,53,47,0,1,0,0,1,2,3,2,1174,10,747
"1686","보은읍","보은읍제4투","대통령선거","충청북도","보은군",2621,1645,577,527,374,73,72,4,1,1,1,2,1,1,3,1637,8,976
"1687","보은읍","보은읍제5투","대통령선거","충청북도","보은군",1297,835,289,303,150,27,43,2,0,1,1,0,3,2,3,824,11,462
"1688","속리산면","관내사전투표","대통령선거","충청북도","보은군",375,375,139,103,95,19,16,1,0,0,0,0,0,0,1,374,1,0
"1689","속리산면","속리산면제1투","대통령선거","충청북도","보은군",1222,802,241,327,161,30,28,3,0,0,1,0,1,4,1,797,5,420
"1690","속리산면","속리산면제2투","대통령선거","충청북도","보은군",206,135,37,57,23,8,2,1,0,0,0,1,1,2,1,133,2,71
"1691","장안면","관내사전투표","대통령선거","충청북도","보은군",326,326,133,67,73,18,29,1,0,1,1,0,0,2,0,325,1,0
"1692","장안면","장안면투표소","대통령선거","충청북도","보은군",1021,644,191,207,180,30,24,0,2,1,1,1,1,2,1,641,3,377
"1693","마로면","관내사전투표","대통령선거","충청북도","보은군",352,352,116,112,86,18,12,0,1,2,0,0,1,1,3,352,0,0
"1694","마로면","마로면제1투","대통령선거","충청북도","보은군",1198,825,209,323,208,43,23,1,1,0,0,4,0,4,3,819,6,373
"1695","마로면","마로면제2투","대통령선거","충청북도","보은군",538,375,87,157,100,9,12,1,0,1,0,0,1,1,3,372,3,163
"1696","탄부면","관내사전투표","대통령선거","충청북도","보은군",248,248,78,85,60,11,11,0,0,2,0,0,0,0,0,247,1,0
"1697","탄부면","탄부면투표소","대통령선거","충청북도","보은군",1266,839,221,350,192,20,33,3,1,0,0,1,4,5,2,832,7,427
"1698","삼승면","관내사전투표","대통령선거","충청북도","보은군",407,407,137,131,98,23,13,1,0,1,1,0,0,1,0,406,1,0
"1699","삼승면","삼승면투표소","대통령선거","충청북도","보은군",1541,901,274,288,244,47,33,0,0,1,1,0,2,4,1,895,6,640
"1700","수한면","관내사전투표","대통령선거","충청북도","보은군",287,287,92,99,67,12,15,0,0,0,0,0,1,1,0,287,0,0
"1701","수한면","수한면투표소","대통령선거","충청북도","보은군",1293,844,201,394,172,37,30,1,1,0,0,1,0,3,0,840,4,449
"1702","회남면","관내사전투표","대통령선거","충청북도","보은군",147,147,45,49,34,7,8,1,0,0,0,1,1,0,1,147,0,0
"1703","회남면","회남면투표소","대통령선거","충청북도","보은군",476,332,73,150,85,7,9,0,1,3,0,1,1,1,0,331,1,144
"1704","회인면","관내사전투표","대통령선거","충청북도","보은군",409,409,116,180,72,14,9,1,1,3,0,0,2,7,1,406,3,0
"1705","회인면","회인면투표소","대통령선거","충청북도","보은군",1175,749,171,361,155,15,21,3,1,4,1,0,3,7,1,743,6,426
"1706","내북면","관내사전투표","대통령선거","충청북도","보은군",273,273,80,92,76,13,5,0,0,1,2,1,0,2,0,272,1,0
"1707","내북면","내북면제1투","대통령선거","충청북도","보은군",734,469,149,159,121,14,18,1,0,0,0,0,1,3,2,468,1,265
"1708","내북면","내북면제2투","대통령선거","충청북도","보은군",515,345,89,124,96,11,12,1,0,1,0,0,3,3,2,342,3,170
"1709","산외면","관내사전투표","대통령선거","충청북도","보은군",231,231,75,80,44,15,15,0,0,0,1,0,0,0,0,230,1,0
"1710","산외면","산외면제1투","대통령선거","충청북도","보은군",783,513,115,202,146,16,26,0,0,0,0,0,1,2,0,508,5,270
"1711","산외면","산외면제2투","대통령선거","충청북도","보은군",502,377,99,151,81,11,23,0,0,0,1,2,1,1,2,372,5,125
"1712","잘못 투입·구분된 투표지","잘못 투입·구분된 투표지","대통령선거","충청북도","보은군",0,0,0,0,0,0,0,0,0,0,0,0,0,0,0,0,0,0
"1713","거소·선상투표","거소·선상투표","대통령선거","충청북도","옥천군",309,297,100,65,78,7,8,8,2,2,2,3,2,4,0,281,16,12
"1714","관외사전투표","관외사전투표","대통령선거","충청북도","옥천군",3543,3542,1513,696,664,294,314,5,1,6,3,2,2,2,9,3511,31,1
"1715","재외투표","재외투표","대통령선거","충청북도","옥천군",185,142,77,12,21,6,22,2,0,1,0,0,0,0,0,141,1,43
"1716","옥천읍","관내사전투표","대통령선거","충청북도","옥천군",4243,4243,1912,913,837,230,308,2,1,7,2,3,1,2,9,4227,16,0
"1717","옥천읍","옥천읍제1투","대통령선거","충청북도","옥천군",3142,1988,766,533,446,83,142,2,0,2,0,0,1,3,1,1979,9,1154
"1718","옥천읍","옥천읍제2투","대통령선거","충청북도","옥천군",1964,1330,438,450,301,67,56,2,2,1,0,0,1,2,1,1321,9,634
"1719","옥천읍","옥천읍제3투","대통령선거","충청북도","옥천군",2889,1923,696,491,473,89,150,2,1,5,1,1,0,1,2,1912,11,966
"1720","옥천읍","옥천읍제4투","대통령선거","충청북도","옥천군",2102,1435,422,517,337,67,77,0,0,1,1,0,0,2,0,1424,11,667
"1721","옥천읍","옥천읍제5투","대통령선거","충청북도","옥천군",1503,923,279,329,227,29,30,2,3,1,2,1,4,3,1,911,12,580
"1722","옥천읍","옥천읍제6투","대통령선거","충청북도","옥천군",2872,1868,620,582,436,84,114,1,2,5,1,5,3,2,2,1857,11,1004
"1723","옥천읍","옥천읍제7투","대통령선거","충청북도","옥천군",3090,2076,688,624,471,115,144,5,1,0,2,6,2,1,4,2063,13,1014
"1724","동이면","관내사전투표","대통령선거","충청북도","옥천군",566,566,187,207,113,19,31,0,1,0,1,3,1,1,2,566,0,0
"1725","동이면","동이면제1투","대통령선거","충청북도","옥천군",1392,904,245,318,241,33,42,3,2,4,0,0,3,4,2,897,7,488
"1726","동이면","동이면제2투","대통령선거","충청북도","옥천군",316,218,45,113,40,8,6,1,0,0,0,1,0,3,0,217,1,98
"1727","동이면","동이면제3투","대통령선거","충청북도","옥천군",544,369,93,140,92,10,22,1,1,0,1,4,1,1,1,367,2,175
"1728","안남면","관내사전투표","대통령선거","충청북도","옥천군",227,227,92,63,43,10,15,0,0,1,0,1,0,0,0,225,2,0
"1729","안남면","안남면투표소","대통령선거","충청북도","옥천군",1019,696,202,261,173,18,21,1,1,2,0,3,0,3,3,688,8,323
"1730","안내면","관내사전투표","대통령선거","충청북도","옥천군",344,344,87,141,73,16,19,0,0,0,0,4,1,0,2,343,1,0
"1731","안내면","안내면투표소","대통령선거","충청북도","옥천군",1403,931,209,395,221,42,33,3,0,2,0,5,5,3,3,921,10,472
"1732","청성면","관내사전투표","대통령선거","충청북도","옥천군",312,312,86,139,60,12,8,0,1,2,0,0,0,3,1,312,0,0
"1733","청성면","청성면투표소","대통령선거","충청북도","옥천군",1629,985,237,385,281,35,17,2,0,2,2,1,1,6,5,974,11,644
"1734","청산면","관내사전투표","대통령선거","충청북도","옥천군",557,557,186,174,142,22,22,0,0,0,0,0,2,1,3,552,5,0
"1735","청산면","청산면제1투","대통령선거","충청북도","옥천군",986,609,169,242,139,23,27,0,0,1,0,2,2,2,0,607,2,377
"1736","청산면","청산면제2투","대통령선거","충청북도","옥천군",508,320,85,138,71,8,8,1,0,1,0,0,2,1,1,316,4,188
"1737","청산면","청산면제3투","대통령선거","충청북도","옥천군",769,524,96,234,133,16,21,2,0,0,0,0,5,4,4,515,9,245
"1738","이원면","관내사전투표","대통령선거","충청북도","옥천군",901,901,302,306,207,32,40,2,0,1,0,0,2,3,2,897,4,0
"1739","이원면","이원면제1투","대통령선거","충청북도","옥천군",1886,1089,272,441,286,35,37,3,0,2,0,1,1,3,1,1082,7,797
"1740","이원면","이원면제2투","대통령선거","충청북도","옥천군",944,618,143,254,156,26,21,1,0,0,0,1,3,5,2,612,6,326
"1741","군서면","관내사전투표","대통령선거","충청북도","옥천군",328,328,117,99,68,13,25,1,1,0,0,1,0,0,0,325,3,0
"1742","군서면","군서면투표소","대통령선거","충청북도","옥천군",1672,1131,312,498,244,28,27,0,2,0,2,2,2,9,0,1126,5,541
"1743","군북면","관내사전투표","대통령선거","충청북도","옥천군",523,523,163,193,106,20,31,0,1,2,0,1,1,2,1,521,2,0
"1744","군북면","군북면제1투","대통령선거","충청북도","옥천군",1334,755,220,270,182,32,30,5,0,1,0,0,3,2,2,747,8,579
"1745","군북면","군북면제2투","대통령선거","충청북도","옥천군",287,206,58,88,36,12,11,0,0,0,0,0,0,1,0,206,0,81
"1746","군북면","군북면제3투","대통령선거","충청북도","옥천군",441,295,64,120,67,11,26,0,0,1,0,0,1,0,3,293,2,146
"1747","잘못 투입·구분된 투표지","잘못 투입·구분된 투표지","대통령선거","충청북도","옥천군",0,0,0,0,0,0,0,0,0,0,0,0,0,0,0,0,0,0
"1748","거소·선상투표","거소·선상투표","대통령선거","충청북도","음성군",393,358,119,57,86,15,14,4,4,5,6,4,3,3,6,326,32,35
"1749","관외사전투표","관외사전투표","대통령선거","충청북도","음성군",7282,7281,3318,1238,1444,555,646,8,0,5,2,4,4,4,12,7240,41,1
"1750","재외투표","재외투표","대통령선거","충청북도","음성군",283,211,130,19,25,12,25,0,0,0,0,0,0,0,0,211,0,72
"1751","음성읍","관내사전투표","대통령선거","충청북도","음성군",2978,2978,1280,748,586,126,209,2,1,2,0,1,0,2,3,2960,18,0
"1752","음성읍","음성읍제1투","대통령선거","충청북도","음성군",2427,1506,465,491,346,103,85,2,1,1,0,0,0,0,4,1498,8,921
"1753","음성읍","음성읍제2투","대통령선거","충청북도","음성군",2348,1557,408,575,410,74,64,3,2,0,0,1,2,3,3,1545,12,791
"1754","음성읍","음성읍제3투","대통령선거","충청북도","음성군",3258,1933,620,593,467,88,136,5,2,0,1,7,2,1,5,1927,6,1325
"1755","음성읍","음성읍제4투","대통령선거","충청북도","음성군",782,432,106,181,108,11,16,0,1,0,1,0,1,3,0,428,4,350
"1756","음성읍","음성읍제5투","대통령선거","충청북도","음성군",2241,1356,390,501,312,60,70,2,4,2,0,0,1,2,5,1349,7,885
"1757","금왕읍","관내사전투표","대통령선거","충청북도","음성군",2914,2914,1319,552,606,162,236,6,1,3,0,2,0,3,2,2892,22,0
"1758","금왕읍","금왕읍제1투","대통령선거","충청북도","음성군",4446,2491,918,667,620,130,131,3,1,1,3,0,2,0,4,2480,11,1955
"1759","금왕읍","금왕읍제2투","대통령선거","충청북도","음성군",3296,1918,726,450,463,109,146,2,0,1,2,2,4,1,3,1909,9,1378
"1760","금왕읍","금왕읍제3투","대통령선거","충청북도","음성군",2607,1625,628,381,387,104,106,2,1,0,1,1,0,3,3,1617,8,982
"1761","금왕읍","금왕읍제4투","대통령선거","충청북도","음성군",1157,681,180,247,193,22,30,1,0,0,0,0,2,2,0,677,4,476
"1762","금왕읍","금왕읍제5투","대통령선거","충청북도","음성군",1581,921,237,360,229,48,35,1,0,1,0,1,1,0,1,914,7,660
"1763","소이면","관내사전투표","대통령선거","충청북도","음성군",584,584,190,184,152,16,35,0,0,1,0,1,0,1,1,581,3,0
"1764","소이면","소이면투표소","대통령선거","충청북도","음성군",2012,1215,320,439,364,36,33,2,0,2,0,1,2,0,4,1203,12,797
"1765","원남면","관내사전투표","대통령선거","충청북도","음성군",408,408,134,133,98,14,20,1,0,1,0,0,1,2,1,405,3,0
"1766","원남면","원남면제1투","대통령선거","충청북도","음성군",1324,811,207,300,239,26,23,1,0,2,0,0,0,4,3,805,6,513
"1767","원남면","원남면제2투","대통령선거","충청북도","음성군",878,546,154,216,128,18,18,2,2,0,0,0,0,2,1,541,5,332
"1768","맹동면","관내사전투표","대통령선거","충청북도","음성군",1575,1575,730,267,283,87,131,8,2,7,2,4,5,4,9,1539,36,0
"1769","맹동면","맹동면제1투","대통령선거","충청북도","음성군",3041,1239,422,336,337,48,72,2,0,1,2,1,1,2,3,1227,12,1802
"1770","맹동면","맹동면제2투","대통령선거","충청북도","음성군",3628,2499,1249,324,551,179,189,0,0,0,0,1,0,4,0,2497,2,1129
"1771","대소면","관내사전투표","대통령선거","충청북도","음성군",1958,1958,933,345,405,124,122,1,0,4,2,3,0,4,3,1946,12,0
"1772","대소면","대소면제1투","대통령선거","충청북도","음성군",2210,1330,432,373,369,58,77,0,2,1,2,2,1,2,2,1321,9,880
"1773","대소면","대소면제2투","대통령선거","충청북도","음성군",1262,714,216,231,196,32,32,1,0,0,0,1,0,0,1,710,4,548
"1774","대소면","대소면제3투","대통령선거","충청북도","음성군",3205,1916,683,428,528,107,148,1,0,3,0,4,1,0,5,1908,8,1289
"1775","대소면","대소면제4투","대통령선거","충청북도","음성군",2869,1500,555,344,394,81,112,0,2,3,0,0,0,2,4,1497,3,1369
"1776","삼성면","관내사전투표","대통령선거","충청북도","음성군",1156,1156,395,334,289,53,75,1,1,0,0,1,1,0,2,1152,4,0
"1777","삼성면","삼성면제1투","대통령선거","충청북도","음성군",2813,1593,521,526,363,69,96,3,0,1,0,3,0,0,2,1584,9,1220
"1778","삼성면","삼성면제2투","대통령선거","충청북도","음성군",2178,1274,356,450,342,52,52,1,0,1,0,3,1,1,2,1261,13,904
"1779","생극면","관내사전투표","대통령선거","충청북도","음성군",679,679,218,219,144,35,43,1,1,2,1,2,0,4,2,672,7,0
"1780","생극면","생극면제1투","대통령선거","충청북도","음성군",2210,1291,322,499,348,36,65,2,0,2,0,2,2,2,1,1281,10,919
"1781","생극면","생극면제2투","대통령선거","충청북도","음성군",1068,711,167,289,177,29,38,0,0,1,0,0,4,1,1,707,4,357
"1782","감곡면","관내사전투표","대통령선거","충청북도","음성군",1535,1535,534,431,341,78,133,2,0,1,0,4,1,4,2,1531,4,0
"1783","감곡면","감곡면제1투","대통령선거","충청북도","음성군",3205,1816,547,523,499,99,127,2,1,3,1,0,1,1,0,1804,12,1389
"1784","감곡면","감곡면제2투","대통령선거","충청북도","음성군",2472,1489,388,595,373,57,54,3,2,0,1,3,0,4,4,1484,5,983
"1785","감곡면","감곡면제3투","대통령선거","충청북도","음성군",1245,787,206,334,179,35,27,1,0,0,0,0,1,1,0,784,3,458
"1786","잘못 투입·구분된 투표지","잘못 투입·구분된 투표지","대통령선거","충청북도","음성군",0,0,0,0,0,0,0,0,0,0,0,0,0,0,0,0,0,0
"1787","거소·선상투표","거소·선상투표","대통령선거","충청북도","진천군",145,131,45,21,47,9,4,0,0,0,0,0,0,0,2,128,3,14
"1788","관외사전투표","관외사전투표","대통령선거","충청북도","진천군",4748,4748,2167,778,968,367,412,6,0,5,0,3,1,1,8,4716,32,0
"1789","재외투표","재외투표","대통령선거","충청북도","진천군",197,148,90,13,22,8,12,2,0,0,0,0,0,0,0,147,1,49
"1790","진천읍","관내사전투표","대통령선거","충청북도","진천군",5103,5103,2301,1053,967,289,437,6,1,3,3,6,1,3,8,5078,25,0
"1791","진천읍","진천읍제1투","대통령선거","충청북도","진천군",2362,1311,416,434,308,53,84,1,1,1,1,0,0,1,7,1307,4,1051
"1792","진천읍","진천읍제2투","대통령선거","충청북도","진천군",1061,710,195,255,186,27,31,2,1,0,0,2,1,4,0,704,6,351
"1793","진천읍","진천읍제3투","대통령선거","충청북도","진천군",1586,996,338,232,262,58,93,0,0,1,1,0,1,0,2,988,8,590
"1794","진천읍","진천읍제4투","대통령선거","충청북도","진천군",1988,1183,379,362,288,60,80,0,0,1,0,0,0,0,5,1175,8,805
"1795","진천읍","진천읍제5투","대통령선거","충청북도","진천군",2380,1407,529,312,349,90,114,2,0,2,0,1,1,0,1,1401,6,973
"1796","진천읍","진천읍제6투","대통령선거","충청북도","진천군",2804,1721,680,386,415,90,131,3,1,2,0,1,2,0,1,1712,9,1083
"1797","진천읍","진천읍제7투","대통령선거","충청북도","진천군",1520,971,332,261,227,56,84,0,0,0,1,0,1,0,2,964,7,549
"1798","진천읍","진천읍제8투","대통령선거","충청북도","진천군",1858,1169,352,328,323,60,83,2,1,2,0,0,0,3,1,1155,14,689
"1799","진천읍","진천읍제9투","대통령선거","충청북도","진천군",2582,1727,769,298,397,104,145,0,0,0,1,1,0,1,4,1720,7,855
"1800","덕산면","관내사전투표","대통령선거","충청북도","진천군",1447,1447,698,296,297,62,84,2,0,0,0,0,1,1,2,1443,4,0
"1801","덕산면","덕산면제1투","대통령선거","충청북도","진천군",3201,1807,601,562,437,97,93,2,0,2,0,1,1,1,3,1800,7,1394
"1802","덕산면","덕산면제2투","대통령선거","충청북도","진천군",3104,2134,990,321,505,123,176,2,0,2,1,2,0,0,3,2125,9,970
"1803","초평면","관내사전투표","대통령선거","충청북도","진천군",454,454,160,149,92,29,19,0,0,0,0,1,0,1,0,451,3,0
"1804","초평면","초평면제1투","대통령선거","충청북도","진천군",1464,919,280,343,206,30,46,0,1,1,2,0,0,1,0,910,9,545
"1805","초평면","초평면제2투","대통령선거","충청북도","진천군",837,543,145,216,131,27,23,0,0,1,0,0,0,0,0,543,0,294
"1806","문백면","관내사전투표","대통령선거","충청북도","진천군",421,421,158,125,99,13,21,0,0,0,0,0,1,1,0,418,3,0
"1807","문백면","문백면제1투","대통령선거","충청북도","진천군",1631,1016,292,372,242,35,54,4,1,1,1,1,1,3,2,1009,7,615
"1808","문백면","문백면제2투","대통령선거","충청북도","진천군",969,676,235,214,172,18,24,3,0,1,0,0,1,0,5,673,3,293
"1809","백곡면","관내사전투표","대통령선거","충청북도","진천군",412,412,112,152,83,24,34,0,1,1,0,0,1,1,1,410,2,0
"1810","백곡면","백곡면투표소","대통령선거","충청북도","진천군",1441,951,241,416,209,42,31,1,0,1,0,2,1,2,0,946,5,490
"1811","이월면","관내사전투표","대통령선거","충청북도","진천군",949,949,362,267,230,34,47,5,0,0,0,1,2,0,0,948,1,0
"1812","이월면","이월면제1투","대통령선거","충청북도","진천군",2536,1491,517,449,360,54,88,4,0,1,1,3,1,3,1,1482,9,1045
"1813","이월면","이월면제2투","대통령선거","충청북도","진천군",2146,1265,412,355,351,57,73,1,0,1,0,1,1,1,5,1258,7,881
"1814","광혜원면","관내사전투표","대통령선거","충청북도","진천군",1731,1731,745,337,393,101,141,1,1,2,0,0,1,0,2,1724,7,0
"1815","광혜원면","광혜원면제1투","대통령선거","충청북도","진천군",2532,1380,431,436,355,66,73,1,1,0,3,1,0,1,2,1370,10,1152
"1816","광혜원면","광혜원면제2투","대통령선거","충청북도","진천군",1900,1049,397,255,245,62,73,1,2,3,0,2,1,1,3,1045,4,851
"1817","광혜원면","광혜원면제3투","대통령선거","충청북도","진천군",2062,1285,475,267,323,94,115,2,0,2,0,2,0,0,1,1281,4,777
"1818","잘못 투입·구분된 투표지","잘못 투입·구분된 투표지","대통령선거","충청북도","진천군",0,0,0,0,0,0,0,0,0,0,0,0,0,0,0,0,0,0
"1819","거소·선상투표","거소·선상투표","대통령선거","충청북도","괴산군",84,69,22,15,28,1,1,0,0,0,0,1,0,0,0,68,1,15
"1820","관외사전투표","관외사전투표","대통령선거","충청북도","괴산군",3496,3496,1524,791,626,240,263,4,2,3,0,4,2,2,7,3468,28,0
"1821","재외투표","재외투표","대통령선거","충청북도","괴산군",136,100,64,4,19,3,7,1,0,0,0,0,0,0,0,98,2,36
"1822","괴산읍","관내사전투표","대통령선거","충청북도","괴산군",1994,1994,808,615,342,85,118,1,0,1,2,6,1,2,4,1985,9,0
"1823","괴산읍","괴산읍제1투","대통령선거","충청북도","괴산군",2601,1674,526,622,358,66,78,4,1,0,4,2,2,1,4,1668,6,927
"1824","괴산읍","괴산읍제2투","대통령선거","충청북도","괴산군",1767,1058,321,352,259,65,43,0,0,0,1,6,1,3,1,1052,6,709
"1825","괴산읍","괴산읍제3투","대통령선거","충청북도","괴산군",1296,790,233,306,180,27,31,1,1,0,2,1,1,1,3,787,3,506
"1826","감물면","관내사전투표","대통령선거","충청북도","괴산군",381,381,114,145,86,10,19,3,0,0,0,0,1,0,0,378,3,0
"1827","감물면","감물면투표소","대통령선거","충청북도","괴산군",1271,836,211,316,217,36,38,0,0,2,1,0,4,2,3,830,6,435
"1828","장연면","관내사전투표","대통령선거","충청북도","괴산군",364,364,79,174,84,14,10,0,0,0,0,1,0,2,0,364,0,0
"1829","장연면","장연면투표소","대통령선거","충청북도","괴산군",1226,749,173,294,206,25,32,1,1,3,0,1,4,3,1,744,5,477
"1830","연풍면","관내사전투표","대통령선거","충청북도","괴산군",571,571,155,264,113,22,10,0,0,3,0,0,2,1,1,571,0,0
"1831","연풍면","연풍면투표소","대통령선거","충청북도","괴산군",1494,915,168,465,188,44,35,1,1,3,0,0,0,4,3,912,3,579
"1832","칠성면","관내사전투표","대통령선거","충청북도","괴산군",854,854,267,329,194,19,32,2,0,0,0,2,1,3,3,852,2,0
"1833","칠성면","칠성면투표소","대통령선거","충청북도","괴산군",1735,1073,281,406,279,45,46,1,0,0,0,2,1,2,2,1065,8,662
"1834","문광면","관내사전투표","대통령선거","충청북도","괴산군",448,448,128,163,115,14,24,0,0,1,0,0,0,0,0,445,3,0
"1835","문광면","문광면투표소","대통령선거","충청북도","괴산군",1409,906,263,333,220,29,37,3,1,1,1,0,1,5,3,897,9,503
"1836","청천면","관내사전투표","대통령선거","충청북도","괴산군",636,636,167,287,136,18,19,3,0,2,0,0,1,1,0,634,2,0
"1837","청천면","청천면제1투","대통령선거","충청북도","괴산군",1503,949,232,434,208,35,24,1,0,2,1,0,3,2,1,943,6,554
"1838","청천면","청천면제2투","대통령선거","충청북도","괴산군",555,400,89,168,109,15,10,0,0,0,0,0,1,2,2,396,4,155
"1839","청천면","청천면제3투","대통령선거","충청북도","괴산군",802,606,172,249,128,19,27,0,1,1,1,0,1,4,0,603,3,196
"1840","청천면","청천면제4투","대통령선거","충청북도","괴산군",680,417,84,199,95,9,11,0,2,0,1,0,0,3,1,405,12,263
"1841","청안면","관내사전투표","대통령선거","충청북도","괴산군",464,464,143,149,135,14,17,0,0,2,0,0,1,0,1,462,2,0
"1842","청안면","청안면제1투","대통령선거","충청북도","괴산군",1307,755,204,273,209,20,34,0,1,1,1,0,2,2,2,749,6,552
"1843","청안면","청안면제2투","대통령선거","충청북도","괴산군",1075,720,170,290,191,39,24,0,1,0,0,0,2,0,0,717,3,355
"1844","사리면","관내사전투표","대통령선거","충청북도","괴산군",417,417,124,167,80,20,19,0,1,0,1,1,0,3,1,417,0,0
"1845","사리면","사리면제1투","대통령선거","충청북도","괴산군",1224,779,181,331,184,29,37,0,0,2,0,0,1,3,3,771,8,445
"1846","사리면","사리면제2투","대통령선거","충청북도","괴산군",696,483,119,204,118,14,21,1,0,0,0,1,1,2,1,482,1,213
"1847","소수면","관내사전투표","대통령선거","충청북도","괴산군",378,378,135,108,83,16,27,0,0,1,2,1,2,0,1,376,2,0
"1848","소수면","소수면투표소","대통령선거","충청북도","괴산군",1288,788,257,271,203,24,29,2,0,0,0,0,1,0,0,787,1,500
"1849","불정면","관내사전투표","대통령선거","충청북도","괴산군",659,659,202,241,159,21,25,0,0,3,0,0,1,0,5,657,2,0
"1850","불정면","불정면투표소","대통령선거","충청북도","괴산군",1800,1095,260,470,278,25,50,0,1,0,1,1,1,2,1,1090,5,705
"1851","잘못 투입·구분된 투표지","잘못 투입·구분된 투표지","대통령선거","충청북도","괴산군",0,0,0,0,0,0,0,0,0,0,0,0,0,0,0,0,0,0
"1852","거소·선상투표","거소·선상투표","대통령선거","충청북도","증평군",56,55,16,7,21,4,2,0,0,1,1,0,0,0,2,54,1,1
"1853","관외사전투표","관외사전투표","대통령선거","충청북도","증평군",2649,2646,1219,422,530,202,222,1,1,6,2,2,2,2,7,2618,28,3
"1854","재외투표","재외투표","대통령선거","충청북도","증평군",92,67,45,2,10,1,9,0,0,0,0,0,0,0,0,67,0,25
"1855","증평읍","관내사전투표","대통령선거","충청북도","증평군",5417,5417,2326,1109,1189,316,400,2,4,4,6,2,3,7,13,5381,36,0
"1856","증평읍","증평읍제1투","대통령선거","충청북도","증평군",2119,1250,416,396,288,53,88,0,0,0,1,0,0,0,0,1242,8,869
"1857","증평읍","증평읍제2투","대통령선거","충청북도","증평군",1974,1212,328,448,325,49,53,1,0,0,0,1,2,0,2,1209,3,762
"1858","증평읍","증평읍제3투","대통령선거","충청북도","증평군",2069,1307,364,479,332,63,50,2,0,1,1,1,1,2,0,1296,11,762
"1859","증평읍","증평읍제4투","대통령선거","충청북도","증평군",2609,1461,569,317,376,82,104,2,0,1,2,0,1,0,3,1457,4,1148
"1860","증평읍","증평읍제5투","대통령선거","충청북도","증평군",2553,1699,669,415,388,80,132,0,1,1,0,0,1,2,4,1693,6,854
"1861","증평읍","증평읍제6투","대통령선거","충청북도","증평군",2175,1443,600,294,340,81,118,0,0,0,1,4,0,1,1,1440,3,732
"1862","증평읍","증평읍제7투","대통령선거","충청북도","증평군",2073,1292,413,369,355,78,59,3,1,2,0,2,1,1,1,1285,7,781
"1863","증평읍","증평읍제8투","대통령선거","충청북도","증평군",1202,801,190,333,201,31,30,1,1,1,0,0,0,2,2,792,9,401
"1864","증평읍","증평읍제9투","대통령선거","충청북도","증평군",3384,1876,578,540,490,118,119,3,0,1,2,1,0,1,10,1863,13,1508
"1865","도안면","관내사전투표","대통령선거","충청북도","증평군",302,302,109,110,53,7,18,1,0,1,0,1,0,0,0,300,2,0
"1866","도안면","도안면투표소","대통령선거","충청북도","증평군",1498,958,267,367,228,34,46,1,0,0,1,3,2,1,1,951,7,540
"1867","잘못 투입·구분된 투표지","잘못 투입·구분된 투표지","대통령선거","충청북도","증평군",0,0,0,0,0,0,0,0,0,0,0,0,0,0,0,0,0,0
"1868","거소·선상투표","거소·선상투표","대통령선거","충청남도","천안시서북구",458,425,140,59,146,37,15,3,1,1,2,0,2,0,5,411,14,33
"1869","관외사전투표","관외사전투표","대통령선거","충청남도","천안시서북구",25354,25342,12186,3252,5080,2174,2343,22,11,14,10,18,16,12,42,25180,162,12
"1870","재외투표","재외투표","대통령선거","충청남도","천안시서북구",1227,948,543,62,164,46,124,2,0,1,1,0,2,0,0,945,3,279
"1871","성환읍","관내사전투표","대통령선거","충청남도","천안시서북구",3589,3589,1452,941,683,214,263,8,2,2,1,0,3,4,4,3577,12,0
"1872","성환읍","성환읍제1투","대통령선거","충청남도","천안시서북구",1871,1124,331,399,284,53,45,2,0,1,0,0,0,1,0,1116,8,747
"1873","성환읍","성환읍제2투","대통령선거","충청남도","천안시서북구",2767,1491,439,486,384,85,86,1,0,1,0,1,0,0,3,1486,5,1276
"1874","성환읍","성환읍제3투","대통령선거","충청남도","천안시서북구",1544,1080,381,226,329,59,73,2,0,1,1,0,1,1,1,1075,5,464
"1875","성환읍","성환읍제4투","대통령선거","충청남도","천안시서북구",796,520,120,193,157,20,25,0,0,1,0,1,1,0,1,519,1,276
"1876","성환읍","성환읍제5투","대통령선거","충청남도","천안시서북구",1095,719,161,294,185,31,38,2,0,0,0,0,0,1,0,712,7,376
"1877","성환읍","성환읍제6투","대통령선거","충청남도","천안시서북구",1774,1106,260,407,322,47,54,3,1,0,0,1,0,2,1,1098,8,668
"1878","성환읍","성환읍제7투","대통령선거","충청남도","천안시서북구",2294,1320,405,430,316,62,89,2,0,5,1,3,0,1,1,1315,5,974
"1879","성환읍","성환읍제8투","대통령선거","충청남도","천안시서북구",736,484,136,180,112,20,31,1,0,0,0,0,1,1,0,482,2,252
"1880","성환읍","성환읍제9투","대통령선거","충청남도","천안시서북구",2712,1683,560,471,436,102,102,1,0,2,0,3,1,1,0,1679,4,1029
"1881","성환읍","성환읍제10투","대통령선거","충청남도","천안시서북구",2137,1523,693,254,368,76,124,2,0,2,0,1,2,0,0,1522,1,614
"1882","성거읍","관내사전투표","대통령선거","충청남도","천안시서북구",2857,2857,1281,578,563,163,241,5,1,6,2,2,2,2,3,2849,8,0
"1883","성거읍","성거읍제1투","대통령선거","충청남도","천안시서북구",2692,1439,551,303,349,99,126,2,1,2,0,1,1,1,0,1436,3,1253
"1884","성거읍","성거읍제2투","대통령선거","충청남도","천안시서북구",1746,1065,330,249,342,59,69,1,1,2,1,1,0,1,1,1057,8,681
"1885","성거읍","성거읍제3투","대통령선거","충청남도","천안시서북구",2796,2037,960,263,509,148,147,0,1,1,0,1,0,0,3,2033,4,759
"1886","성거읍","성거읍제4투","대통령선거","충청남도","천안시서북구",2439,1376,491,352,362,69,91,1,1,2,1,0,0,0,0,1370,6,1063
"1887","성거읍","성거읍제5투","대통령선거","충청남도","천안시서북구",1661,895,268,290,231,43,56,0,0,3,0,0,1,0,0,892,3,766
"1888","성거읍","성거읍제6투","대통령선거","충청남도","천안시서북구",1751,1256,571,181,314,82,100,2,0,0,0,3,0,0,0,1253,3,495
"1889","직산읍","관내사전투표","대통령선거","충청남도","천안시서북구",3366,3366,1573,639,697,191,239,5,0,4,0,4,3,0,3,3358,8,0
"1890","직산읍","직산읍제1투","대통령선거","충청남도","천안시서북구",1557,995,303,370,212,43,51,0,0,2,1,0,1,1,4,988,7,562
"1891","직산읍","직산읍제2투","대통령선거","충청남도","천안시서북구",2564,1465,555,279,398,94,122,1,1,3,2,2,1,2,1,1461,4,1099
"1892","직산읍","직산읍제3투","대통령선거","충청남도","천안시서북구",2346,1320,376,416,392,54,61,5,0,2,0,2,1,0,4,1313,7,1026
"1893","직산읍","직산읍제4투","대통령선거","충청남도","천안시서북구",1899,1015,398,206,273,55,69,2,0,2,1,0,1,1,2,1010,5,884
"1894","직산읍","직산읍제5투","대통령선거","충청남도","천안시서북구",2241,1272,485,238,343,76,110,0,0,3,1,1,0,2,8,1267,5,969
"1895","직산읍","직산읍제6투","대통령선거","충청남도","천안시서북구",2135,1425,528,297,399,87,100,0,0,3,0,2,0,0,3,1419,6,710
"1896","입장면","관내사전투표","대통령선거","충청남도","천안시서북구",1426,1426,579,339,312,80,109,1,0,0,0,0,1,0,3,1424,2,0
"1897","입장면","입장면제1투","대통령선거","충청남도","천안시서북구",2270,1316,413,383,338,84,82,0,0,4,0,0,2,1,1,1308,8,954
"1898","입장면","입장면제2투","대통령선거","충청남도","천안시서북구",968,595,179,177,165,32,32,2,0,1,0,0,0,0,3,591,4,373
"1899","입장면","입장면제3투","대통령선거","충청남도","천안시서북구",2467,1450,423,492,379,70,74,1,0,1,0,1,1,2,2,1446,4,1017
"1900","입장면","입장면제4투","대통령선거","충청남도","천안시서북구",792,542,148,213,115,22,28,4,0,1,0,1,2,0,2,536,6,250
"1901","성정1동","관내사전투표","대통령선거","충청남도","천안시서북구",1712,1712,728,352,362,105,150,0,0,0,1,2,3,0,0,1703,9,0
"1902","성정1동","성정1동제1투","대통령선거","충청남도","천안시서북구",1815,1124,300,397,301,45,68,1,0,1,0,0,3,0,1,1117,7,691
"1903","성정1동","성정1동제2투","대통령선거","충청남도","천안시서북구",4006,2067,785,472,464,134,190,2,1,2,0,1,1,1,4,2057,10,1939
"1904","성정1동","성정1동제3투","대통령선거","충청남도","천안시서북구",2568,1305,468,310,347,75,89,0,0,1,3,0,3,0,4,1300,5,1263
"1905","성정1동","성정1동제4투","대통령선거","충청남도","천안시서북구",1981,1033,283,375,260,51,50,2,0,0,1,0,0,0,1,1023,10,948
"1906","성정1동","성정1동제5투","대통령선거","충청남도","천안시서북구",1814,1267,461,356,293,63,84,0,1,1,1,1,0,1,1,1263,4,547
"1907","성정2동","관내사전투표","대통령선거","충청남도","천안시서북구",2645,2645,1308,414,492,168,242,6,0,3,1,2,1,0,0,2637,8,0
"1908","성정2동","성정2동제1투","대통령선거","충청남도","천안시서북구",4403,2017,955,272,428,160,189,0,0,2,0,0,0,1,2,2009,8,2386
"1909","성정2동","성정2동제2투","대통령선거","충청남도","천안시서북구",4001,2347,861,561,579,135,187,0,2,0,1,3,3,2,2,2336,11,1654
"1910","성정2동","성정2동제3투","대통령선거","충청남도","천안시서북구",3645,2073,776,502,507,133,144,0,0,2,0,2,1,0,0,2067,6,1572
"1911","성정2동","성정2동제4투","대통령선거","충청남도","천안시서북구",3228,1583,597,386,401,81,105,3,0,1,0,1,0,1,2,1578,5,1645
"1912","성정2동","성정2동제5투","대통령선거","충청남도","천안시서북구",3574,1661,705,276,403,115,148,4,1,0,0,2,0,1,2,1657,4,1913
"1913","쌍용1동","관내사전투표","대통령선거","충청남도","천안시서북구",1933,1933,934,338,335,131,179,3,1,0,1,1,0,2,1,1926,7,0
"1914","쌍용1동","쌍용1동제1투","대통령선거","충청남도","천안시서북구",2353,1552,586,391,353,99,111,2,0,0,1,0,0,2,1,1546,6,801
"1915","쌍용1동","쌍용1동제2투","대통령선거","충청남도","천안시서북구",2333,1427,542,329,347,94,108,1,0,1,1,1,0,0,0,1424,3,906
"1916","쌍용1동","쌍용1동제3투","대통령선거","충청남도","천안시서북구",2525,1803,680,421,444,116,124,1,0,1,2,1,0,0,2,1792,11,722
"1917","쌍용1동","쌍용1동제4투","대통령선거","충청남도","천안시서북구",2580,1831,639,447,472,114,138,5,0,0,0,1,0,2,2,1820,11,749
"1918","쌍용2동","관내사전투표","대통령선거","충청남도","천안시서북구",3886,3884,2065,444,711,255,387,5,0,1,1,1,3,1,4,3878,6,2
"1919","쌍용2동","쌍용2동제1투","대통령선거","충청남도","천안시서북구",3460,2346,882,556,539,158,189,5,0,0,0,1,0,0,5,2335,11,1114
"1920","쌍용2동","쌍용2동제2투","대통령선거","충청남도","천안시서북구",2677,1862,754,384,431,132,144,1,1,0,0,4,2,0,1,1854,8,815
"1921","쌍용2동","쌍용2동제3투","대통령선거","충청남도","천안시서북구",2097,1329,611,183,316,110,100,2,0,0,0,0,0,1,3,1326,3,768
"1922","쌍용2동","쌍용2동제4투","대통령선거","충청남도","천안시서북구",3527,2755,1213,409,677,216,223,4,0,2,0,0,1,2,1,2748,7,772
"1923","쌍용2동","쌍용2동제5투","대통령선거","충청남도","천안시서북구",1658,1129,535,151,231,85,114,3,0,0,0,0,0,1,3,1123,6,529
"1924","쌍용2동","쌍용2동제6투","대통령선거","충청남도","천안시서북구",2858,2109,867,418,503,127,178,2,1,3,0,0,0,2,1,2102,7,749
"1925","쌍용2동","쌍용2동제7투","대통령선거","충청남도","천안시서북구",2905,2402,1059,392,602,140,196,4,0,0,1,0,1,0,1,2396,6,503
"1926","쌍용2동","쌍용2동제8투","대통령선거","충청남도","천안시서북구",3697,2688,1067,550,641,209,201,4,0,1,0,2,0,2,2,2679,9,1009
"1927","쌍용3동","관내사전투표","대통령선거","충청남도","천안시서북구",3096,3096,1497,439,653,222,264,7,0,2,1,0,1,0,2,3088,8,0
"1928","쌍용3동","쌍용3동제1투","대통령선거","충청남도","천안시서북구",2340,1654,649,357,417,121,97,6,0,1,1,0,0,0,0,1649,5,686
"1929","쌍용3동","쌍용3동제2투","대통령선거","충청남도","천안시서북구",2129,1348,476,361,354,66,71,2,0,2,0,1,0,2,1,1336,12,781
"1930","쌍용3동","쌍용3동제3투","대통령선거","충청남도","천안시서북구",1603,1103,399,231,281,93,84,1,1,0,0,0,0,0,4,1094,9,500
"1931","쌍용3동","쌍용3동제4투","대통령선거","충청남도","천안시서북구",1979,1383,655,164,316,109,129,3,0,0,0,0,0,0,2,1378,5,596
"1932","쌍용3동","쌍용3동제5투","대통령선거","충청남도","천안시서북구",2079,1459,705,193,336,94,118,1,0,0,0,0,0,0,3,1450,9,620
"1933","쌍용3동","쌍용3동제6투","대통령선거","충청남도","천안시서북구",1777,1418,555,297,385,123,51,2,0,0,0,1,0,0,1,1415,3,359
"1934","백석동","관내사전투표","대통령선거","충청남도","천안시서북구",4417,4417,2423,482,841,281,364,3,1,0,1,3,2,1,3,4405,12,0
"1935","백석동","백석동제1투","대통령선거","충청남도","천안시서북구",3810,2638,1165,466,622,178,194,1,1,1,0,4,0,1,0,2633,5,1172
"1936","백석동","백석동제2투","대통령선거","충청남도","천안시서북구",1882,1401,546,332,303,107,105,3,0,0,0,2,0,1,0,1399,2,481
"1937","백석동","백석동제3투","대통령선거","충청남도","천안시서북구",2899,2050,850,414,480,133,161,3,1,0,1,1,1,0,1,2046,4,849
"1938","백석동","백석동제4투","대통령선거","충청남도","천안시서북구",3359,2399,1110,373,533,172,198,1,1,0,0,1,1,3,0,2393,6,960
"1939","백석동","백석동제5투","대통령선거","충청남도","천안시서북구",2868,2214,1043,320,526,189,127,2,0,0,1,1,0,0,0,2209,5,654
"1940","백석동","백석동제6투","대통령선거","충청남도","천안시서북구",2318,1887,899,299,427,140,112,1,0,0,0,0,0,0,1,1879,8,431
"1941","백석동","백석동제7투","대통령선거","충청남도","천안시서북구",2696,2257,1154,277,529,160,130,2,0,0,0,0,0,0,3,2255,2,439
"1942","백석동","백석동제8투","대통령선거","충청남도","천안시서북구",937,758,415,57,171,59,52,0,0,0,0,0,1,0,0,755,3,179
"1943","불당동","관내사전투표","대통령선거","충청남도","천안시서북구",5708,5708,3184,544,1072,445,438,7,0,2,0,2,0,1,2,5697,11,0
"1944","불당동","불당동제1투","대통령선거","충청남도","천안시서북구",3149,2396,1071,386,594,166,172,2,0,1,0,0,0,2,1,2395,1,753
"1945","불당동","불당동제2투","대통령선거","충청남도","천안시서북구",2950,2378,1180,294,587,169,144,1,0,0,0,0,0,0,0,2375,3,572
"1946","불당동","불당동제3투","대통령선거","충청남도","천안시서북구",3247,2347,1048,375,605,165,143,2,0,1,1,1,0,0,0,2341,6,900
"1947","불당동","불당동제4투","대통령선거","충청남도","천안시서북구",3152,2591,1440,228,553,198,165,1,0,0,2,1,0,0,0,2588,3,561
"1948","불당동","불당동제5투","대통령선거","충청남도","천안시서북구",4387,3381,1714,365,798,249,238,5,0,0,1,2,1,0,1,3374,7,1006
"1949","불당동","불당동제6투","대통령선거","충청남도","천안시서북구",1439,993,492,127,202,90,75,5,0,0,0,0,1,0,1,993,0,446
"1950","불당동","불당동제7투","대통령선거","충청남도","천안시서북구",2593,1913,845,309,483,134,128,5,0,1,0,0,0,0,0,1905,8,680
"1951","부성1동","관내사전투표","대통령선거","충청남도","천안시서북구",3944,3944,2088,440,759,269,356,2,0,1,4,3,1,0,4,3927,17,0
"1952","부성1동","부성1동제1투","대통령선거","충청남도","천안시서북구",1905,1411,652,244,290,115,105,0,0,0,0,0,1,0,0,1407,4,494
"1953","부성1동","부성1동제2투","대통령선거","충청남도","천안시서북구",2034,1224,423,394,278,56,60,3,0,1,0,0,1,1,2,1219,5,810
"1954","부성1동","부성1동제3투","대통령선거","충청남도","천안시서북구",921,601,186,181,164,32,33,0,0,0,0,1,0,0,1,598,3,320
"1955","부성1동","부성1동제4투","대통령선거","충청남도","천안시서북구",2292,1702,734,287,401,136,130,2,0,1,1,2,0,0,1,1695,7,590
"1956","부성1동","부성1동제5투","대통령선거","충청남도","천안시서북구",2785,1786,886,212,407,119,156,1,0,1,0,0,1,0,0,1783,3,999
"1957","부성1동","부성1동제6투","대통령선거","충청남도","천안시서북구",1448,1058,465,157,254,65,107,2,2,2,0,0,0,0,0,1054,4,390
"1958","부성1동","부성1동제7투","대통령선거","충청남도","천안시서북구",2292,1510,744,224,302,99,140,0,0,0,0,0,0,0,0,1509,1,782
"1959","부성1동","부성1동제8투","대통령선거","충청남도","천안시서북구",2901,2057,907,350,500,139,149,5,0,0,0,1,1,0,0,2052,5,844
"1960","부성1동","부성1동제9투","대통령선거","충청남도","천안시서북구",3041,1329,700,100,247,116,156,0,0,0,0,2,0,0,2,1323,6,1712
"1961","부성1동","부성1동제10투","대통령선거","충청남도","천안시서북구",2471,1874,819,289,466,160,127,1,0,3,1,2,0,0,1,1869,5,597
"1962","부성2동","관내사전투표","대통령선거","충청남도","천안시서북구",4776,4776,2693,435,806,353,456,1,1,3,1,3,1,0,5,4758,18,0
"1963","부성2동","부성2동제1투","대통령선거","충청남도","천안시서북구",3141,2447,1305,197,531,200,202,2,0,0,0,1,2,1,2,2443,4,694
"1964","부성2동","부성2동제2투","대통령선거","충청남도","천안시서북구",3380,2566,1090,449,627,171,216,1,1,1,0,2,0,0,4,2562,4,814
"1965","부성2동","부성2동제3투","대통령선거","충청남도","천안시서북구",3558,2635,1182,398,653,177,210,3,0,1,0,1,0,1,2,2628,7,923
"1966","부성2동","부성2동제4투","대통령선거","충청남도","천안시서북구",2747,1295,603,173,262,99,143,0,1,0,1,4,1,0,2,1289,6,1452
"1967","부성2동","부성2동제5투","대통령선거","충청남도","천안시서북구",3134,1895,843,282,449,126,181,1,0,1,0,1,2,0,3,1889,6,1239
"1968","부성2동","부성2동제6투","대통령선거","충청남도","천안시서북구",2321,1312,690,135,284,84,106,0,0,0,1,1,1,0,1,1303,9,1009
"1969","부성2동","부성2동제7투","대통령선거","충청남도","천안시서북구",2759,2007,1000,274,435,145,140,0,1,1,0,0,1,0,1,1998,9,752
"1970","부성2동","부성2동제8투","대통령선거","충청남도","천안시서북구",2899,2022,1067,272,333,157,184,1,0,3,1,0,0,0,3,2021,1,877
"1971","부성2동","부성2동제9투","대통령선거","충청남도","천안시서북구",1700,1337,730,105,276,103,117,0,0,0,1,0,0,0,2,1334,3,363
"1972","잘못 투입·구분된 투표지","잘못 투입·구분된 투표지","대통령선거","충청남도","천안시서북구",0,2,0,0,1,1,0,0,0,0,0,0,0,0,0,2,0,-2
"1973","거소·선상투표","거소·선상투표","대통령선거","충청남도","천안시동남구",365,339,115,56,100,26,17,1,1,1,1,0,1,2,2,323,16,26
"1974","관외사전투표","관외사전투표","대통령선거","충청남도","천안시동남구",17123,17121,7889,2510,3620,1339,1536,17,7,10,5,9,15,2,34,16993,128,2
"1975","재외투표","재외투표","대통령선거","충청남도","천안시동남구",941,735,465,34,105,35,87,3,0,0,0,0,0,1,0,730,5,206
"1976","목천읍","관내사전투표","대통령선거","충청남도","천안시동남구",2119,2119,962,425,441,113,160,4,0,0,0,2,3,3,0,2113,6,0
"1977","목천읍","목천읍제1투","대통령선거","충청남도","천안시동남구",2845,1675,511,556,410,79,100,3,0,3,0,1,1,5,2,1671,4,1170
"1978","목천읍","목천읍제2투","대통령선거","충청남도","천안시동남구",1438,928,278,281,247,49,67,1,0,1,0,1,2,0,0,927,1,510
"1979","목천읍","목천읍제3투","대통령선거","충청남도","천안시동남구",850,571,143,207,150,23,39,4,0,0,0,1,0,0,0,567,4,279
"1980","목천읍","목천읍제4투","대통령선거","충청남도","천안시동남구",2520,1550,576,383,360,106,112,2,0,1,0,0,1,0,2,1543,7,970
"1981","목천읍","목천읍제5투","대통령선거","충청남도","천안시동남구",2989,2102,909,354,524,122,173,4,0,0,0,2,2,1,1,2092,10,887
"1982","목천읍","목천읍제6투","대통령선거","충청남도","천안시동남구",1386,892,380,137,239,45,77,4,0,0,1,2,1,1,3,890,2,494
"1983","목천읍","목천읍제7투","대통령선거","충청남도","천안시동남구",4258,2636,1163,447,645,177,194,1,0,2,0,1,1,0,2,2633,3,1622
"1984","풍세면","관내사전투표","대통령선거","충청남도","천안시동남구",610,610,222,157,173,19,34,0,0,0,1,0,0,2,0,608,2,0
"1985","풍세면","풍세면제1투","대통령선거","충청남도","천안시동남구",1068,655,203,192,180,31,42,3,0,0,0,0,0,1,1,653,2,413
"1986","풍세면","풍세면제2투","대통령선거","충청남도","천안시동남구",665,433,106,172,101,15,31,1,0,2,0,0,0,3,0,431,2,232
"1987","풍세면","풍세면제3투","대통령선거","충청남도","천안시동남구",1314,816,203,356,175,41,33,0,1,2,0,2,0,0,0,813,3,498
"1988","광덕면","관내사전투표","대통령선거","충청남도","천안시동남구",517,517,198,147,109,23,38,1,0,0,0,1,0,0,0,517,0,0
"1989","광덕면","광덕면제1투","대통령선거","충청남도","천안시동남구",1367,908,174,508,154,38,22,0,2,4,0,0,1,2,0,905,3,459
"1990","광덕면","광덕면제2투","대통령선거","충청남도","천안시동남구",1134,779,214,292,190,24,49,1,0,2,0,0,1,2,1,776,3,355
"1991","광덕면","광덕면제3투","대통령선거","충청남도","천안시동남구",827,549,125,230,130,37,26,0,0,0,0,0,0,0,0,548,1,278
"1992","북면","관내사전투표","대통령선거","충청남도","천안시동남구",368,368,138,97,83,18,28,1,0,0,0,0,0,0,1,366,2,0
"1993","북면","북면제1투","대통령선거","충청남도","천안시동남구",2058,1179,353,376,274,74,85,0,0,5,0,1,1,2,1,1172,7,879
"1994","북면","북면제2투","대통령선거","충청남도","천안시동남구",576,359,72,144,107,9,19,0,0,1,0,0,0,0,3,355,4,217
"1995","북면","북면제3투","대통령선거","충청남도","천안시동남구",618,397,90,155,111,9,14,0,0,0,0,0,2,2,6,389,8,221
"1996","성남면","관내사전투표","대통령선거","충청남도","천안시동남구",602,602,228,150,145,27,34,0,5,4,1,0,3,1,1,599,3,0
"1997","성남면","성남면제1투","대통령선거","충청남도","천안시동남구",921,577,150,213,158,26,21,1,0,1,1,0,0,0,0,571,6,344
"1998","성남면","성남면제2투","대통령선거","충청남도","천안시동남구",1535,937,231,367,256,40,36,0,0,0,0,0,2,0,0,932,5,598
"1999","수신면","관내사전투표","대통령선거","충청남도","천안시동남구",351,351,122,104,81,16,28,0,0,0,0,0,0,0,0,351,0,0
"2000","수신면","수신면제1투","대통령선거","충청남도","천안시동남구",1206,759,194,295,204,30,26,2,2,0,0,0,0,0,1,754,5,447
"2001","수신면","수신면제2투","대통령선거","충청남도","천안시동남구",591,391,89,165,102,14,12,2,1,0,0,0,0,1,0,386,5,200
"2002","병천면","관내사전투표","대통령선거","충청남도","천안시동남구",1283,1283,498,320,287,77,86,1,0,1,1,1,0,1,1,1274,9,0
"2003","병천면","병천면제1투","대통령선거","충청남도","천안시동남구",2410,1375,414,474,333,61,74,4,1,0,0,1,1,2,3,1368,7,1035
"2004","병천면","병천면제2투","대통령선거","충청남도","천안시동남구",1204,721,217,233,196,40,30,0,0,0,1,0,0,2,0,719,2,483
"2005","병천면","병천면제3투","대통령선거","충청남도","천안시동남구",679,407,98,148,117,18,16,1,0,1,1,0,2,1,2,405,2,272
"2006","동면","관내사전투표","대통령선거","충청남도","천안시동남구",454,454,121,157,110,18,23,1,3,2,2,0,1,2,2,442,12,0
"2007","동면","동면투표소","대통령선거","충청남도","천안시동남구",1543,883,177,392,227,34,37,2,0,2,0,1,1,2,1,876,7,660
"2008","중앙동","관내사전투표","대통령선거","충청남도","천안시동남구",999,999,304,374,210,52,51,1,0,0,2,0,1,0,1,996,3,0
"2009","중앙동","중앙동제1투","대통령선거","충청남도","천안시동남구",2479,1384,338,568,355,53,54,3,0,0,0,0,0,0,0,1371,13,1095
"2010","중앙동","중앙동제2투","대통령선거","충청남도","천안시동남구",1571,940,262,397,207,29,36,1,0,2,0,0,0,0,1,935,5,631
"2011","문성동","관내사전투표","대통령선거","충청남도","천안시동남구",1009,1009,351,331,222,45,48,2,0,1,1,2,0,2,0,1005,4,0
"2012","문성동","문성동제1투","대통령선거","충청남도","천안시동남구",1213,481,132,170,119,23,32,1,0,0,0,1,0,0,1,479,2,732
"2013","문성동","문성동제2투","대통령선거","충청남도","천안시동남구",1765,996,309,329,249,34,60,0,1,2,2,1,1,0,2,990,6,769
"2014","원성1동","관내사전투표","대통령선거","충청남도","천안시동남구",1479,1479,607,377,322,72,91,1,0,1,1,1,0,0,1,1474,5,0
"2015","원성1동","원성1동제1투","대통령선거","충청남도","천안시동남구",2039,1278,408,411,301,57,88,3,1,0,0,1,0,0,0,1270,8,761
"2016","원성1동","원성1동제2투","대통령선거","충청남도","천안시동남구",1373,793,234,283,197,36,38,1,0,1,0,1,0,0,0,791,2,580
"2017","원성1동","원성1동제3투","대통령선거","충청남도","천안시동남구",1623,977,300,314,246,55,55,0,0,0,0,1,0,0,1,972,5,646
"2018","원성1동","원성1동제4투","대통령선거","충청남도","천안시동남구",1367,860,280,272,221,31,47,1,0,0,0,2,1,0,0,855,5,507
"2019","원성2동","관내사전투표","대통령선거","충청남도","천안시동남구",1766,1766,679,493,340,101,131,5,0,4,3,1,0,1,2,1760,6,0
"2020","원성2동","원성2동제1투","대통령선거","충청남도","천안시동남구",1117,712,191,256,185,38,31,1,0,0,0,2,0,3,0,707,5,405
"2021","원성2동","원성2동제2투","대통령선거","충청남도","천안시동남구",2802,1747,517,592,411,92,116,1,0,0,0,2,1,0,2,1734,13,1055
"2022","원성2동","원성2동제3투","대통령선거","충청남도","천안시동남구",1596,884,285,288,192,50,58,3,0,3,0,0,0,1,1,881,3,712
"2023","원성2동","원성2동제4투","대통령선거","충청남도","천안시동남구",2338,1316,372,425,328,72,110,1,0,3,0,0,0,0,1,1312,4,1022
"2024","봉명동","관내사전투표","대통령선거","충청남도","천안시동남구",1748,1748,782,344,353,105,140,4,0,4,0,3,3,1,0,1739,9,0
"2025","봉명동","봉명동제1투","대통령선거","충청남도","천안시동남구",2412,1243,424,322,317,67,102,0,0,1,0,1,2,2,0,1238,5,1169
"2026","봉명동","봉명동제2투","대통령선거","충청남도","천안시동남구",2489,1359,472,359,357,81,83,2,0,0,0,0,0,1,1,1356,3,1130
"2027","봉명동","봉명동제3투","대통령선거","충청남도","천안시동남구",947,533,144,198,142,23,22,0,0,0,0,0,1,0,1,531,2,414
"2028","봉명동","봉명동제4투","대통령선거","충청남도","천안시동남구",1810,967,306,315,239,50,46,1,0,0,0,0,0,3,1,961,6,843
"2029","봉명동","봉명동제5투","대통령선거","충청남도","천안시동남구",2716,1745,639,444,406,112,128,3,0,3,1,2,0,1,1,1740,5,971
"2030","봉명동","봉명동제6투","대통령선거","충청남도","천안시동남구",2136,1332,594,211,353,60,107,0,0,0,1,0,0,0,2,1328,4,804
"2031","일봉동","관내사전투표","대통령선거","충청남도","천안시동남구",1761,1761,729,399,378,97,144,4,0,2,1,1,1,0,1,1757,4,0
"2032","일봉동","일봉동제1투","대통령선거","충청남도","천안시동남구",3173,1783,556,528,471,94,110,6,0,4,1,2,0,1,3,1776,7,1390
"2033","일봉동","일봉동제2투","대통령선거","충청남도","천안시동남구",2202,1421,486,364,356,88,118,0,0,0,1,1,0,0,1,1415,6,781
"2034","일봉동","일봉동제3투","대통령선거","충청남도","천안시동남구",2583,1613,562,431,423,75,109,2,1,1,1,0,1,1,2,1609,4,970
"2035","일봉동","일봉동제4투","대통령선거","충청남도","천안시동남구",3230,2459,1032,515,572,153,177,1,0,1,1,1,0,1,0,2454,5,771
"2036","일봉동","일봉동제5투","대통령선거","충청남도","천안시동남구",3698,2825,1301,433,684,186,197,7,0,1,0,3,1,1,2,2816,9,873
"2037","신방동","관내사전투표","대통령선거","충청남도","천안시동남구",5230,5230,2798,627,1012,327,437,3,0,3,3,1,1,1,3,5216,14,0
"2038","신방동","신방동제1투","대통령선거","충청남도","천안시동남구",2267,1680,700,359,369,119,123,2,0,0,0,0,0,1,1,1674,6,587
"2039","신방동","신방동제2투","대통령선거","충청남도","천안시동남구",2696,2058,932,326,502,129,157,1,0,0,0,1,0,3,2,2053,5,638
"2040","신방동","신방동제3투","대통령선거","충청남도","천안시동남구",3124,2346,1036,374,592,150,177,1,0,2,1,1,1,1,1,2337,9,778
"2041","신방동","신방동제4투","대통령선거","충청남도","천안시동남구",2619,1953,880,286,471,132,168,1,0,3,2,2,0,0,3,1948,5,666
"2042","신방동","신방동제5투","대통령선거","충청남도","천안시동남구",2325,1251,510,221,324,85,99,0,0,2,0,0,2,1,2,1246,5,1074
"2043","신방동","신방동제6투","대통령선거","충청남도","천안시동남구",2367,1251,518,243,318,73,93,1,0,1,0,0,0,0,1,1248,3,1116
"2044","신방동","신방동제7투","대통령선거","충청남도","천안시동남구",1341,816,322,170,190,51,78,0,0,0,0,0,0,0,1,812,4,525
"2045","신방동","신방동제8투","대통령선거","충청남도","천안시동남구",2847,2238,937,417,546,144,175,4,0,2,0,1,0,1,2,2229,9,609
"2046","신방동","신방동제9투","대통령선거","충청남도","천안시동남구",3536,2440,1190,301,561,173,199,2,1,2,2,0,1,1,2,2435,5,1096
"2047","신방동","신방동제10투","대통령선거","충청남도","천안시동남구",3921,2649,1251,376,620,173,215,0,0,2,1,0,0,0,2,2640,9,1272
"2048","청룡동","관내사전투표","대통령선거","충청남도","천안시동남구",5593,5593,2743,948,1085,310,442,7,1,7,1,0,0,2,3,5549,44,0
"2049","청룡동","청룡동제1투","대통령선거","충청남도","천안시동남구",2816,2021,696,540,496,109,157,7,0,3,1,2,0,0,1,2012,9,795
"2050","청룡동","청룡동제2투","대통령선거","충청남도","천안시동남구",2803,1777,613,471,415,120,142,5,1,2,1,0,0,1,1,1772,5,1026
"2051","청룡동","청룡동제3투","대통령선거","충청남도","천안시동남구",2068,1578,658,340,376,104,97,0,0,0,0,0,0,0,1,1576,2,490
"2052","청룡동","청룡동제4투","대통령선거","충청남도","천안시동남구",3671,2657,1067,574,624,171,198,5,0,2,1,3,0,0,2,2647,10,1014
"2053","청룡동","청룡동제5투","대통령선거","충청남도","천안시동남구",3627,2318,757,674,585,119,153,2,2,3,2,6,3,1,3,2310,8,1309
"2054","청룡동","청룡동제6투","대통령선거","충청남도","천안시동남구",1164,686,193,223,195,27,40,0,0,0,1,0,0,1,2,682,4,478
"2055","청룡동","청룡동제7투","대통령선거","충청남도","천안시동남구",3263,2468,1077,437,594,164,186,0,0,3,0,1,0,0,1,2463,5,795
"2056","청룡동","청룡동제8투","대통령선거","충청남도","천안시동남구",1688,1234,605,191,267,67,95,1,0,0,3,1,0,0,0,1230,4,454
"2057","청룡동","청룡동제9투","대통령선거","충청남도","천안시동남구",3815,2426,1055,450,558,145,203,1,0,1,1,2,1,0,2,2419,7,1389
"2058","청룡동","청룡동제10투","대통령선거","충청남도","천안시동남구",2520,1844,793,328,456,119,128,5,0,0,1,0,0,1,2,1833,11,676
"2059","신안동","관내사전투표","대통령선거","충청남도","천안시동남구",3817,3817,1763,610,699,280,429,4,0,5,2,2,1,1,3,3799,18,0
"2060","신안동","신안동제1투","대통령선거","충청남도","천안시동남구",2692,1541,572,403,347,105,101,2,1,2,0,2,0,0,1,1536,5,1151
"2061","신안동","신안동제2투","대통령선거","충청남도","천안시동남구",801,490,163,148,109,27,39,0,0,0,0,0,0,0,3,489,1,311
"2062","신안동","신안동제3투","대통령선거","충청남도","천안시동남구",1724,1000,321,291,244,62,76,1,1,0,0,0,0,0,0,996,4,724
"2063","신안동","신안동제4투","대통령선거","충청남도","천안시동남구",2599,1853,697,514,388,114,125,0,0,2,0,1,0,4,2,1847,6,746
"2064","신안동","신안동제5투","대통령선거","충청남도","천안시동남구",3159,2315,948,450,540,182,179,5,0,0,2,0,0,1,0,2307,8,844
"2065","신안동","신안동제6투","대통령선거","충청남도","천안시동남구",3284,2207,887,462,501,167,172,4,0,2,1,0,0,0,2,2198,9,1077
"2066","신안동","신안동제7투","대통령선거","충청남도","천안시동남구",1062,581,159,207,162,28,21,0,2,0,0,0,1,0,1,581,0,481
"2067","신안동","신안동제8투","대통령선거","충청남도","천안시동남구",2385,1682,613,430,398,106,123,1,0,2,0,2,0,1,0,1676,6,703
"2068","신안동","신안동제9투","대통령선거","충청남도","천안시동남구",2268,1744,617,501,389,123,105,4,0,0,0,1,0,0,0,1740,4,524
"2069","잘못 투입·구분된 투표지","잘못 투입·구분된 투표지","대통령선거","충청남도","천안시동남구",0,0,0,0,0,0,0,0,0,0,0,0,0,0,0,0,0,0
"2070","거소·선상투표","거소·선상투표","대통령선거","충청남도","공주시",195,183,64,43,52,12,3,0,0,1,2,0,0,0,2,179,4,12
"2071","관외사전투표","관외사전투표","대통령선거","충청남도","공주시",7764,7764,3710,1212,1536,540,672,11,2,7,2,9,2,4,13,7720,44,0
"2072","재외투표","재외투표","대통령선거","충청남도","공주시",415,297,172,28,50,15,31,1,0,0,0,0,0,0,0,297,0,118
"2073","유구읍","관내사전투표","대통령선거","충청남도","공주시",993,993,328,309,245,36,60,1,0,0,2,1,1,1,2,986,7,0
"2074","유구읍","유구읍제1투","대통령선거","충청남도","공주시",2749,1647,436,662,419,40,74,0,1,1,0,1,1,1,0,1636,11,1102
"2075","유구읍","유구읍제2투","대통령선거","충청남도","공주시",1771,1102,256,456,286,34,47,1,0,1,2,0,4,2,5,1094,8,669
"2076","유구읍","유구읍제3투","대통령선거","충청남도","공주시",1194,711,175,276,210,17,20,1,0,3,0,1,1,2,2,708,3,483
"2077","이인면","관내사전투표","대통령선거","충청남도","공주시",381,381,145,89,94,30,13,0,0,0,1,2,1,1,0,376,5,0
"2078","이인면","이인면제1투","대통령선거","충청남도","공주시",1488,857,232,330,228,21,38,0,0,0,0,1,0,0,0,850,7,631
"2079","이인면","이인면제2투","대통령선거","충청남도","공주시",1212,780,249,266,200,26,22,1,3,0,0,3,0,2,4,776,4,432
"2080","탄천면","관내사전투표","대통령선거","충청남도","공주시",342,342,137,76,68,9,30,2,0,0,0,1,1,0,4,328,14,0
"2081","탄천면","탄천면제1투","대통령선거","충청남도","공주시",1544,894,226,337,246,25,42,1,0,2,0,3,1,1,1,885,9,650
"2082","탄천면","탄천면제2투","대통령선거","충청남도","공주시",867,557,157,176,179,13,24,1,0,1,1,0,1,1,1,555,2,310
"2083","계룡면","관내사전투표","대통령선거","충청남도","공주시",659,659,254,210,134,33,16,3,0,1,0,2,0,1,0,654,5,0
"2084","계룡면","계룡면제1투","대통령선거","충청남도","공주시",1551,942,279,316,256,33,47,1,1,0,0,2,1,0,2,938,4,609
"2085","계룡면","계룡면제2투","대통령선거","충청남도","공주시",486,314,77,124,82,24,4,1,0,0,0,0,0,0,0,312,2,172
"2086","계룡면","계룡면제3투","대통령선거","충청남도","공주시",830,554,120,230,168,14,11,0,0,1,0,0,1,3,1,549,5,276
"2087","계룡면","계룡면제4투","대통령선거","충청남도","공주시",1486,899,265,295,255,32,39,1,0,0,0,0,1,1,3,892,7,587
"2088","반포면","관내사전투표","대통령선거","충청남도","공주시",664,664,257,195,129,34,31,0,1,2,5,1,0,3,3,661,3,0
"2089","반포면","반포면제1투","대통령선거","충청남도","공주시",1742,1079,349,319,253,57,49,3,2,3,5,4,0,1,4,1049,30,663
"2090","반포면","반포면제2투","대통령선거","충청남도","공주시",1343,851,241,318,225,29,29,2,0,1,0,0,1,1,0,847,4,492
"2091","의당면","관내사전투표","대통령선거","충청남도","공주시",925,925,375,217,229,29,66,0,0,0,1,1,0,1,1,920,5,0
"2092","의당면","의당면제1투","대통령선거","충청남도","공주시",1892,1057,367,258,311,48,65,0,0,1,1,2,0,1,1,1055,2,835
"2093","의당면","의당면제2투","대통령선거","충청남도","공주시",658,449,141,147,121,12,18,0,0,1,0,0,1,2,2,445,4,209
"2094","의당면","의당면제3투","대통령선거","충청남도","공주시",903,544,177,173,152,20,13,0,1,0,0,0,1,2,2,541,3,359
"2095","정안면","관내사전투표","대통령선거","충청남도","공주시",637,637,209,216,147,24,36,0,0,0,0,1,1,1,0,635,2,0
"2096","정안면","정안면제1투","대통령선거","충청남도","공주시",1203,723,189,306,172,12,24,5,0,3,0,1,1,1,1,715,8,480
"2097","정안면","정안면제2투","대통령선거","충청남도","공주시",824,524,147,205,126,19,17,0,0,1,0,1,1,2,0,519,5,300
"2098","정안면","정안면제3투","대통령선거","충청남도","공주시",1567,954,233,341,301,28,36,1,0,2,1,0,0,4,1,948,6,613
"2099","우성면","관내사전투표","대통령선거","충청남도","공주시",490,490,214,110,116,17,27,1,0,0,0,0,1,1,0,487,3,0
"2100","우성면","우성면제1투","대통령선거","충청남도","공주시",889,551,162,207,118,18,37,1,0,1,0,0,1,2,1,548,3,338
"2101","우성면","우성면제2투","대통령선거","충청남도","공주시",1059,704,230,261,158,17,30,0,0,0,0,0,0,2,2,700,4,355
"2102","우성면","우성면제3투","대통령선거","충청남도","공주시",1350,890,283,260,272,29,34,1,2,0,0,0,2,2,0,885,5,460
"2103","우성면","우성면제4투","대통령선거","충청남도","공주시",873,516,131,226,117,9,23,0,0,0,0,2,2,3,1,514,2,357
"2104","사곡면","관내사전투표","대통령선거","충청남도","공주시",465,465,160,166,101,14,16,2,0,0,0,0,0,3,0,462,3,0
"2105","사곡면","사곡면제1투","대통령선거","충청남도","공주시",1244,720,186,276,194,15,39,2,0,0,0,0,1,1,1,715,5,524
"2106","사곡면","사곡면제2투","대통령선거","충청남도","공주시",921,601,206,188,152,18,24,0,1,0,0,2,1,2,3,597,4,320
"2107","신풍면","관내사전투표","대통령선거","충청남도","공주시",588,588,184,199,152,16,25,1,0,0,0,1,2,1,2,583,5,0
"2108","신풍면","신풍면제1투","대통령선거","충청남도","공주시",1364,777,197,295,217,24,36,1,0,1,0,0,2,3,1,777,0,587
"2109","신풍면","신풍면제2투","대통령선거","충청남도","공주시",733,444,121,142,138,10,25,1,1,0,1,1,1,0,2,443,1,289
"2110","중학동","관내사전투표","대통령선거","충청남도","공주시",847,847,361,214,181,44,37,1,0,0,0,1,0,0,1,840,7,0
"2111","중학동","중학동제1투","대통령선거","충청남도","공주시",735,392,129,121,101,16,20,3,0,1,0,0,0,1,0,392,0,343
"2112","중학동","중학동제2투","대통령선거","충청남도","공주시",923,586,197,178,162,23,21,2,0,0,0,0,0,0,1,584,2,337
"2113","중학동","중학동제3투","대통령선거","충청남도","공주시",1101,672,213,209,188,31,25,0,1,2,0,0,0,0,0,669,3,429
"2114","중학동","중학동제4투","대통령선거","충청남도","공주시",954,569,206,149,165,23,23,0,0,0,0,0,0,0,1,567,2,385
"2115","웅진동","관내사전투표","대통령선거","충청남도","공주시",1560,1560,596,416,381,57,92,1,2,2,0,0,1,1,3,1552,8,0
"2116","웅진동","웅진동제1투","대통령선거","충청남도","공주시",1031,589,213,163,152,24,29,1,0,0,0,1,1,1,2,587,2,442
"2117","웅진동","웅진동제2투","대통령선거","충청남도","공주시",1208,730,208,288,168,29,33,0,0,1,0,0,0,2,0,729,1,478
"2118","웅진동","웅진동제3투","대통령선거","충청남도","공주시",1908,1210,400,370,321,50,56,0,0,3,0,0,2,2,1,1205,5,698
"2119","웅진동","웅진동제4투","대통령선거","충청남도","공주시",1397,867,310,253,213,38,42,1,0,0,0,2,0,0,1,860,7,530
"2120","금학동","관내사전투표","대통령선거","충청남도","공주시",1075,1075,516,187,198,69,93,0,0,1,0,0,1,0,2,1067,8,0
"2121","금학동","금학동제1투","대통령선거","충청남도","공주시",2313,1508,629,372,341,64,96,1,0,0,0,1,1,0,2,1507,1,805
"2122","금학동","금학동제2투","대통령선거","충청남도","공주시",1220,708,202,240,188,19,31,5,0,0,2,1,2,3,3,696,12,512
"2123","옥룡동","관내사전투표","대통령선거","충청남도","공주시",1303,1303,562,344,248,53,83,4,0,4,0,0,3,1,0,1302,1,0
"2124","옥룡동","옥룡동제1투","대통령선거","충청남도","공주시",1178,720,206,227,213,27,40,0,0,0,1,0,3,1,1,719,1,458
"2125","옥룡동","옥룡동제2투","대통령선거","충청남도","공주시",2551,1468,503,467,358,56,68,1,0,0,2,2,0,1,2,1460,8,1083
"2126","옥룡동","옥룡동제3투","대통령선거","충청남도","공주시",1615,1001,385,250,266,40,41,1,0,0,0,2,2,1,2,990,11,614
"2127","옥룡동","옥룡동제4투","대통령선거","충청남도","공주시",962,596,192,185,154,21,28,1,0,0,0,2,1,0,3,587,9,366
"2128","신관동","관내사전투표","대통령선거","충청남도","공주시",3877,3877,1941,714,645,243,297,4,0,1,0,9,0,1,7,3862,15,0
"2129","신관동","신관동제1투","대통령선거","충청남도","공주시",1971,1196,455,293,297,71,72,1,0,0,0,1,0,0,1,1191,5,775
"2130","신관동","신관동제2투","대통령선거","충청남도","공주시",2149,1442,649,314,291,69,107,1,0,0,0,3,0,0,2,1436,6,707
"2131","신관동","신관동제3투","대통령선거","충청남도","공주시",1846,1144,476,245,282,48,80,2,2,2,0,0,0,1,1,1139,5,702
"2132","신관동","신관동제4투","대통령선거","충청남도","공주시",2301,1295,517,319,276,69,98,1,0,0,0,3,0,3,0,1286,9,1006
"2133","신관동","신관동제5투","대통령선거","충청남도","공주시",2198,1389,532,387,307,68,84,0,2,1,0,2,1,0,0,1384,5,809
"2134","월송동","관내사전투표","대통령선거","충청남도","공주시",1464,1464,755,242,281,66,105,1,0,3,1,2,1,1,1,1459,5,0
"2135","월송동","월송동제1투","대통령선거","충청남도","공주시",2637,1860,857,356,399,88,144,1,0,0,1,1,1,1,2,1851,9,777
"2136","월송동","월송동제2투","대통령선거","충청남도","공주시",2226,1498,674,325,319,71,98,1,2,3,0,0,1,1,0,1495,3,728
"2137","월송동","월송동제3투","대통령선거","충청남도","공주시",642,423,111,161,110,18,16,1,0,0,0,1,1,1,1,421,2,219
"2138","잘못 투입·구분된 투표지","잘못 투입·구분된 투표지","대통령선거","충청남도","공주시",0,0,0,0,0,0,0,0,0,0,0,0,0,0,0,0,0,0
"2139","거소·선상투표","거소·선상투표","대통령선거","충청남도","보령시",232,213,72,45,67,4,13,1,0,0,0,0,0,0,1,203,10,19
"2140","관외사전투표","관외사전투표","대통령선거","충청남도","보령시",6781,6781,3013,1048,1457,530,615,7,1,5,6,9,6,3,24,6724,57,0
"2141","재외투표","재외투표","대통령선거","충청남도","보령시",291,221,128,11,39,7,34,2,0,0,0,0,0,0,0,221,0,70
"2142","웅천읍","관내사전투표","대통령선거","충청남도","보령시",1132,1132,404,368,231,50,51,2,2,0,0,3,1,0,5,1117,15,0
"2143","웅천읍","웅천읍제1투","대통령선거","충청남도","보령시",1872,1147,250,506,310,27,35,3,1,0,0,5,0,2,0,1139,8,725
"2144","웅천읍","웅천읍제2투","대통령선거","충청남도","보령시",1441,849,192,384,204,28,30,0,0,1,1,3,2,1,1,847,2,592
"2145","웅천읍","웅천읍제3투","대통령선거","충청남도","보령시",1292,801,196,299,249,21,23,1,1,0,0,0,1,1,2,794,7,491
"2146","주포면","관내사전투표","대통령선거","충청남도","보령시",339,339,113,100,93,19,10,0,0,2,0,0,0,0,0,337,2,0
"2147","주포면","주포면투표소","대통령선거","충청남도","보령시",1167,711,182,275,186,38,20,1,0,1,0,0,0,0,1,704,7,456
"2148","주교면","관내사전투표","대통령선거","충청남도","보령시",946,946,382,189,196,32,61,3,1,1,3,6,2,6,8,890,56,0
"2149","주교면","주교면제1투","대통령선거","충청남도","보령시",2119,1210,346,454,291,44,54,3,0,2,1,0,1,1,2,1199,11,909
"2150","주교면","주교면제2투","대통령선거","충청남도","보령시",1461,896,208,351,253,28,45,3,0,1,0,0,0,1,3,893,3,565
"2151","오천면","관내사전투표","대통령선거","충청남도","보령시",401,401,151,111,104,11,21,0,0,0,0,0,0,1,1,400,1,0
"2152","오천면","오천면제1투","대통령선거","충청남도","보령시",1445,878,209,344,240,31,37,0,1,2,0,0,1,3,0,868,10,567
"2153","오천면","오천면제2투","대통령선거","충청남도","보령시",193,94,17,42,27,0,6,0,0,0,1,0,0,0,0,93,1,99
"2154","오천면","오천면제3투","대통령선거","충청남도","보령시",763,447,76,269,65,20,4,1,0,0,0,1,4,2,1,443,4,316
"2155","오천면","오천면제4투","대통령선거","충청남도","보령시",330,204,28,74,82,7,12,0,0,0,0,0,0,1,0,204,0,126
"2156","오천면","오천면제5투","대통령선거","충청남도","보령시",158,93,15,51,24,0,0,0,0,0,0,0,0,0,0,90,3,65
"2157","오천면","오천면제6투","대통령선거","충청남도","보령시",175,119,39,31,36,2,10,0,0,0,0,0,0,0,0,118,1,56
"2158","오천면","오천면제7투","대통령선거","충청남도","보령시",113,68,22,23,14,0,4,0,0,0,0,0,1,1,0,65,3,45
"2159","오천면","오천면제8투","대통령선거","충청남도","보령시",173,108,23,48,25,3,4,0,0,0,0,0,0,0,3,106,2,65
"2160","오천면","오천면제9투","대통령선거","충청남도","보령시",307,145,44,42,48,4,6,0,0,0,0,0,0,0,0,144,1,162
"2161","천북면","관내사전투표","대통령선거","충청남도","보령시",321,321,106,99,77,13,22,1,0,0,0,0,0,1,0,319,2,0
"2162","천북면","천북면제1투","대통령선거","충청남도","보령시",1874,1245,292,522,317,36,58,2,0,0,0,0,5,2,2,1236,9,629
"2163","천북면","천북면제2투","대통령선거","충청남도","보령시",921,628,181,228,163,22,24,0,0,1,0,0,0,1,3,623,5,293
"2164","청소면","관내사전투표","대통령선거","충청남도","보령시",574,574,162,225,135,18,23,1,2,2,0,0,0,0,0,568,6,0
"2165","청소면","청소면투표소","대통령선거","충청남도","보령시",1941,1225,262,564,296,44,40,2,0,1,1,0,1,3,0,1214,11,716
"2166","청라면","관내사전투표","대통령선거","충청남도","보령시",451,451,145,153,99,14,32,0,0,1,0,1,0,0,1,446,5,0
"2167","청라면","청라면제1투","대통령선거","충청남도","보령시",997,644,142,274,173,18,25,0,0,0,0,0,1,1,1,635,9,353
"2168","청라면","청라면제2투","대통령선거","충청남도","보령시",1076,746,168,310,209,27,22,1,0,0,0,1,0,1,0,739,7,330
"2169","청라면","청라면제3투","대통령선거","충청남도","보령시",959,602,137,247,162,19,25,2,0,3,2,0,0,1,0,598,4,357
"2170","남포면","관내사전투표","대통령선거","충청남도","보령시",533,533,163,152,158,20,33,0,1,0,0,0,0,0,2,529,4,0
"2171","남포면","남포면제1투","대통령선거","충청남도","보령시",1517,921,255,328,261,33,31,0,0,1,0,0,2,2,2,915,6,596
"2172","남포면","남포면제2투","대통령선거","충청남도","보령시",1409,841,178,333,252,26,35,2,0,0,1,2,1,2,1,833,8,568
"2173","남포면","남포면제3투","대통령선거","충청남도","보령시",1008,627,158,217,191,21,27,0,0,3,0,1,3,0,3,624,3,381
"2174","주산면","관내사전투표","대통령선거","충청남도","보령시",400,400,108,138,111,9,26,0,0,1,2,0,0,1,1,397,3,0
"2175","주산면","주산면제1투","대통령선거","충청남도","보령시",1352,889,216,363,242,26,28,0,0,0,0,1,0,4,2,882,7,463
"2176","주산면","주산면제2투","대통령선거","충청남도","보령시",485,313,86,95,105,5,13,0,0,1,0,0,0,0,2,307,6,172
"2177","미산면","관내사전투표","대통령선거","충청남도","보령시",180,180,52,58,46,12,8,1,0,1,0,0,0,0,0,178,2,0
"2178","미산면","미산면제1투","대통령선거","충청남도","보령시",502,326,69,132,99,8,7,1,0,1,0,0,0,4,1,322,4,176
"2179","미산면","미산면제2투","대통령선거","충청남도","보령시",475,326,57,155,87,9,12,1,0,1,1,0,0,2,1,326,0,149
"2180","미산면","미산면제3투","대통령선거","충청남도","보령시",416,285,63,134,66,9,6,1,0,1,0,0,1,0,1,282,3,131
"2181","성주면","관내사전투표","대통령선거","충청남도","보령시",505,505,206,131,118,19,27,2,0,0,0,0,0,0,0,503,2,0
"2182","성주면","성주면제1투","대통령선거","충청남도","보령시",1226,692,182,240,199,26,36,0,0,0,1,1,2,1,0,688,4,534
"2183","성주면","성주면제2투","대통령선거","충청남도","보령시",516,336,93,119,93,12,9,4,0,0,2,0,1,1,0,334,2,180
"2184","대천1동","관내사전투표","대통령선거","충청남도","보령시",2499,2499,1030,669,489,123,170,2,0,2,0,1,4,1,3,2494,5,0
"2185","대천1동","대천1동제1투","대통령선거","충청남도","보령시",1478,756,193,339,181,24,16,0,0,0,1,1,0,0,0,755,1,722
"2186","대천1동","대천1동제2투","대통령선거","충청남도","보령시",1216,747,204,312,175,31,18,0,0,0,0,0,0,0,0,740,7,469
"2187","대천1동","대천1동제3투","대통령선거","충청남도","보령시",1982,1211,295,485,314,52,49,0,0,2,0,3,0,0,1,1201,10,771
"2188","대천1동","대천1동제4투","대통령선거","충청남도","보령시",2066,1400,476,386,348,76,104,1,0,2,0,2,1,1,0,1397,3,666
"2189","대천1동","대천1동제5투","대통령선거","충청남도","보령시",2721,1789,773,343,417,95,145,3,0,5,0,3,1,1,1,1787,2,932
"2190","대천2동","관내사전투표","대통령선거","충청남도","보령시",2053,2053,788,576,438,98,136,1,0,3,0,3,1,0,1,2045,8,0
"2191","대천2동","대천2동제1투","대통령선거","충청남도","보령시",1277,734,220,240,197,34,39,0,0,1,0,1,0,0,1,733,1,543
"2192","대천2동","대천2동제2투","대통령선거","충청남도","보령시",848,526,126,220,141,20,14,0,0,2,0,1,0,0,0,524,2,322
"2193","대천2동","대천2동제3투","대통령선거","충청남도","보령시",2213,1430,527,388,343,61,96,3,0,2,0,0,1,1,3,1425,5,783
"2194","대천3동","관내사전투표","대통령선거","충청남도","보령시",2166,2166,984,412,476,102,178,2,0,1,1,1,0,1,0,2158,8,0
"2195","대천3동","대천3동제1투","대통령선거","충청남도","보령시",1723,1022,288,351,255,45,72,3,0,1,1,3,1,0,2,1022,0,701
"2196","대천3동","대천3동제2투","대통령선거","충청남도","보령시",2244,1519,656,358,348,58,92,0,0,0,0,1,0,0,0,1513,6,725
"2197","대천3동","대천3동제3투","대통령선거","충청남도","보령시",2308,1349,429,441,345,61,62,0,0,1,0,2,1,1,1,1344,5,959
"2198","대천3동","대천3동제4투","대통령선거","충청남도","보령시",1812,1060,379,270,266,67,69,0,1,0,1,3,1,1,0,1058,2,752
"2199","대천4동","관내사전투표","대통령선거","충청남도","보령시",2541,2540,1076,530,561,151,205,4,0,2,0,2,0,2,0,2533,7,1
"2200","대천4동","대천4동제1투","대통령선거","충청남도","보령시",938,540,148,190,143,24,29,0,0,2,0,0,0,0,0,536,4,398
"2201","대천4동","대천4동제2투","대통령선거","충청남도","보령시",1708,1121,330,381,295,53,54,0,0,1,1,0,0,2,2,1119,2,587
"2202","대천4동","대천4동제3투","대통령선거","충청남도","보령시",1524,910,282,272,278,30,31,2,2,0,0,2,0,0,3,902,8,614
"2203","대천4동","대천4동제4투","대통령선거","충청남도","보령시",3312,2184,800,553,534,113,173,2,0,0,0,0,0,0,2,2177,7,1128
"2204","대천5동","관내사전투표","대통령선거","충청남도","보령시",928,928,312,310,214,36,38,0,3,3,0,0,0,0,1,917,11,0
"2205","대천5동","대천5동제1투","대통령선거","충청남도","보령시",1380,783,205,296,218,35,25,0,0,0,0,0,2,0,2,783,0,597
"2206","대천5동","대천5동제2투","대통령선거","충청남도","보령시",1774,1009,296,351,278,29,34,3,0,3,0,2,1,1,1,999,10,765
"2207","대천5동","대천5동제3투","대통령선거","충청남도","보령시",1794,1136,266,498,274,49,33,0,0,2,0,0,1,2,3,1128,8,658
"2208","잘못 투입·구분된 투표지","잘못 투입·구분된 투표지","대통령선거","충청남도","보령시",0,0,0,0,0,0,0,0,0,0,0,0,0,0,0,0,0,0
"2209","거소·선상투표","거소·선상투표","대통령선거","충청남도","아산시",449,424,147,53,140,23,19,1,2,2,3,2,3,1,2,398,26,25
"2210","관외사전투표","관외사전투표","대통령선거","충청남도","아산시",18529,18529,8677,2655,3839,1460,1651,25,5,13,1,9,8,10,36,18389,140,0
"2211","재외투표","재외투표","대통령선거","충청남도","아산시",1017,770,494,39,107,32,88,4,0,0,1,0,1,0,0,766,4,247
"2212","염치읍","관내사전투표","대통령선거","충청남도","아산시",811,811,345,194,167,45,51,1,0,0,0,1,1,1,0,806,5,0
"2213","염치읍","염치읍제1투","대통령선거","충청남도","아산시",1205,679,195,251,164,31,30,1,0,0,0,1,0,1,2,676,3,526
"2214","염치읍","염치읍제2투","대통령선거","충청남도","아산시",1491,846,292,245,209,29,60,1,1,0,0,0,1,1,0,839,7,645
"2215","염치읍","염치읍제3투","대통령선거","충청남도","아산시",2167,1301,411,408,309,75,84,1,0,3,0,2,1,0,4,1298,3,866
"2216","배방읍","관내사전투표","대통령선거","충청남도","아산시",6547,6547,3602,803,1177,370,553,7,3,3,3,3,1,1,6,6532,15,0
"2217","배방읍","배방읍제1투","대통령선거","충청남도","아산시",861,575,161,204,148,30,23,1,0,1,0,0,0,2,0,570,5,286
"2218","배방읍","배방읍제2투","대통령선거","충청남도","아산시",2984,1690,598,464,388,110,110,2,2,3,2,0,0,2,2,1683,7,1294
"2219","배방읍","배방읍제3투","대통령선거","충청남도","아산시",2309,1744,942,211,361,109,114,0,0,0,0,3,0,0,0,1740,4,565
"2220","배방읍","배방읍제4투","대통령선거","충청남도","아산시",2414,1945,937,314,418,142,127,1,0,2,0,2,0,0,0,1943,2,469
"2221","배방읍","배방읍제5투","대통령선거","충청남도","아산시",3329,2046,1020,279,456,117,159,4,0,0,0,2,0,0,1,2038,8,1283
"2222","배방읍","배방읍제6투","대통령선거","충청남도","아산시",1999,1548,788,225,313,95,117,4,0,0,1,0,1,1,1,1546,2,451
"2223","배방읍","배방읍제7투","대통령선거","충청남도","아산시",2744,1819,903,283,412,111,102,1,0,1,0,1,0,0,1,1815,4,925
"2224","배방읍","배방읍제8투","대통령선거","충청남도","아산시",1215,731,210,280,163,39,32,0,0,0,0,0,0,0,1,725,6,484
"2225","배방읍","배방읍제9투","대통령선거","충청남도","아산시",3124,2530,1273,354,553,137,202,1,0,0,0,3,0,2,1,2526,4,594
"2226","배방읍","배방읍제10투","대통령선거","충청남도","아산시",1015,664,181,276,148,32,23,0,0,1,0,0,0,0,0,661,3,351
"2227","배방읍","배방읍제11투","대통령선거","충청남도","아산시",1575,1037,439,180,261,57,93,3,0,0,0,1,1,1,0,1036,1,538
"2228","배방읍","배방읍제12투","대통령선거","충청남도","아산시",3577,2678,1309,371,605,191,189,4,0,0,1,0,0,1,1,2672,6,899
"2229","배방읍","배방읍제13투","대통령선거","충청남도","아산시",3297,2442,1183,368,563,145,162,3,2,2,0,4,0,0,1,2433,9,855
"2230","배방읍","배방읍제14투","대통령선거","충청남도","아산시",2310,1881,845,292,467,163,107,1,0,1,0,0,0,1,1,1878,3,429
"2231","배방읍","배방읍제15투","대통령선거","충청남도","아산시",1674,1331,655,183,325,85,82,0,0,0,0,0,0,0,0,1330,1,343
"2232","배방읍","배방읍제16투","대통령선거","충청남도","아산시",2132,1396,738,131,298,93,125,1,0,2,0,0,0,0,2,1390,6,736
"2233","송악면","관내사전투표","대통령선거","충청남도","아산시",558,558,196,178,122,18,36,1,1,1,0,2,0,0,1,556,2,0
"2234","송악면","송악면제1투","대통령선거","충청남도","아산시",1374,865,253,334,179,34,52,1,0,0,1,0,2,0,3,859,6,509
"2235","송악면","송악면제2투","대통령선거","충청남도","아산시",831,516,170,184,110,20,24,0,0,1,1,1,1,3,0,515,1,315
"2236","송악면","송악면제3투","대통령선거","충청남도","아산시",551,381,128,131,93,7,20,0,0,0,0,0,0,0,0,379,2,170
"2237","탕정면","관내사전투표","대통령선거","충청남도","아산시",3333,3333,1884,328,567,233,293,3,0,1,2,2,0,1,5,3319,14,0
"2238","탕정면","탕정면제1투","대통령선거","충청남도","아산시",1867,1035,346,302,240,56,75,3,0,0,4,0,1,2,1,1030,5,832
"2239","탕정면","탕정면제2투","대통령선거","충청남도","아산시",2180,1223,463,238,275,72,164,0,1,0,0,2,2,0,0,1217,6,957
"2240","탕정면","탕정면제3투","대통령선거","충청남도","아산시",1116,562,271,68,73,74,69,0,0,1,0,1,0,1,0,558,4,554
"2241","탕정면","탕정면제4투","대통령선거","충청남도","아산시",3336,2770,1542,210,633,218,159,0,0,0,0,2,0,1,0,2765,5,566
"2242","탕정면","탕정면제5투","대통령선거","충청남도","아산시",2432,2061,1297,112,396,150,102,0,0,0,1,0,0,0,0,2058,3,371
"2243","음봉면","관내사전투표","대통령선거","충청남도","아산시",1503,1503,754,262,317,72,94,1,0,1,0,0,1,0,1,1503,0,0
"2244","음봉면","음봉면제1투","대통령선거","충청남도","아산시",1386,793,202,316,183,35,46,2,0,0,0,0,0,1,1,786,7,593
"2245","음봉면","음봉면제2투","대통령선거","충청남도","아산시",2685,1661,679,335,401,104,132,0,0,1,1,0,1,0,1,1655,6,1024
"2246","음봉면","음봉면제3투","대통령선거","충청남도","아산시",1180,794,218,301,191,35,44,0,0,1,0,2,0,1,0,793,1,386
"2247","음봉면","음봉면제4투","대통령선거","충청남도","아산시",2953,2008,799,459,471,124,138,4,0,0,0,1,1,2,2,2001,7,945
"2248","음봉면","음봉면제5투","대통령선거","충청남도","아산시",1230,624,261,111,175,32,35,4,0,1,0,0,1,0,2,622,2,606
"2249","음봉면","음봉면제6투","대통령선거","충청남도","아산시",2970,2336,1268,214,528,156,159,0,1,3,0,1,0,0,2,2332,4,634
"2250","둔포면","관내사전투표","대통령선거","충청남도","아산시",1800,1800,856,366,359,96,114,1,0,3,0,0,0,0,2,1797,3,0
"2251","둔포면","둔포면제1투","대통령선거","충청남도","아산시",1669,944,267,351,232,42,46,1,0,1,0,0,0,0,0,940,4,725
"2252","둔포면","둔포면제2투","대통령선거","충청남도","아산시",901,589,119,234,161,29,40,0,0,2,0,0,0,0,1,586,3,312
"2253","둔포면","둔포면제3투","대통령선거","충청남도","아산시",1287,807,228,298,220,26,28,1,0,0,0,0,0,1,1,803,4,480
"2254","둔포면","둔포면제4투","대통령선거","충청남도","아산시",3857,2440,1047,425,614,147,182,1,0,5,1,0,4,0,6,2432,8,1417
"2255","둔포면","둔포면제5투","대통령선거","충청남도","아산시",2297,1309,423,359,364,73,77,3,0,0,0,1,0,0,2,1302,7,988
"2256","영인면","관내사전투표","대통령선거","충청남도","아산시",1012,1012,390,263,214,41,80,3,1,3,3,3,0,1,0,1002,10,0
"2257","영인면","영인면제1투","대통령선거","충청남도","아산시",1355,784,223,253,204,43,53,0,0,0,0,1,0,2,1,780,4,571
"2258","영인면","영인면제2투","대통령선거","충청남도","아산시",985,670,159,231,218,23,28,2,0,0,0,1,1,1,2,666,4,315
"2259","영인면","영인면제3투","대통령선거","충청남도","아산시",1274,863,225,329,194,36,37,1,2,2,1,1,0,0,2,830,33,411
"2260","영인면","영인면제4투","대통령선거","충청남도","아산시",678,464,136,180,109,9,26,0,0,1,1,0,0,0,0,462,2,214
"2261","인주면","관내사전투표","대통령선거","충청남도","아산시",1332,1332,552,270,264,80,145,4,2,0,0,4,0,2,3,1326,6,0
"2262","인주면","인주면제1투","대통령선거","충청남도","아산시",1456,872,303,231,241,40,44,2,0,0,0,0,1,1,2,865,7,584
"2263","인주면","인주면제2투","대통령선거","충청남도","아산시",1805,890,286,280,198,47,62,3,2,1,0,2,1,0,1,883,7,915
"2264","인주면","인주면제3투","대통령선거","충청남도","아산시",1352,854,312,207,208,40,81,0,0,1,0,0,0,0,0,849,5,498
"2265","선장면","관내사전투표","대통령선거","충청남도","아산시",486,486,158,171,98,23,29,1,0,0,0,1,0,1,0,482,4,0
"2266","선장면","선장면제1투","대통령선거","충청남도","아산시",949,541,120,232,142,21,18,0,0,3,0,0,1,1,1,539,2,408
"2267","선장면","선장면제2투","대통령선거","충청남도","아산시",832,500,110,219,134,13,18,0,0,0,0,2,1,0,0,497,3,332
"2268","선장면","선장면제3투","대통령선거","충청남도","아산시",793,527,126,216,148,19,14,1,0,0,0,0,0,0,0,524,3,266
"2269","도고면","관내사전투표","대통령선거","충청남도","아산시",717,717,247,236,163,31,33,2,0,2,0,0,0,0,0,714,3,0
"2270","도고면","도고면제1투","대통령선거","충청남도","아산시",1538,915,238,358,228,28,48,2,0,4,0,0,1,0,1,908,7,623
"2271","도고면","도고면제2투","대통령선거","충청남도","아산시",927,560,126,236,146,27,20,1,0,0,0,1,0,0,2,559,1,367
"2272","도고면","도고면제3투","대통령선거","충청남도","아산시",955,640,124,296,150,34,19,0,0,2,0,1,0,5,2,633,7,315
"2273","신창면","관내사전투표","대통령선거","충청남도","아산시",1737,1737,767,317,400,85,154,0,0,0,0,1,0,1,3,1728,9,0
"2274","신창면","신창면제1투","대통령선거","충청남도","아산시",1247,685,181,257,177,17,46,0,0,0,1,1,2,1,2,685,0,562
"2275","신창면","신창면제2투","대통령선거","충청남도","아산시",776,491,126,184,139,16,20,0,0,3,0,0,0,1,0,489,2,285
"2276","신창면","신창면제3투","대통령선거","충청남도","아산시",1638,974,235,392,242,44,54,0,0,0,0,1,0,0,1,969,5,664
"2277","신창면","신창면제4투","대통령선거","충청남도","아산시",2420,1480,567,318,382,88,102,1,1,1,0,2,2,0,3,1467,13,940
"2278","신창면","신창면제5투","대통령선거","충청남도","아산시",2958,1802,711,378,436,114,150,6,0,0,0,2,1,1,0,1799,3,1156
"2279","신창면","신창면제6투","대통령선거","충청남도","아산시",3012,1800,728,391,417,80,168,0,2,0,1,0,0,0,1,1788,12,1212
"2280","신창면","신창면제7투","대통령선거","충청남도","아산시",1842,1204,518,244,253,68,110,2,0,1,0,0,1,0,1,1198,6,638
"2281","온양1동","관내사전투표","대통령선거","충청남도","아산시",2050,2050,834,545,393,112,157,2,1,0,1,0,0,1,2,2048,2,0
"2282","온양1동","온양1동제1투","대통령선거","충청남도","아산시",1068,631,150,279,124,36,38,0,0,0,0,0,0,0,0,627,4,437
"2283","온양1동","온양1동제2투","대통령선거","충청남도","아산시",3452,2144,839,483,499,138,169,2,0,3,0,2,1,0,3,2139,5,1308
"2284","온양1동","온양1동제3투","대통령선거","충청남도","아산시",995,486,113,196,131,15,27,0,0,0,0,0,0,0,0,482,4,509
"2285","온양2동","관내사전투표","대통령선거","충청남도","아산시",2520,2520,991,653,500,134,212,4,1,3,2,2,0,0,1,2503,17,0
"2286","온양2동","온양2동제1투","대통령선거","충청남도","아산시",1902,1171,347,388,289,65,72,1,0,0,0,0,1,1,1,1165,6,731
"2287","온양2동","온양2동제2투","대통령선거","충청남도","아산시",1713,1053,335,336,248,52,76,1,0,2,0,0,1,0,0,1051,2,660
"2288","온양2동","온양2동제3투","대통령선거","충청남도","아산시",1588,839,274,265,198,36,55,4,3,0,1,0,0,1,0,837,2,749
"2289","온양3동","관내사전투표","대통령선거","충청남도","아산시",4897,4897,2275,991,915,262,430,3,1,4,0,2,1,0,1,4885,12,0
"2290","온양3동","온양3동제1투","대통령선거","충청남도","아산시",3479,2413,931,540,549,161,211,3,0,0,2,1,2,0,3,2403,10,1066
"2291","온양3동","온양3동제2투","대통령선거","충청남도","아산시",3330,1963,621,689,410,77,144,3,0,1,3,3,0,0,1,1952,11,1367
"2292","온양3동","온양3동제3투","대통령선거","충청남도","아산시",2843,1944,816,398,407,126,181,4,1,1,0,0,0,0,1,1935,9,899
"2293","온양3동","온양3동제4투","대통령선거","충청남도","아산시",1629,1163,538,195,251,63,112,0,0,0,0,0,0,0,1,1160,3,466
"2294","온양3동","온양3동제5투","대통령선거","충청남도","아산시",3292,2142,742,611,470,112,182,3,0,4,1,3,1,0,4,2133,9,1150
"2295","온양3동","온양3동제6투","대통령선거","충청남도","아산시",3187,2127,785,559,472,116,173,3,0,1,1,0,0,1,1,2112,15,1060
"2296","온양3동","온양3동제7투","대통령선거","충청남도","아산시",1760,1395,735,146,300,77,131,0,0,0,0,0,0,2,1,1392,3,365
"2297","온양4동","관내사전투표","대통령선거","충청남도","아산시",1970,1970,898,364,388,125,175,4,1,3,0,1,0,0,2,1961,9,0
"2298","온양4동","온양4동제1투","대통령선거","충청남도","아산시",2705,1891,752,456,437,83,145,2,0,2,2,1,0,1,5,1886,5,814
"2299","온양4동","온양4동제2투","대통령선거","충청남도","아산시",3314,2263,914,493,507,135,207,2,0,0,0,1,0,0,1,2260,3,1051
"2300","온양4동","온양4동제3투","대통령선거","충청남도","아산시",1724,1057,262,422,250,59,51,0,0,2,0,1,0,3,3,1053,4,667
"2301","온양4동","온양4동제4투","대통령선거","충청남도","아산시",2342,1130,455,225,261,74,101,3,0,0,1,2,0,2,1,1125,5,1212
"2302","온양4동","온양4동제5투","대통령선거","충청남도","아산시",1897,1234,498,241,302,62,120,1,0,1,1,3,0,1,1,1231,3,663
"2303","온양5동","관내사전투표","대통령선거","충청남도","아산시",2460,2460,1231,378,444,144,242,2,0,1,1,1,2,0,0,2446,14,0
"2304","온양5동","온양5동제1투","대통령선거","충청남도","아산시",2804,1840,675,465,428,91,157,2,0,8,1,0,1,4,1,1833,7,964
"2305","온양5동","온양5동제2투","대통령선거","충청남도","아산시",2901,1837,613,521,464,86,140,3,0,3,0,0,2,0,1,1833,4,1064
"2306","온양5동","온양5동제3투","대통령선거","충청남도","아산시",1626,1028,361,297,224,61,76,2,1,1,2,0,0,0,0,1025,3,598
"2307","온양5동","온양5동제4투","대통령선거","충청남도","아산시",3567,2350,846,574,557,135,222,2,0,2,1,0,1,0,3,2343,7,1217
"2308","온양5동","온양5동제5투","대통령선거","충청남도","아산시",2852,1495,670,207,341,111,149,4,1,0,0,0,0,0,6,1489,6,1357
"2309","온양5동","온양5동제6투","대통령선거","충청남도","아산시",2277,1785,880,265,339,110,181,3,0,0,1,2,2,0,1,1784,1,492
"2310","온양6동","관내사전투표","대통령선거","충청남도","아산시",2190,2190,1110,342,403,123,195,5,0,2,1,1,2,0,2,2186,4,0
"2311","온양6동","온양6동제1투","대통령선거","충청남도","아산시",1964,1181,392,361,249,71,90,2,0,0,0,1,0,2,4,1172,9,783
"2312","온양6동","온양6동제2투","대통령선거","충청남도","아산시",2286,1548,638,294,356,97,154,0,0,0,0,1,0,1,2,1543,5,738
"2313","온양6동","온양6동제3투","대통령선거","충청남도","아산시",1503,926,220,368,250,36,28,1,1,1,1,3,1,4,1,915,11,577
"2314","온양6동","온양6동제4투","대통령선거","충청남도","아산시",2870,1824,682,424,470,82,151,3,0,3,0,0,1,1,3,1820,4,1046
"2315","온양6동","온양6동제5투","대통령선거","충청남도","아산시",2369,1447,596,322,341,81,99,3,1,0,0,0,1,0,2,1446,1,922
"2316","온양6동","온양6동제6투","대통령선거","충청남도","아산시",2359,1664,706,330,371,109,136,1,0,3,0,0,0,1,4,1661,3,695
"2317","온양6동","온양6동제7투","대통령선거","충청남도","아산시",2575,2061,1052,250,430,154,160,1,1,1,1,1,0,3,0,2054,7,514
"2318","잘못 투입·구분된 투표지","잘못 투입·구분된 투표지","대통령선거","충청남도","아산시",0,0,0,0,0,0,0,0,0,0,0,0,0,0,0,0,0,0
"2319","거소·선상투표","거소·선상투표","대통령선거","충청남도","서산시",442,416,150,75,105,21,20,3,4,4,0,3,7,2,3,397,19,26
"2320","관외사전투표","관외사전투표","대통령선거","충청남도","서산시",10074,10072,4559,1477,2124,830,928,9,2,4,3,12,7,4,19,9978,94,2
"2321","재외투표","재외투표","대통령선거","충청남도","서산시",496,376,242,21,51,13,44,0,0,0,0,0,1,0,0,372,4,120
"2322","대산읍","관내사전투표","대통령선거","충청남도","서산시",2080,2080,959,331,425,137,208,2,0,1,1,7,0,0,4,2075,5,0
"2323","대산읍","대산읍제1투","대통령선거","충청남도","서산시",2351,1322,378,350,408,72,91,0,0,3,0,10,0,0,2,1314,8,1029
"2324","대산읍","대산읍제2투","대통령선거","충청남도","서산시",749,420,122,133,111,20,23,1,0,1,0,0,1,2,1,415,5,329
"2325","대산읍","대산읍제3투","대통령선거","충청남도","서산시",1048,681,286,128,162,40,60,0,0,0,0,0,0,0,3,679,2,367
"2326","대산읍","대산읍제4투","대통령선거","충청남도","서산시",1486,1083,478,148,256,69,122,1,0,1,0,1,0,1,0,1077,6,403
"2327","대산읍","대산읍제5투","대통령선거","충청남도","서산시",2320,1360,428,390,350,75,97,0,1,4,0,4,2,2,0,1353,7,960
"2328","대산읍","대산읍제6투","대통령선거","충청남도","서산시",1164,778,299,205,182,37,49,0,0,0,1,2,0,2,0,777,1,386
"2329","인지면","관내사전투표","대통령선거","충청남도","서산시",1183,1183,520,231,263,60,96,0,1,0,0,1,0,1,2,1175,8,0
"2330","인지면","인지면제1투","대통령선거","충청남도","서산시",3113,1974,622,547,551,105,126,3,0,4,0,1,1,2,3,1965,9,1139
"2331","인지면","인지면제2투","대통령선거","충청남도","서산시",870,530,130,207,139,19,30,1,0,0,0,0,0,1,2,529,1,340
"2332","인지면","인지면제3투","대통령선거","충청남도","서산시",861,535,110,234,139,21,21,3,0,1,0,0,0,3,0,532,3,326
"2333","부석면","관내사전투표","대통령선거","충청남도","서산시",503,503,180,147,120,19,34,0,0,0,0,1,0,1,1,503,0,0
"2334","부석면","부석면제1투","대통령선거","충청남도","서산시",1459,918,230,381,232,32,24,4,0,1,0,0,2,3,6,915,3,541
"2335","부석면","부석면제2투","대통령선거","충청남도","서산시",1255,756,234,250,195,27,36,3,0,0,0,3,0,2,0,750,6,499
"2336","부석면","부석면제3투","대통령선거","충청남도","서산시",738,463,127,166,128,12,20,0,1,0,1,1,0,1,3,460,3,275
"2337","부석면","부석면제4투","대통령선거","충청남도","서산시",917,539,160,191,135,17,25,0,0,0,1,2,1,0,2,534,5,378
"2338","팔봉면","관내사전투표","대통령선거","충청남도","서산시",427,427,134,117,126,20,23,1,1,1,0,1,1,0,0,425,2,0
"2339","팔봉면","팔봉면제1투","대통령선거","충청남도","서산시",1589,1037,272,396,276,36,40,2,0,0,0,0,4,2,0,1028,9,552
"2340","팔봉면","팔봉면제2투","대통령선거","충청남도","서산시",887,543,109,218,173,22,16,0,1,0,0,0,1,2,0,542,1,344
"2341","팔봉면","팔봉면제3투","대통령선거","충청남도","서산시",83,41,4,14,20,0,1,0,0,1,0,0,1,0,0,41,0,42
"2342","지곡면","관내사전투표","대통령선거","충청남도","서산시",966,966,415,225,187,52,74,0,0,0,0,4,1,4,2,964,2,0
"2343","지곡면","지곡면제1투","대통령선거","충청남도","서산시",2890,1728,452,630,457,69,93,0,1,3,1,2,4,2,2,1716,12,1162
"2344","지곡면","지곡면제2투","대통령선거","충청남도","서산시",2793,1841,839,287,476,80,140,0,0,3,1,4,1,0,0,1831,10,952
"2345","성연면","관내사전투표","대통령선거","충청남도","서산시",808,808,389,134,163,40,71,0,0,1,0,0,0,1,3,802,6,0
"2346","성연면","성연면제1투","대통령선거","충청남도","서산시",1379,856,228,286,266,28,34,0,1,1,0,1,1,2,1,849,7,523
"2347","성연면","성연면제2투","대통령선거","충청남도","서산시",1734,1238,574,205,270,80,99,0,0,1,2,2,1,0,3,1237,1,496
"2348","음암면","관내사전투표","대통령선거","충청남도","서산시",1050,1050,453,212,237,50,82,1,1,3,0,5,0,1,2,1047,3,0
"2349","음암면","음암면제1투","대통령선거","충청남도","서산시",2035,1215,344,409,335,48,58,4,1,0,2,1,2,2,2,1208,7,820
"2350","음암면","음암면제2투","대통령선거","충청남도","서산시",2515,1555,499,388,464,84,101,4,1,0,0,0,0,2,4,1547,8,960
"2351","음암면","음암면제3투","대통령선거","충청남도","서산시",1522,994,399,202,258,45,78,2,0,1,0,0,1,2,3,991,3,528
"2352","음암면","음암면제4투","대통령선거","충청남도","서산시",842,555,132,186,183,19,26,1,0,0,0,2,1,0,1,551,4,287
"2353","운산면","관내사전투표","대통령선거","충청남도","서산시",812,812,267,291,164,32,47,0,0,3,0,1,0,1,0,806,6,0
"2354","운산면","운산면제1투","대통령선거","충청남도","서산시",2255,1353,323,585,313,51,54,3,1,1,2,3,0,3,1,1340,13,902
"2355","운산면","운산면제2투","대통령선거","충청남도","서산시",754,515,90,248,145,12,14,0,0,0,0,1,0,1,2,513,2,239
"2356","운산면","운산면제3투","대통령선거","충청남도","서산시",856,546,139,216,145,20,20,0,0,0,0,1,0,1,0,542,4,310
"2357","해미면","관내사전투표","대통령선거","충청남도","서산시",1751,1751,621,457,430,116,112,0,1,4,0,1,0,0,3,1745,6,0
"2358","해미면","해미면제1투","대통령선거","충청남도","서산시",1861,1137,296,399,322,51,56,3,0,3,0,2,0,1,1,1134,3,724
"2359","해미면","해미면제2투","대통령선거","충청남도","서산시",1248,754,164,327,193,30,30,1,0,0,1,1,1,1,0,749,5,494
"2360","해미면","해미면제3투","대통령선거","충청남도","서산시",2225,1234,334,486,320,37,38,5,0,2,0,1,0,1,3,1227,7,991
"2361","고북면","관내사전투표","대통령선거","충청남도","서산시",676,676,250,153,184,42,32,3,0,1,0,1,0,1,1,668,8,0
"2362","고북면","고북면제1투","대통령선거","충청남도","서산시",1938,1140,261,437,329,41,51,3,0,0,2,2,0,3,4,1133,7,798
"2363","고북면","고북면제2투","대통령선거","충청남도","서산시",1528,1024,391,214,278,81,52,1,0,1,0,2,1,0,0,1021,3,504
"2364","고북면","고북면제3투","대통령선거","충청남도","서산시",1105,732,202,251,224,18,23,1,0,0,0,2,2,1,1,725,7,373
"2365","부춘동","관내사전투표","대통령선거","충청남도","서산시",2998,2998,1406,564,552,171,277,3,0,5,1,9,0,1,2,2991,7,0
"2366","부춘동","부춘동제1투","대통령선거","충청남도","서산시",872,501,138,200,109,28,21,0,0,2,0,0,0,0,0,498,3,371
"2367","부춘동","부춘동제2투","대통령선거","충청남도","서산시",2099,1341,472,400,299,64,96,1,0,3,1,0,1,0,2,1339,2,758
"2368","부춘동","부춘동제3투","대통령선거","충청남도","서산시",3188,2030,813,516,452,104,134,3,0,4,0,1,0,1,1,2029,1,1158
"2369","부춘동","부춘동제4투","대통령선거","충청남도","서산시",2248,1465,630,294,332,68,125,2,1,0,1,1,1,0,2,1457,8,783
"2370","부춘동","부춘동제5투","대통령선거","충청남도","서산시",2585,1515,534,462,349,69,96,0,1,0,0,0,0,1,1,1513,2,1070
"2371","동문1동","관내사전투표","대통령선거","충청남도","서산시",2430,2430,1134,487,426,150,214,1,0,4,0,2,1,0,2,2421,9,0
"2372","동문1동","동문1동제1투","대통령선거","충청남도","서산시",3554,2191,852,526,498,110,188,0,0,1,0,7,0,0,2,2184,7,1363
"2373","동문1동","동문1동제2투","대통령선거","충청남도","서산시",2059,1115,322,445,238,47,49,1,0,2,0,2,1,1,2,1110,5,944
"2374","동문1동","동문1동제3투","대통령선거","충청남도","서산시",3163,2218,926,461,494,156,171,1,0,1,0,0,0,1,4,2215,3,945
"2375","동문1동","동문1동제4투","대통령선거","충청남도","서산시",758,475,130,196,104,21,21,0,0,0,0,0,0,0,1,473,2,283
"2376","동문2동","관내사전투표","대통령선거","충청남도","서산시",1674,1674,707,387,318,104,150,0,0,0,0,0,0,3,0,1669,5,0
"2377","동문2동","동문2동제1투","대통령선거","충청남도","서산시",1231,651,185,244,159,27,33,2,0,0,0,0,0,0,0,650,1,580
"2378","동문2동","동문2동제2투","대통령선거","충청남도","서산시",1980,1184,312,502,237,63,59,0,0,0,0,2,1,1,1,1178,6,796
"2379","동문2동","동문2동제3투","대통령선거","충청남도","서산시",2984,1837,654,515,416,115,123,1,0,0,0,1,2,1,3,1831,6,1147
"2380","수석동","관내사전투표","대통령선거","충청남도","서산시",2421,2421,1106,459,476,165,192,3,1,0,2,3,1,1,2,2411,10,0
"2381","수석동","수석동제1투","대통령선거","충청남도","서산시",1556,979,367,249,234,44,75,1,1,1,0,0,0,0,2,974,5,577
"2382","수석동","수석동제2투","대통령선거","충청남도","서산시",3612,2200,782,630,509,118,146,0,0,3,0,1,1,0,0,2190,10,1412
"2383","수석동","수석동제3투","대통령선거","충청남도","서산시",1172,694,191,252,179,32,32,1,1,1,0,0,0,1,2,692,2,478
"2384","수석동","수석동제4투","대통령선거","충청남도","서산시",2599,1732,571,472,470,99,100,1,0,1,0,2,2,1,1,1720,12,867
"2385","석남동","관내사전투표","대통령선거","충청남도","서산시",3899,3899,1967,571,728,260,344,3,0,4,1,4,1,0,4,3887,12,0
"2386","석남동","석남동제1투","대통령선거","충청남도","서산시",3924,2472,915,573,601,152,209,1,0,4,1,2,1,0,3,2462,10,1452
"2387","석남동","석남동제2투","대통령선거","충청남도","서산시",2997,1974,821,375,476,132,161,3,0,0,0,0,1,1,2,1972,2,1023
"2388","석남동","석남동제3투","대통령선거","충청남도","서산시",1880,1486,769,155,309,112,132,0,1,0,1,1,0,0,1,1481,5,394
"2389","석남동","석남동제4투","대통령선거","충청남도","서산시",2862,1843,694,440,459,104,132,0,1,0,0,4,2,0,1,1837,6,1019
"2390","석남동","석남동제5투","대통령선거","충청남도","서산시",1303,732,184,245,216,39,36,1,0,0,0,3,2,3,0,729,3,571
"2391","석남동","석남동제6투","대통령선거","충청남도","서산시",3531,2285,999,367,583,136,181,2,0,3,2,4,1,0,2,2280,5,1246
"2392","잘못 투입·구분된 투표지","잘못 투입·구분된 투표지","대통령선거","충청남도","서산시",0,0,0,0,0,0,0,0,0,0,0,0,0,0,0,0,0,0
"2393","거소·선상투표","거소·선상투표","대통령선거","충청남도","태안군",180,171,58,32,48,12,5,1,0,1,1,0,1,0,3,162,9,9
"2394","관외사전투표","관외사전투표","대통령선거","충청남도","태안군",4699,4699,2019,848,969,360,429,3,2,6,1,4,4,3,8,4656,43,0
"2395","재외투표","재외투표","대통령선거","충청남도","태안군",221,165,105,8,30,6,16,0,0,0,0,0,0,0,0,165,0,56
"2396","태안읍","관내사전투표","대통령선거","충청남도","태안군",4537,4538,1933,1177,817,220,346,5,1,1,0,8,1,2,4,4515,23,-1
"2397","태안읍","태안읍제1투","대통령선거","충청남도","태안군",1656,922,254,393,193,26,51,0,0,0,0,0,0,0,2,919,3,734
"2398","태안읍","태안읍제2투","대통령선거","충청남도","태안군",1241,752,220,266,208,18,26,3,0,0,0,1,2,0,0,744,8,489
"2399","태안읍","태안읍제3투","대통령선거","충청남도","태안군",1571,978,280,369,247,32,36,1,0,1,0,3,0,3,0,972,6,593
"2400","태안읍","태안읍제4투","대통령선거","충청남도","태안군",723,487,130,195,121,10,18,1,0,0,0,0,2,3,1,481,6,236
"2401","태안읍","태안읍제5투","대통령선거","충청남도","태안군",2273,1374,436,470,306,57,90,0,0,0,1,1,3,1,1,1366,8,899
"2402","태안읍","태안읍제6투","대통령선거","충청남도","태안군",3439,2012,722,628,432,98,115,1,0,1,0,1,1,1,2,2002,10,1427
"2403","태안읍","태안읍제7투","대통령선거","충청남도","태안군",2108,1175,353,442,274,53,42,1,0,0,1,4,0,0,2,1172,3,933
"2404","태안읍","태안읍제8투","대통령선거","충청남도","태안군",4277,2722,1104,746,540,123,184,3,0,2,0,2,0,2,2,2708,14,1555
"2405","안면읍","관내사전투표","대통령선거","충청남도","태안군",1084,1084,366,339,258,50,58,0,0,1,1,2,2,0,0,1077,7,0
"2406","안면읍","안면읍제1투","대통령선거","충청남도","태안군",2675,1453,402,535,360,57,81,3,0,0,0,2,1,2,0,1443,10,1222
"2407","안면읍","안면읍제2투","대통령선거","충청남도","태안군",1274,703,170,297,188,19,20,0,0,1,0,0,1,1,1,698,5,571
"2408","안면읍","안면읍제3투","대통령선거","충청남도","태안군",1844,1037,259,407,305,26,28,1,0,2,0,0,1,1,0,1030,7,807
"2409","안면읍","안면읍제4투","대통령선거","충청남도","태안군",622,374,122,120,101,8,18,0,0,0,1,0,1,0,1,372,2,248
"2410","고남면","관내사전투표","대통령선거","충청남도","태안군",309,309,95,110,72,12,15,0,0,0,0,0,1,0,0,305,4,0
"2411","고남면","고남면투표소","대통령선거","충청남도","태안군",1819,1020,284,386,270,30,43,0,0,0,0,0,0,0,1,1014,6,799
"2412","남면","관내사전투표","대통령선거","충청남도","태안군",423,423,178,127,72,23,20,1,0,0,0,1,1,0,0,423,0,0
"2413","남면","남면제1투","대통령선거","충청남도","태안군",1186,783,273,279,184,20,16,0,0,0,0,0,0,4,0,776,7,403
"2414","남면","남면제2투","대통령선거","충청남도","태안군",820,501,166,171,128,13,12,0,0,2,1,0,1,1,3,498,3,319
"2415","남면","남면제3투","대통령선거","충청남도","태안군",1289,716,199,248,202,22,39,1,0,0,0,1,0,1,0,713,3,573
"2416","근흥면","관내사전투표","대통령선거","충청남도","태안군",764,764,229,291,174,29,33,0,0,0,0,1,0,2,1,760,4,0
"2417","근흥면","근흥면제1투","대통령선거","충청남도","태안군",1405,776,178,315,218,30,23,0,0,0,1,1,3,1,2,772,4,629
"2418","근흥면","근흥면제2투","대통령선거","충청남도","태안군",890,552,148,227,129,18,20,0,0,3,0,0,1,1,0,547,5,338
"2419","근흥면","근흥면제3투","대통령선거","충청남도","태안군",1597,980,247,461,217,21,26,0,0,0,0,1,0,3,0,976,4,617
"2420","근흥면","근흥면제4투","대통령선거","충청남도","태안군",62,52,3,33,10,1,1,0,0,0,0,0,0,0,2,50,2,10
"2421","소원면","관내사전투표","대통령선거","충청남도","태안군",1023,1023,278,368,287,26,37,2,0,2,2,0,2,4,0,1008,15,0
"2422","소원면","소원면제1투","대통령선거","충청남도","태안군",2008,1129,302,405,331,30,42,4,0,2,0,1,2,1,2,1122,7,879
"2423","소원면","소원면제2투","대통령선거","충청남도","태안군",1672,1054,285,447,239,33,33,0,0,1,1,1,1,0,2,1043,11,618
"2424","원북면","관내사전투표","대통령선거","충청남도","태안군",551,551,226,149,103,28,38,2,0,2,0,1,0,0,0,549,2,0
"2425","원북면","원북면제1투","대통령선거","충청남도","태안군",1406,922,241,374,211,31,47,1,0,0,0,1,1,3,1,911,11,484
"2426","원북면","원북면제2투","대통령선거","충청남도","태안군",920,599,131,253,157,22,20,3,1,0,1,1,1,3,2,595,4,321
"2427","원북면","원북면제3투","대통령선거","충청남도","태안군",864,568,128,266,126,17,21,1,0,0,0,3,1,1,1,565,3,296
"2428","이원면","관내사전투표","대통령선거","충청남도","태안군",341,341,93,116,99,15,12,0,1,0,0,0,1,1,2,340,1,0
"2429","이원면","이원면제1투","대통령선거","충청남도","태안군",876,560,148,210,155,16,16,1,0,3,0,0,2,1,2,554,6,316
"2430","이원면","이원면제2투","대통령선거","충청남도","태안군",730,471,116,158,159,14,16,0,0,0,0,1,1,1,0,466,5,259
"2431","잘못 투입·구분된 투표지","잘못 투입·구분된 투표지","대통령선거","충청남도","태안군",0,0,0,0,0,0,0,0,0,0,0,0,0,0,0,0,0,0
"2432","거소·선상투표","거소·선상투표","대통령선거","충청남도","금산군",133,122,31,37,39,2,2,2,0,1,0,0,0,1,0,115,7,11
"2433","관외사전투표","관외사전투표","대통령선거","충청남도","금산군",3932,3931,1791,667,792,282,345,5,1,2,2,5,6,0,10,3908,23,1
"2434","재외투표","재외투표","대통령선거","충청남도","금산군",186,130,63,22,22,2,17,1,0,0,1,0,0,0,1,129,1,56
"2435","금산읍","관내사전투표","대통령선거","충청남도","금산군",3833,3833,1684,803,844,164,289,5,0,5,1,7,2,6,5,3815,18,0
"2436","금산읍","금산읍제1투","대통령선거","충청남도","금산군",2135,1198,337,429,338,39,45,0,1,1,0,0,2,0,1,1193,5,937
"2437","금산읍","금산읍제2투","대통령선거","충청남도","금산군",1463,947,291,302,291,16,38,0,0,1,0,2,1,1,0,943,4,516
"2438","금산읍","금산읍제3투","대통령선거","충청남도","금산군",2650,1577,614,395,379,79,90,1,0,0,0,4,2,1,4,1569,8,1073
"2439","금산읍","금산읍제4투","대통령선거","충청남도","금산군",1245,790,199,282,227,31,27,1,0,3,0,4,2,2,3,781,9,455
"2440","금산읍","금산읍제5투","대통령선거","충청남도","금산군",709,427,149,110,143,8,8,0,0,0,0,0,1,0,1,420,7,282
"2441","금산읍","금산읍제6투","대통령선거","충청남도","금산군",1354,815,236,270,237,19,45,0,0,0,0,2,0,0,0,809,6,539
"2442","금산읍","금산읍제7투","대통령선거","충청남도","금산군",3153,1956,776,409,528,101,127,2,0,1,0,1,1,1,1,1948,8,1197
"2443","금산읍","금산읍제8투","대통령선거","충청남도","금산군",1721,1125,288,432,301,46,47,0,0,0,1,1,0,1,1,1118,7,596
"2444","금성면","관내사전투표","대통령선거","충청남도","금산군",409,409,149,88,104,19,29,0,1,2,1,2,0,0,1,396,13,0
"2445","금성면","금성면제1투","대통령선거","충청남도","금산군",1575,928,268,293,281,31,36,0,0,0,0,2,3,1,5,920,8,647
"2446","금성면","금성면제2투","대통령선거","충청남도","금산군",887,522,125,191,156,18,13,2,0,1,1,0,1,0,4,512,10,365
"2447","제원면","관내사전투표","대통령선거","충청남도","금산군",507,507,166,150,139,23,16,2,0,3,1,0,0,1,4,505,2,0
"2448","제원면","제원면제1투","대통령선거","충청남도","금산군",1462,825,210,332,215,27,28,1,2,0,0,2,1,1,2,821,4,637
"2449","제원면","제원면제2투","대통령선거","충청남도","금산군",553,329,93,116,97,4,8,2,0,2,0,0,2,2,1,327,2,224
"2450","부리면","관내사전투표","대통령선거","충청남도","금산군",219,219,67,73,52,8,16,0,1,0,1,0,0,0,0,218,1,0
"2451","부리면","부리면제1투","대통령선거","충청남도","금산군",1289,786,196,276,234,20,34,3,0,1,1,0,3,3,6,777,9,503
"2452","부리면","부리면제2투","대통령선거","충청남도","금산군",725,472,151,149,132,9,19,0,0,0,0,1,0,2,3,466,6,253
"2453","군북면","관내사전투표","대통령선거","충청남도","금산군",168,168,73,35,44,6,6,0,2,1,0,0,0,0,0,167,1,0
"2454","군북면","군북면제1투","대통령선거","충청남도","금산군",610,382,104,135,111,12,9,2,0,0,0,2,1,1,2,379,3,228
"2455","군북면","군북면제2투","대통령선거","충청남도","금산군",901,583,158,205,164,24,20,0,0,1,0,0,1,1,3,577,6,318
"2456","군북면","군북면제3투","대통령선거","충청남도","금산군",398,268,83,88,78,5,11,0,0,0,0,0,1,1,0,267,1,130
"2457","남일면","관내사전투표","대통령선거","충청남도","금산군",347,347,123,98,100,6,10,0,0,2,0,1,0,1,3,344,3,0
"2458","남일면","남일면제1투","대통령선거","충청남도","금산군",1303,825,203,263,286,19,36,0,0,0,0,2,2,3,2,816,9,478
"2459","남일면","남일면제2투","대통령선거","충청남도","금산군",518,316,69,112,104,12,14,0,0,0,1,0,1,0,1,314,2,202
"2460","남이면","관내사전투표","대통령선거","충청남도","금산군",187,187,64,53,55,4,7,0,0,1,0,0,2,0,0,186,1,0
"2461","남이면","남이면제1투","대통령선거","충청남도","금산군",949,570,149,186,185,14,19,2,1,0,0,0,2,2,2,562,8,379
"2462","남이면","남이면제2투","대통령선거","충청남도","금산군",556,357,105,121,95,8,22,0,0,0,1,1,0,1,1,355,2,199
"2463","진산면","관내사전투표","대통령선거","충청남도","금산군",400,400,141,121,99,17,15,0,1,0,0,0,2,0,3,399,1,0
"2464","진산면","진산면제1투","대통령선거","충청남도","금산군",1498,918,271,308,256,34,22,1,2,2,1,2,2,3,0,904,14,580
"2465","진산면","진산면제2투","대통령선거","충청남도","금산군",758,504,146,163,162,10,10,0,1,2,0,1,1,1,5,502,2,254
"2466","복수면","관내사전투표","대통령선거","충청남도","금산군",345,345,130,98,90,16,8,1,0,1,0,0,0,0,0,344,1,0
"2467","복수면","복수면제1투","대통령선거","충청남도","금산군",1196,746,192,278,211,30,21,3,1,2,0,1,0,0,3,742,4,450
"2468","복수면","복수면제2투","대통령선거","충청남도","금산군",1192,774,214,276,219,15,36,1,0,1,0,2,1,2,1,768,6,418
"2469","추부면","관내사전투표","대통령선거","충청남도","금산군",783,783,319,180,194,37,41,0,1,0,0,2,1,0,1,776,7,0
"2470","추부면","추부면제1투","대통령선거","충청남도","금산군",1900,1068,329,335,312,39,43,0,0,0,1,1,1,1,1,1063,5,832
"2471","추부면","추부면제2투","대통령선거","충청남도","금산군",1294,819,238,278,226,25,24,0,2,1,1,1,3,4,5,808,11,475
"2472","추부면","추부면제3투","대통령선거","충청남도","금산군",1194,760,187,257,245,31,26,2,2,0,0,0,2,1,1,754,6,434
"2473","잘못 투입·구분된 투표지","잘못 투입·구분된 투표지","대통령선거","충청남도","금산군",0,0,0,0,0,0,0,0,0,0,0,0,0,0,0,0,0,0
"2474","거소·선상투표","거소·선상투표","대통령선거","충청남도","논산시",384,351,137,51,99,18,11,6,2,2,1,1,1,2,3,334,17,33
"2475","관외사전투표","관외사전투표","대통령선거","충청남도","논산시",8150,8150,3771,1213,1688,627,725,12,3,5,6,6,4,4,23,8087,63,0
"2476","재외투표","재외투표","대통령선거","충청남도","논산시",398,260,166,14,39,11,27,1,0,0,0,0,0,0,0,258,2,138
"2477","강경읍","관내사전투표","대통령선거","충청남도","논산시",1132,1132,599,179,230,47,62,0,0,3,0,1,0,2,3,1126,6,0
"2478","강경읍","강경읍제1투","대통령선거","충청남도","논산시",1254,678,262,148,210,26,18,2,0,2,0,1,1,2,0,672,6,576
"2479","강경읍","강경읍제2투","대통령선거","충청남도","논산시",756,513,205,120,144,15,20,1,0,2,0,1,0,0,1,509,4,243
"2480","강경읍","강경읍제3투","대통령선거","충청남도","논산시",2656,1663,674,319,527,60,70,0,0,5,0,1,0,0,0,1656,7,993
"2481","강경읍","강경읍제4투","대통령선거","충청남도","논산시",1901,1052,428,222,317,35,30,2,2,0,1,0,1,0,3,1041,11,849
"2482","연무읍","관내사전투표","대통령선거","충청남도","논산시",2206,2206,947,415,535,153,123,5,0,4,1,6,3,0,4,2196,10,0
"2483","연무읍","연무읍제1투","대통령선거","충청남도","논산시",3088,1717,625,416,470,89,87,1,2,3,0,3,1,1,7,1705,12,1371
"2484","연무읍","연무읍제2투","대통령선거","충청남도","논산시",2756,1566,566,382,472,71,59,2,1,0,1,5,1,0,1,1561,5,1190
"2485","연무읍","연무읍제3투","대통령선거","충청남도","논산시",1748,957,342,234,298,52,23,1,0,1,1,1,0,2,0,955,2,791
"2486","연무읍","연무읍제4투","대통령선거","충청남도","논산시",1690,1072,410,259,327,24,18,0,1,2,0,21,0,1,2,1065,7,618
"2487","성동면","관내사전투표","대통령선거","충청남도","논산시",505,505,182,101,166,22,20,1,0,3,0,0,1,0,0,496,9,0
"2488","성동면","성동면제1투","대통령선거","충청남도","논산시",893,494,154,127,167,19,24,0,0,0,0,0,0,1,0,492,2,399
"2489","성동면","성동면제2투","대통령선거","충청남도","논산시",1130,693,247,178,206,27,29,2,0,0,0,0,0,0,3,692,1,437
"2490","성동면","성동면제3투","대통령선거","충청남도","논산시",1383,900,251,312,264,26,35,2,0,2,0,2,2,1,1,898,2,483
"2491","광석면","관내사전투표","대통령선거","충청남도","논산시",451,451,179,128,97,18,25,0,1,0,0,0,1,1,1,451,0,0
"2492","광석면","광석면제1투","대통령선거","충청남도","논산시",1451,916,270,314,254,29,36,0,0,1,1,0,0,1,1,907,9,535
"2493","광석면","광석면제2투","대통령선거","충청남도","논산시",798,507,162,124,181,16,18,0,0,0,0,0,1,1,1,504,3,291
"2494","광석면","광석면제3투","대통령선거","충청남도","논산시",1215,764,230,248,215,21,41,0,0,0,1,1,0,1,4,762,2,451
"2495","노성면","관내사전투표","대통령선거","충청남도","논산시",386,386,148,98,82,22,32,0,0,2,0,0,0,0,0,384,2,0
"2496","노성면","노성면제1투","대통령선거","충청남도","논산시",1434,922,267,322,241,36,37,1,0,2,1,2,1,1,4,915,7,512
"2497","노성면","노성면제2투","대통령선거","충청남도","논산시",966,599,185,175,181,19,27,3,0,2,0,1,1,1,2,597,2,367
"2498","상월면","관내사전투표","대통령선거","충청남도","논산시",514,514,216,120,119,12,26,1,1,1,0,2,3,4,0,505,9,0
"2499","상월면","상월면제1투","대통령선거","충청남도","논산시",1389,812,281,252,209,28,32,0,0,1,0,6,1,0,2,812,0,577
"2500","상월면","상월면제2투","대통령선거","충청남도","논산시",1329,769,284,221,193,21,40,0,0,0,0,0,1,4,2,766,3,560
"2501","부적면","관내사전투표","대통령선거","충청남도","논산시",593,593,236,113,163,26,40,2,0,0,1,1,0,2,1,585,8,0
"2502","부적면","부적면제1투","대통령선거","충청남도","논산시",1302,796,261,202,248,41,33,2,0,0,0,4,0,2,1,794,2,506
"2503","부적면","부적면제2투","대통령선거","충청남도","논산시",796,525,147,178,164,11,17,1,0,0,1,0,1,2,1,523,2,271
"2504","부적면","부적면제3투","대통령선거","충청남도","논산시",677,428,128,145,121,11,17,0,0,0,0,2,0,3,0,427,1,249
"2505","연산면","관내사전투표","대통령선거","충청남도","논산시",868,868,331,240,200,30,44,3,1,1,2,0,5,2,0,859,9,0
"2506","연산면","연산면제1투","대통령선거","충청남도","논산시",1889,1171,342,387,327,55,47,0,1,1,1,1,2,1,0,1165,6,718
"2507","연산면","연산면제2투","대통령선거","충청남도","논산시",1538,871,242,278,253,37,47,3,1,1,1,2,1,2,0,868,3,667
"2508","연산면","연산면제3투","대통령선거","충청남도","논산시",1151,739,202,274,193,24,33,2,0,2,1,2,0,1,1,735,4,412
"2509","벌곡면","관내사전투표","대통령선거","충청남도","논산시",337,337,119,110,82,10,14,1,0,0,0,0,0,0,0,336,1,0
"2510","벌곡면","벌곡면제1투","대통령선거","충청남도","논산시",1034,670,170,259,195,21,20,0,0,0,0,1,0,1,0,667,3,364
"2511","벌곡면","벌곡면제2투","대통령선거","충청남도","논산시",754,503,133,172,156,25,9,0,0,1,0,0,0,0,3,499,4,251
"2512","양촌면","관내사전투표","대통령선거","충청남도","논산시",750,750,245,214,209,30,37,0,0,3,1,1,1,1,1,743,7,0
"2513","양촌면","양촌면제1투","대통령선거","충청남도","논산시",1326,758,246,222,231,30,17,0,0,1,0,0,0,3,1,751,7,568
"2514","양촌면","양촌면제2투","대통령선거","충청남도","논산시",1119,645,209,169,219,19,15,0,0,3,0,2,0,0,1,637,8,474
"2515","양촌면","양촌면제3투","대통령선거","충청남도","논산시",1364,763,243,205,255,17,27,1,0,0,1,3,1,3,2,758,5,601
"2516","가야곡면","관내사전투표","대통령선거","충청남도","논산시",555,555,219,128,161,15,27,0,0,0,0,1,0,0,1,552,3,0
"2517","가야곡면","가야곡면제1투","대통령선거","충청남도","논산시",1040,581,191,187,168,12,16,0,0,1,0,0,1,0,3,579,2,459
"2518","가야곡면","가야곡면제2투","대통령선거","충청남도","논산시",705,439,120,179,106,9,14,0,1,4,0,3,0,0,2,438,1,266
"2519","가야곡면","가야곡면제3투","대통령선거","충청남도","논산시",953,569,155,194,170,17,20,2,0,0,1,0,4,0,1,564,5,384
"2520","은진면","관내사전투표","대통령선거","충청남도","논산시",539,539,202,139,126,33,29,0,0,3,0,0,0,1,2,535,4,0
"2521","은진면","은진면제1투","대통령선거","충청남도","논산시",1298,754,207,212,261,39,26,1,0,2,0,0,0,1,2,751,3,544
"2522","은진면","은진면제2투","대통령선거","충청남도","논산시",769,493,151,171,139,11,13,2,0,0,1,0,1,0,0,489,4,276
"2523","은진면","은진면제3투","대통령선거","충청남도","논산시",964,553,189,138,151,31,39,0,0,2,0,0,1,0,1,552,1,411
"2524","채운면","관내사전투표","대통령선거","충청남도","논산시",396,396,194,81,88,10,14,0,0,0,1,1,2,0,1,392,4,0
"2525","채운면","채운면제1투","대통령선거","충청남도","논산시",1034,637,236,175,171,19,26,1,0,1,0,0,2,1,3,635,2,397
"2526","채운면","채운면제2투","대통령선거","충청남도","논산시",778,491,181,117,147,24,15,0,0,0,0,0,2,1,1,488,3,287
"2527","취암동","관내사전투표","대통령선거","충청남도","논산시",4513,4513,2312,658,872,285,356,2,0,1,1,5,2,1,3,4498,15,0
"2528","취암동","취암동제1투","대통령선거","충청남도","논산시",2415,1369,464,424,365,53,56,1,0,0,0,0,1,0,0,1364,5,1046
"2529","취암동","취암동제2투","대통령선거","충청남도","논산시",3347,1890,773,375,492,101,136,0,0,1,1,2,0,1,4,1886,4,1457
"2530","취암동","취암동제3투","대통령선거","충청남도","논산시",3780,2206,854,490,605,114,124,1,0,6,0,2,0,0,2,2198,8,1574
"2531","취암동","취암동제4투","대통령선거","충청남도","논산시",1417,882,240,321,229,41,43,2,1,1,0,0,1,0,0,879,3,535
"2532","취암동","취암동제5투","대통령선거","충청남도","논산시",1685,1032,379,275,277,48,45,0,1,0,1,1,0,1,1,1029,3,653
"2533","취암동","취암동제6투","대통령선거","충청남도","논산시",1837,1267,521,263,311,87,81,1,0,0,1,1,0,0,0,1266,1,570
"2534","취암동","취암동제7투","대통령선거","충청남도","논산시",2758,1851,819,333,483,84,115,0,1,1,0,4,1,0,1,1842,9,907
"2535","취암동","취암동제8투","대통령선거","충청남도","논산시",2464,1666,790,267,380,104,115,0,0,0,0,4,0,0,2,1662,4,798
"2536","부창동","관내사전투표","대통령선거","충청남도","논산시",2036,2036,967,360,437,110,139,5,0,3,0,3,0,0,2,2026,10,0
"2537","부창동","부창동제1투","대통령선거","충청남도","논산시",2353,1487,623,321,359,77,94,3,0,2,0,4,0,0,1,1484,3,866
"2538","부창동","부창동제2투","대통령선거","충청남도","논산시",1794,1094,354,353,296,39,39,0,1,0,0,1,1,0,2,1086,8,700
"2539","부창동","부창동제3투","대통령선거","충청남도","논산시",3605,2267,876,538,623,111,96,2,0,1,1,1,0,1,4,2254,13,1338
"2540","부창동","부창동제4투","대통령선거","충청남도","논산시",3061,1901,806,389,480,98,107,1,0,2,0,4,3,1,4,1895,6,1160
"2541","잘못 투입·구분된 투표지","잘못 투입·구분된 투표지","대통령선거","충청남도","논산시",0,0,0,0,0,0,0,0,0,0,0,0,0,0,0,0,0,0
"2542","거소·선상투표","거소·선상투표","대통령선거","충청남도","계룡시",129,121,40,15,38,18,5,0,0,0,0,1,0,1,0,118,3,8
"2543","관외사전투표","관외사전투표","대통령선거","충청남도","계룡시",4034,4034,1572,734,996,390,293,4,3,1,2,4,0,0,7,4006,28,0
"2544","재외투표","재외투표","대통령선거","충청남도","계룡시",237,183,93,17,42,14,16,1,0,0,0,0,0,0,0,183,0,54
"2545","두마면","관내사전투표","대통령선거","충청남도","계룡시",1189,1189,531,245,265,73,69,1,0,0,1,1,0,0,0,1186,3,0
"2546","두마면","두마면제1투","대통령선거","충청남도","계룡시",1824,1260,444,358,322,78,49,2,0,1,0,0,0,0,1,1255,5,564
"2547","두마면","두마면제2투","대통령선거","충청남도","계룡시",1690,1275,446,349,316,88,63,5,0,0,0,0,1,1,4,1273,2,415
"2548","엄사면","관내사전투표","대통령선거","충청남도","계룡시",2834,2834,1148,653,642,184,171,6,0,3,0,4,1,1,4,2817,17,0
"2549","엄사면","엄사면제1투","대통령선거","충청남도","계룡시",3084,2104,754,543,561,128,93,4,1,1,1,6,2,1,1,2096,8,980
"2550","엄사면","엄사면제2투","대통령선거","충청남도","계룡시",2024,1331,440,357,360,82,78,0,1,1,2,4,0,1,1,1327,4,693
"2551","엄사면","엄사면제3투","대통령선거","충청남도","계룡시",1798,1264,429,303,324,107,88,3,0,2,0,3,0,0,2,1261,3,534
"2552","엄사면","엄사면제4투","대통령선거","충청남도","계룡시",2370,1549,568,379,414,83,92,0,0,1,0,1,1,0,2,1541,8,821
"2553","엄사면","엄사면제5투","대통령선거","충청남도","계룡시",670,431,127,143,126,11,18,1,0,1,0,1,0,0,0,428,3,239
"2554","신도안면","관내사전투표","대통령선거","충청남도","계룡시",1883,1883,578,421,485,283,100,2,1,3,0,3,0,0,3,1879,4,0
"2555","신도안면","신도안면제1투","대통령선거","충청남도","계룡시",1241,910,227,212,295,138,34,0,0,0,0,0,0,1,0,907,3,331
"2556","신도안면","신도안면제2투","대통령선거","충청남도","계룡시",1779,1422,381,290,430,237,78,0,0,1,0,0,1,1,1,1420,2,357
"2557","금암동","관내사전투표","대통령선거","충청남도","계룡시",1829,1829,751,450,376,135,100,0,0,2,0,6,0,3,0,1823,6,0
"2558","금암동","금암동제1투","대통령선거","충청남도","계룡시",2380,1731,666,426,429,107,91,1,0,1,0,0,0,1,3,1725,6,649
"2559","금암동","금암동제2투","대통령선거","충청남도","계룡시",1658,1180,371,366,301,66,64,4,0,2,0,1,0,2,0,1177,3,478
"2560","잘못 투입·구분된 투표지","잘못 투입·구분된 투표지","대통령선거","충청남도","계룡시",0,0,0,0,0,0,0,0,0,0,0,0,0,0,0,0,0,0
"2561","거소·선상투표","거소·선상투표","대통령선거","충청남도","당진시",307,272,72,68,84,18,9,3,3,0,4,0,1,1,1,264,8,35
"2562","관외사전투표","관외사전투표","대통령선거","충청남도","당진시",10515,10515,4649,1792,2148,764,1010,15,3,13,0,15,4,3,23,10439,76,0
"2563","재외투표","재외투표","대통령선거","충청남도","당진시",433,317,204,14,41,10,44,2,0,0,0,0,0,0,0,315,2,116
"2564","당진1동","관내사전투표","대통령선거","충청남도","당진시",4117,4117,1916,867,712,228,351,3,1,5,0,13,1,1,2,4100,17,0
"2565","당진1동","당진1동제1투","대통령선거","충청남도","당진시",2503,1479,631,271,310,102,155,0,0,0,0,3,1,1,3,1477,2,1024
"2566","당진1동","당진1동제2투","대통령선거","충청남도","당진시",4178,2440,877,670,543,151,166,2,0,9,0,1,1,3,2,2425,15,1738
"2567","당진1동","당진1동제3투","대통령선거","충청남도","당진시",3285,2013,744,524,428,105,186,4,0,3,1,7,1,0,1,2004,9,1272
"2568","당진1동","당진1동제4투","대통령선거","충청남도","당진시",3640,2314,1032,393,496,139,237,3,0,1,1,3,0,0,2,2307,7,1326
"2569","합덕읍","관내사전투표","대통령선거","충청남도","당진시",1482,1482,529,407,334,74,125,0,0,2,1,0,1,2,0,1475,7,0
"2570","합덕읍","합덕읍제1투","대통령선거","충청남도","당진시",1082,640,167,271,161,18,21,0,0,0,0,0,0,0,0,638,2,442
"2571","합덕읍","합덕읍제2투","대통령선거","충청남도","당진시",1457,843,192,367,208,33,38,1,0,0,0,0,1,0,2,842,1,614
"2572","합덕읍","합덕읍제3투","대통령선거","충청남도","당진시",2182,1172,343,433,268,51,64,0,0,1,1,1,0,1,2,1165,7,1010
"2573","합덕읍","합덕읍제4투","대통령선거","충청남도","당진시",925,558,145,235,134,16,19,0,1,2,0,1,0,0,1,554,4,367
"2574","합덕읍","합덕읍제5투","대통령선거","충청남도","당진시",1280,791,259,267,198,35,28,0,0,0,0,2,0,0,2,791,0,489
"2575","송악읍","관내사전투표","대통령선거","충청남도","당진시",3246,3246,1605,565,590,163,297,2,1,3,1,7,0,2,3,3239,7,0
"2576","송악읍","송악읍제1투","대통령선거","충청남도","당진시",3738,2316,961,501,484,148,192,0,0,5,0,12,1,2,2,2308,8,1422
"2577","송악읍","송악읍제2투","대통령선거","충청남도","당진시",856,494,109,204,137,18,21,1,0,0,0,0,1,0,0,491,3,362
"2578","송악읍","송악읍제3투","대통령선거","충청남도","당진시",3101,1880,700,507,451,60,140,4,0,3,0,4,0,1,4,1874,6,1221
"2579","송악읍","송악읍제4투","대통령선거","충청남도","당진시",2390,1217,342,458,292,40,73,0,0,1,1,0,2,2,0,1211,6,1173
"2580","송악읍","송악읍제5투","대통령선거","충청남도","당진시",2583,1619,699,309,352,100,142,0,0,3,0,6,2,1,0,1614,5,964
"2581","송악읍","송악읍제6투","대통령선거","충청남도","당진시",3831,2244,933,382,564,127,204,4,1,4,2,8,0,0,2,2231,13,1587
"2582","고대면","관내사전투표","대통령선거","충청남도","당진시",886,886,403,203,147,50,72,0,0,0,0,3,1,0,2,881,5,0
"2583","고대면","고대면제1투","대통령선거","충청남도","당진시",1616,999,284,358,258,27,56,0,0,5,1,3,1,2,2,997,2,617
"2584","고대면","고대면제2투","대통령선거","충청남도","당진시",1507,867,224,352,219,26,30,1,1,2,1,2,0,3,1,862,5,640
"2585","고대면","고대면제3투","대통령선거","충청남도","당진시",1007,608,201,231,134,13,26,0,0,1,0,0,0,0,0,606,2,399
"2586","석문면","관내사전투표","대통령선거","충청남도","당진시",833,834,393,176,162,33,61,0,0,0,0,8,0,0,0,833,1,-1
"2587","석문면","석문면제1투","대통령선거","충청남도","당진시",2428,1400,501,370,342,67,103,0,0,4,0,4,0,1,3,1395,5,1028
"2588","석문면","석문면제2투","대통령선거","충청남도","당진시",3071,1810,493,644,476,75,91,2,1,2,2,3,0,0,3,1792,18,1261
"2589","석문면","석문면제3투","대통령선거","충청남도","당진시",147,100,12,59,22,1,4,0,0,0,0,0,0,0,0,98,2,47
"2590","석문면","석문면제4투","대통령선거","충청남도","당진시",588,392,114,130,107,10,24,1,0,0,0,1,0,1,1,389,3,196
"2591","대호지면","관내사전투표","대통령선거","충청남도","당진시",291,291,108,90,60,14,10,0,1,0,1,1,1,1,2,289,2,0
"2592","대호지면","대호지면제1투","대통령선거","충청남도","당진시",1155,686,170,312,146,18,28,0,0,1,0,1,0,5,3,684,2,469
"2593","대호지면","대호지면제2투","대통령선거","충청남도","당진시",742,459,101,187,113,21,29,3,0,0,0,0,0,1,1,456,3,283
"2594","정미면","관내사전투표","대통령선거","충청남도","당진시",370,370,118,115,93,13,25,0,0,1,0,3,1,1,0,370,0,0
"2595","정미면","정미면제1투","대통령선거","충청남도","당진시",1734,1021,258,404,263,40,41,0,1,1,1,2,3,2,3,1019,2,713
"2596","정미면","정미면제2투","대통령선거","충청남도","당진시",928,600,142,221,178,15,27,0,0,3,0,2,2,2,2,594,6,328
"2597","면천면","관내사전투표","대통령선거","충청남도","당진시",616,616,205,189,148,33,37,0,0,0,0,0,0,1,0,613,3,0
"2598","면천면","면천면제1투","대통령선거","충청남도","당진시",1709,981,257,387,241,40,36,2,0,4,0,2,0,3,2,974,7,728
"2599","면천면","면천면제2투","대통령선거","충청남도","당진시",850,511,130,200,127,12,32,0,0,0,1,0,1,1,3,507,4,339
"2600","순성면","관내사전투표","대통령선거","충청남도","당진시",706,706,249,176,185,25,62,0,0,1,1,1,1,2,1,704,2,0
"2601","순성면","순성면제1투","대통령선거","충청남도","당진시",1992,1207,344,409,312,42,79,2,2,0,1,1,2,1,3,1198,9,785
"2602","순성면","순성면제2투","대통령선거","충청남도","당진시",811,487,108,190,145,24,16,0,0,1,0,0,0,0,1,485,2,324
"2603","순성면","순성면제3투","대통령선거","충청남도","당진시",942,544,152,198,136,18,31,0,1,1,0,0,0,1,3,541,3,398
"2604","우강면","관내사전투표","대통령선거","충청남도","당진시",614,614,227,183,141,27,31,2,1,0,0,1,0,0,0,613,1,0
"2605","우강면","우강면제1투","대통령선거","충청남도","당진시",2094,1245,379,441,282,44,80,1,1,3,0,0,0,1,2,1234,11,849
"2606","우강면","우강면제2투","대통령선거","충청남도","당진시",1074,670,165,265,171,20,43,0,0,1,0,0,2,0,0,667,3,404
"2607","우강면","우강면제3투","대통령선거","충청남도","당진시",710,428,147,145,107,12,16,0,0,0,0,0,0,0,0,427,1,282
"2608","신평면","관내사전투표","대통령선거","충청남도","당진시",1984,1984,894,406,372,115,182,1,0,2,2,2,1,1,2,1980,4,0
"2609","신평면","신평면제1투","대통령선거","충청남도","당진시",2508,1559,502,534,337,69,95,2,0,1,0,3,1,2,2,1548,11,949
"2610","신평면","신평면제2투","대통령선거","충청남도","당진시",4901,2935,1170,605,690,165,261,5,0,5,0,13,2,3,2,2921,14,1966
"2611","신평면","신평면제3투","대통령선거","충청남도","당진시",1059,678,158,304,149,24,31,0,0,1,1,5,0,1,2,676,2,381
"2612","신평면","신평면제4투","대통령선거","충청남도","당진시",1967,1125,347,430,258,27,44,7,0,2,0,0,2,0,2,1119,6,842
"2613","송산면","관내사전투표","대통령선거","충청남도","당진시",1697,1697,832,250,299,83,219,1,0,0,1,6,0,3,0,1694,3,0
"2614","송산면","송산면제1투","대통령선거","충청남도","당진시",1981,1232,451,336,272,56,98,1,1,2,0,8,2,0,2,1229,3,749
"2615","송산면","송산면제2투","대통령선거","충청남도","당진시",1885,1076,321,362,278,29,74,1,0,1,0,3,0,2,2,1073,3,809
"2616","송산면","송산면제3투","대통령선거","충청남도","당진시",3517,2280,1032,402,434,96,270,5,0,5,1,17,1,0,3,2266,14,1237
"2617","당진2동","관내사전투표","대통령선거","충청남도","당진시",2772,2772,1316,461,523,155,282,2,0,7,1,2,1,0,5,2755,17,0
"2618","당진2동","당진2동제1투","대통령선거","충청남도","당진시",573,374,88,156,100,12,15,0,0,1,0,0,0,1,1,374,0,199
"2619","당진2동","당진2동제2투","대통령선거","충청남도","당진시",2811,1700,563,534,372,75,132,1,0,6,1,8,1,0,2,1695,5,1111
"2620","당진2동","당진2동제3투","대통령선거","충청남도","당진시",1609,1005,373,271,236,40,73,1,0,5,0,4,0,0,1,1004,1,604
"2621","당진2동","당진2동제4투","대통령선거","충청남도","당진시",3052,2175,1001,377,475,114,192,1,1,3,0,3,0,0,0,2167,8,877
"2622","당진2동","당진2동제5투","대통령선거","충청남도","당진시",3121,1862,712,413,437,109,139,6,0,28,1,6,1,0,1,1853,9,1259
"2623","당진3동","관내사전투표","대통령선거","충청남도","당진시",3176,3176,1718,377,534,192,326,4,2,7,0,4,0,0,3,3167,9,0
"2624","당진3동","당진3동제1투","대통령선거","충청남도","당진시",3536,2391,969,473,537,177,213,3,0,4,1,3,1,1,1,2383,8,1145
"2625","당진3동","당진3동제2투","대통령선거","충청남도","당진시",2309,1648,734,291,342,94,161,6,1,4,0,8,0,2,2,1645,3,661
"2626","당진3동","당진3동제3투","대통령선거","충청남도","당진시",1510,1125,505,203,250,63,93,1,0,4,0,3,0,1,0,1123,2,385
"2627","당진3동","당진3동제4투","대통령선거","충청남도","당진시",2066,1322,511,272,307,92,126,1,0,3,1,2,0,2,3,1320,2,744
"2628","잘못 투입·구분된 투표지","잘못 투입·구분된 투표지","대통령선거","충청남도","당진시",0,0,0,0,0,0,0,0,0,0,0,0,0,0,0,0,0,0
"2629","거소·선상투표","거소·선상투표","대통령선거","충청남도","부여군",255,237,71,45,78,10,10,2,0,1,3,2,0,3,1,226,11,18
"2630","관외사전투표","관외사전투표","대통령선거","충청남도","부여군",4750,4750,2163,691,960,381,473,10,2,1,3,9,1,2,7,4703,47,0
"2631","재외투표","재외투표","대통령선거","충청남도","부여군",268,174,101,18,32,8,15,0,0,0,0,0,0,0,0,174,0,94
"2632","부여읍","관내사전투표","대통령선거","충청남도","부여군",3583,3583,1541,808,704,207,282,3,1,1,0,5,4,2,4,3562,21,0
"2633","부여읍","부여읍제1투","대통령선거","충청남도","부여군",1774,1028,309,371,239,43,53,2,0,0,0,3,0,1,0,1021,7,746
"2634","부여읍","부여읍제2투","대통령선거","충청남도","부여군",1423,910,233,378,209,34,43,1,1,2,1,0,2,1,0,905,5,513
"2635","부여읍","부여읍제3투","대통령선거","충청남도","부여군",1469,934,244,379,239,28,29,1,1,2,0,2,2,0,3,930,4,535
"2636","부여읍","부여읍제4투","대통령선거","충청남도","부여군",1226,808,207,317,209,39,32,0,0,0,0,1,1,0,1,807,1,418
"2637","부여읍","부여읍제5투","대통령선거","충청남도","부여군",2447,1622,506,549,386,69,97,2,1,1,0,3,1,2,1,1618,4,825
"2638","부여읍","부여읍제6투","대통령선거","충청남도","부여군",1570,1058,369,273,279,62,67,0,0,2,0,1,1,1,1,1056,2,512
"2639","부여읍","부여읍제7투","대통령선거","충청남도","부여군",1487,852,216,338,202,30,46,1,0,1,0,4,2,5,1,846,6,635
"2640","부여읍","부여읍제8투","대통령선거","충청남도","부여군",1196,722,151,338,164,22,32,1,0,1,2,0,3,2,2,718,4,474
"2641","부여읍","부여읍제9투","대통령선거","충청남도","부여군",1577,969,300,311,251,38,53,1,0,1,0,0,0,2,2,959,10,608
"2642","규암면","관내사전투표","대통령선거","충청남도","부여군",1026,1026,355,283,246,45,74,3,0,1,0,2,2,6,5,1022,4,0
"2643","규암면","규암면제1투","대통령선거","충청남도","부여군",1508,844,193,365,208,30,43,0,0,0,0,0,0,0,1,840,4,664
"2644","규암면","규암면제2투","대통령선거","충청남도","부여군",2571,1510,489,453,397,71,86,3,0,1,0,0,0,2,2,1504,6,1061
"2645","규암면","규암면제3투","대통령선거","충청남도","부여군",1433,931,271,283,267,38,56,0,1,1,2,1,4,2,1,927,4,502
"2646","규암면","규암면제4투","대통령선거","충청남도","부여군",1092,694,172,294,156,33,32,0,0,1,0,1,1,2,0,692,2,398
"2647","은산면","관내사전투표","대통령선거","충청남도","부여군",671,671,183,248,173,14,35,3,0,3,0,1,4,2,1,667,4,0
"2648","은산면","은산면제1투","대통령선거","충청남도","부여군",1504,855,193,366,203,39,38,0,0,0,0,2,0,2,5,848,7,649
"2649","은산면","은산면제2투","대통령선거","충청남도","부여군",634,399,94,146,125,14,10,0,0,0,0,1,2,1,2,395,4,235
"2650","은산면","은산면제3투","대통령선거","충청남도","부여군",639,368,58,169,109,11,16,0,0,0,0,0,0,2,1,366,2,271
"2651","외산면","관내사전투표","대통령선거","충청남도","부여군",516,516,165,154,147,16,20,0,2,0,2,2,1,3,0,512,4,0
"2652","외산면","외산면투표소","대통령선거","충청남도","부여군",1676,1098,291,379,322,50,29,2,2,3,1,0,3,4,4,1090,8,578
"2653","내산면","관내사전투표","대통령선거","충청남도","부여군",251,251,74,71,79,12,13,0,0,1,1,0,0,0,0,251,0,0
"2654","내산면","내산면투표소","대통령선거","충청남도","부여군",1231,822,174,347,231,24,31,0,0,2,0,1,3,1,4,818,4,409
"2655","구룡면","관내사전투표","대통령선거","충청남도","부여군",294,294,106,85,78,8,15,1,0,0,0,0,0,1,0,294,0,0
"2656","구룡면","구룡면제1투","대통령선거","충청남도","부여군",1268,748,208,249,238,15,20,1,1,1,0,2,3,2,2,742,6,520
"2657","구룡면","구룡면제2투","대통령선거","충청남도","부여군",587,384,113,114,101,20,22,0,0,0,0,1,1,3,5,380,4,203
"2658","홍산면","관내사전투표","대통령선거","충청남도","부여군",545,545,179,187,129,18,20,1,0,0,0,3,0,1,1,539,6,0
"2659","홍산면","홍산면제1투","대통령선거","충청남도","부여군",1520,927,222,334,264,38,55,0,1,0,1,0,1,0,2,918,9,593
"2660","홍산면","홍산면제2투","대통령선거","충청남도","부여군",556,371,91,131,113,15,10,1,0,0,0,5,2,0,1,369,2,185
"2661","옥산면","관내사전투표","대통령선거","충청남도","부여군",218,218,67,65,52,13,16,1,0,0,0,0,0,1,1,216,2,0
"2662","옥산면","옥산면투표소","대통령선거","충청남도","부여군",1078,688,153,258,213,18,24,1,1,0,0,4,4,4,5,685,3,390
"2663","남면","관내사전투표","대통령선거","충청남도","부여군",297,297,107,96,68,12,7,0,0,0,0,0,1,0,2,293,4,0
"2664","남면","남면투표소","대통령선거","충청남도","부여군",1437,877,231,286,286,27,32,1,0,0,0,2,1,2,3,871,6,560
"2665","충화면","관내사전투표","대통령선거","충청남도","부여군",163,163,64,57,29,4,7,0,0,0,0,0,0,0,0,161,2,0
"2666","충화면","충화면투표소","대통령선거","충청남도","부여군",898,571,125,239,161,16,21,1,0,0,0,0,0,0,2,565,6,327
"2667","양화면","관내사전투표","대통령선거","충청남도","부여군",222,222,66,74,56,12,8,4,0,0,0,0,0,1,0,221,1,0
"2668","양화면","양화면제1투","대통령선거","충청남도","부여군",572,357,66,151,110,10,13,1,0,0,0,2,1,1,0,355,2,215
"2669","양화면","양화면제2투","대통령선거","충청남도","부여군",824,538,157,192,141,13,22,0,1,0,0,0,1,5,1,533,5,286
"2670","임천면","관내사전투표","대통령선거","충청남도","부여군",443,442,142,148,111,22,16,0,0,0,0,0,0,1,1,441,1,1
"2671","임천면","임천면제1투","대통령선거","충청남도","부여군",1303,796,175,292,251,30,34,1,0,0,3,1,1,2,1,791,5,507
"2672","임천면","임천면제2투","대통령선거","충청남도","부여군",870,522,124,204,148,13,24,1,1,1,0,1,1,2,0,520,2,348
"2673","장암면","관내사전투표","대통령선거","충청남도","부여군",403,403,134,111,118,12,22,0,0,0,0,1,1,0,2,401,2,0
"2674","장암면","장암면제1투","대통령선거","충청남도","부여군",500,275,68,100,80,9,11,0,1,0,0,0,1,0,0,270,5,225
"2675","장암면","장암면제2투","대통령선거","충청남도","부여군",790,444,107,184,124,8,12,0,0,0,0,0,1,1,2,439,5,346
"2676","장암면","장암면제3투","대통령선거","충청남도","부여군",884,547,134,188,169,17,29,1,0,0,2,1,0,4,0,545,2,337
"2677","세도면","관내사전투표","대통령선거","충청남도","부여군",432,432,120,136,132,16,23,1,0,0,0,0,1,1,1,431,1,0
"2678","세도면","세도면제1투","대통령선거","충청남도","부여군",1225,691,191,218,224,15,31,0,0,1,1,0,4,0,4,689,2,534
"2679","세도면","세도면제2투","대통령선거","충청남도","부여군",1316,801,291,225,218,29,29,0,0,0,0,0,0,0,3,795,6,515
"2680","석성면","관내사전투표","대통령선거","충청남도","부여군",386,386,151,107,86,10,24,0,0,0,0,1,0,1,4,384,2,0
"2681","석성면","석성면제1투","대통령선거","충청남도","부여군",1386,831,219,334,202,23,40,0,0,2,1,1,0,3,2,827,4,555
"2682","석성면","석성면제2투","대통령선거","충청남도","부여군",872,557,171,171,165,24,14,0,1,1,0,1,0,1,3,552,5,315
"2683","초촌면","관내사전투표","대통령선거","충청남도","부여군",272,272,81,80,70,12,22,0,0,1,0,1,3,1,0,271,1,0
"2684","초촌면","초촌면제1투","대통령선거","충청남도","부여군",1082,645,190,212,174,19,29,0,0,0,0,6,0,3,5,638,7,437
"2685","초촌면","초촌면제2투","대통령선거","충청남도","부여군",621,412,116,159,96,15,15,0,0,0,0,2,1,1,4,409,3,209
"2686","잘못 투입·구분된 투표지","잘못 투입·구분된 투표지","대통령선거","충청남도","부여군",0,0,0,0,0,0,0,0,0,0,0,0,0,0,0,0,0,0
"2687","거소·선상투표","거소·선상투표","대통령선거","충청남도","서천군",118,102,35,21,31,5,3,0,1,0,0,0,0,0,1,97,5,16
"2688","관외사전투표","관외사전투표","대통령선거","충청남도","서천군",3619,3619,1761,509,695,282,322,3,0,1,2,4,1,2,9,3591,28,0
"2689","재외투표","재외투표","대통령선거","충청남도","서천군",202,142,82,16,27,2,15,0,0,0,0,0,0,0,0,142,0,60
"2690","장항읍","관내사전투표","대통령선거","충청남도","서천군",1543,1543,732,304,311,82,102,2,0,0,0,0,0,1,3,1537,6,0
"2691","장항읍","장항읍제1투","대통령선거","충청남도","서천군",1615,958,252,326,294,44,35,0,0,1,0,0,1,1,0,954,4,657
"2692","장항읍","장항읍제2투","대통령선거","충청남도","서천군",2338,1416,489,359,410,72,71,0,0,0,1,1,2,2,4,1411,5,922
"2693","장항읍","장항읍제3투","대통령선거","충청남도","서천군",2285,1425,446,448,392,75,51,0,0,6,0,0,2,0,1,1421,4,860
"2694","장항읍","장항읍제4투","대통령선거","충청남도","서천군",1697,1053,351,299,296,49,47,1,0,4,1,0,0,0,1,1049,4,644
"2695","서천읍","관내사전투표","대통령선거","충청남도","서천군",2590,2590,1194,565,487,150,175,1,1,2,0,5,0,0,2,2582,8,0
"2696","서천읍","서천읍제1투","대통령선거","충청남도","서천군",1749,1028,314,360,273,36,35,1,0,0,0,1,0,0,2,1022,6,721
"2697","서천읍","서천읍제2투","대통령선거","충청남도","서천군",1388,803,274,246,209,27,30,5,0,2,0,0,0,2,1,796,7,585
"2698","서천읍","서천읍제3투","대통령선거","충청남도","서천군",1492,933,268,366,230,29,27,1,0,0,0,0,2,1,2,926,7,559
"2699","서천읍","서천읍제4투","대통령선거","충청남도","서천군",1404,943,366,252,237,44,35,0,0,0,0,0,1,1,0,936,7,461
"2700","서천읍","서천읍제5투","대통령선거","충청남도","서천군",2200,1497,600,403,334,84,62,0,0,3,0,4,0,1,1,1492,5,703
"2701","마서면","관내사전투표","대통령선거","충청남도","서천군",539,539,230,131,112,18,37,0,0,1,1,2,1,0,1,534,5,0
"2702","마서면","마서면제1투","대통령선거","충청남도","서천군",1218,746,259,214,210,21,29,1,1,1,0,3,2,1,0,742,4,472
"2703","마서면","마서면제2투","대통령선거","충청남도","서천군",1262,726,236,218,207,32,19,0,0,1,0,2,1,1,2,719,7,536
"2704","마서면","마서면제3투","대통령선거","충청남도","서천군",1392,893,300,243,271,32,42,0,0,0,0,0,0,0,1,889,4,499
"2705","화양면","관내사전투표","대통령선거","충청남도","서천군",367,367,148,98,89,13,11,1,0,1,0,1,1,0,1,364,3,0
"2706","화양면","화양면제1투","대통령선거","충청남도","서천군",1041,636,192,222,176,20,18,0,0,0,1,2,0,1,2,634,2,405
"2707","화양면","화양면제2투","대통령선거","충청남도","서천군",721,464,146,161,122,8,17,0,0,2,0,0,2,2,2,462,2,257
"2708","기산면","관내사전투표","대통령선거","충청남도","서천군",346,346,129,102,78,10,23,0,0,2,0,0,0,1,0,345,1,0
"2709","기산면","기산면투표소","대통령선거","충청남도","서천군",1207,755,223,303,168,28,24,0,0,0,0,3,0,1,1,751,4,452
"2710","한산면","관내사전투표","대통령선거","충청남도","서천군",517,517,199,146,127,16,20,2,0,1,0,0,0,2,0,513,4,0
"2711","한산면","한산면투표소","대통령선거","충청남도","서천군",1867,1157,369,350,320,50,44,2,1,4,1,0,3,2,4,1150,7,710
"2712","마산면","관내사전투표","대통령선거","충청남도","서천군",263,263,102,83,57,7,7,2,1,0,0,1,1,0,2,263,0,0
"2713","마산면","마산면투표소","대통령선거","충청남도","서천군",1076,670,234,202,177,20,22,0,0,1,1,4,2,1,4,668,2,406
"2714","시초면","관내사전투표","대통령선거","충청남도","서천군",225,225,64,72,65,7,14,0,0,1,0,0,1,0,1,225,0,0
"2715","시초면","시초면투표소","대통령선거","충청남도","서천군",934,574,156,200,171,12,18,2,2,0,0,1,4,3,1,570,4,360
"2716","문산면","관내사전투표","대통령선거","충청남도","서천군",215,215,71,58,70,10,3,0,0,0,0,1,0,0,0,213,2,0
"2717","문산면","문산면투표소","대통령선거","충청남도","서천군",977,615,158,233,182,11,16,1,0,0,0,0,2,1,2,606,9,362
"2718","판교면","관내사전투표","대통령선거","충청남도","서천군",480,480,143,171,111,18,29,0,0,0,0,0,1,0,1,474,6,0
"2719","판교면","판교면투표소","대통령선거","충청남도","서천군",1551,1024,232,435,289,27,24,0,0,0,1,1,1,3,4,1017,7,527
"2720","종천면","관내사전투표","대통령선거","충청남도","서천군",296,296,130,89,54,5,15,1,0,0,0,0,0,0,0,294,2,0
"2721","종천면","종천면제1투","대통령선거","충청남도","서천군",756,451,146,152,115,17,13,1,0,2,0,0,2,1,0,449,2,305
"2722","종천면","종천면제2투","대통령선거","충청남도","서천군",836,531,138,211,143,13,13,1,0,1,0,3,0,3,1,527,4,305
"2723","비인면","관내사전투표","대통령선거","충청남도","서천군",467,467,172,119,112,22,31,1,0,2,0,3,1,0,1,464,3,0
"2724","비인면","비인면제1투","대통령선거","충청남도","서천군",1547,963,244,333,291,39,38,2,0,3,1,0,0,1,2,954,9,584
"2725","비인면","비인면제2투","대통령선거","충청남도","서천군",830,468,166,119,131,24,19,2,1,1,0,0,0,1,0,464,4,362
"2726","서면","관내사전투표","대통령선거","충청남도","서천군",553,553,198,153,146,24,25,1,0,1,0,2,0,0,1,551,2,0
"2727","서면","서면제1투","대통령선거","충청남도","서천군",1244,730,189,268,205,28,23,1,0,1,0,0,2,4,1,722,8,514
"2728","서면","서면제2투","대통령선거","충청남도","서천군",2008,1166,416,331,319,38,43,2,1,2,0,0,1,3,2,1158,8,842
"2729","잘못 투입·구분된 투표지","잘못 투입·구분된 투표지","대통령선거","충청남도","서천군",0,0,0,0,0,0,0,0,0,0,0,0,0,0,0,0,0,0
"2730","거소·선상투표","거소·선상투표","대통령선거","충청남도","홍성군",258,240,78,46,66,16,9,3,2,0,0,0,5,2,5,232,8,18
"2731","관외사전투표","관외사전투표","대통령선거","충청남도","홍성군",6609,6609,3028,988,1321,526,654,7,0,3,0,10,6,2,7,6552,57,0
"2732","재외투표","재외투표","대통령선거","충청남도","홍성군",287,221,131,15,32,10,30,0,0,0,0,0,1,0,1,220,1,66
"2733","홍성읍","관내사전투표","대통령선거","충청남도","홍성군",5172,5172,2325,1054,979,325,441,0,3,5,4,1,1,3,9,5150,22,0
"2734","홍성읍","홍성읍제1투","대통령선거","충청남도","홍성군",2413,1519,410,578,377,72,73,0,0,2,0,3,0,0,0,1515,4,894
"2735","홍성읍","홍성읍제2투","대통령선거","충청남도","홍성군",2576,1704,557,511,437,102,87,1,2,1,0,1,0,0,1,1700,4,872
"2736","홍성읍","홍성읍제3투","대통령선거","충청남도","홍성군",3290,1953,750,458,497,101,135,1,0,1,1,0,0,1,2,1947,6,1337
"2737","홍성읍","홍성읍제4투","대통령선거","충청남도","홍성군",2067,1165,352,418,265,54,65,1,1,2,0,1,2,2,0,1163,2,902
"2738","홍성읍","홍성읍제5투","대통령선거","충청남도","홍성군",3347,1943,638,659,411,110,105,6,1,1,0,1,2,1,0,1935,8,1404
"2739","홍성읍","홍성읍제6투","대통령선거","충청남도","홍성군",3185,1885,498,734,492,69,69,0,2,2,1,3,1,1,1,1873,12,1300
"2740","홍성읍","홍성읍제7투","대통령선거","충청남도","홍성군",3225,1982,687,507,531,118,119,5,1,2,0,1,4,0,0,1975,7,1243
"2741","홍성읍","홍성읍제8투","대통령선거","충청남도","홍성군",4092,2427,866,606,601,127,205,2,0,2,0,0,1,1,3,2414,13,1665
"2742","광천읍","관내사전투표","대통령선거","충청남도","홍성군",1573,1573,382,622,384,69,102,0,0,0,0,1,1,2,3,1566,7,0
"2743","광천읍","광천읍제1투","대통령선거","충청남도","홍성군",2075,1151,270,520,279,32,33,4,0,3,2,0,0,0,2,1145,6,924
"2744","광천읍","광천읍제2투","대통령선거","충청남도","홍성군",2445,1490,380,590,393,57,47,0,0,1,0,0,1,6,0,1475,15,955
"2745","광천읍","광천읍제3투","대통령선거","충청남도","홍성군",2132,1234,269,491,337,61,58,1,0,0,0,2,2,4,2,1227,7,898
"2746","홍북면","관내사전투표","대통령선거","충청남도","홍성군",3679,3678,1915,473,718,235,313,3,1,3,0,1,0,1,2,3665,13,1
"2747","홍북면","홍북면제1투","대통령선거","충청남도","홍성군",1355,868,254,306,214,42,37,2,0,1,2,0,2,2,3,865,3,487
"2748","홍북면","홍북면제2투","대통령선거","충청남도","홍성군",872,573,158,201,171,17,22,0,1,0,0,0,1,1,0,572,1,299
"2749","홍북면","홍북면제3투","대통령선거","충청남도","홍성군",810,522,112,195,163,25,23,0,0,1,0,0,1,0,2,522,0,288
"2750","홍북면","홍북면제4투","대통령선거","충청남도","홍성군",1919,1204,529,190,291,87,105,0,0,0,0,1,0,0,0,1203,1,715
"2751","홍북면","홍북면제5투","대통령선거","충청남도","홍성군",2097,1553,764,225,334,108,116,2,0,0,0,0,0,2,1,1552,1,544
"2752","홍북면","홍북면제6투","대통령선거","충청남도","홍성군",2007,1446,703,182,336,106,115,0,0,0,1,0,1,1,0,1445,1,561
"2753","홍북면","홍북면제7투","대통령선거","충청남도","홍성군",3038,2143,984,320,513,135,181,0,0,0,0,1,1,2,3,2140,3,895
"2754","금마면","관내사전투표","대통령선거","충청남도","홍성군",385,385,142,106,89,11,29,2,0,0,0,0,1,1,0,381,4,0
"2755","금마면","금마면제1투","대통령선거","충청남도","홍성군",814,545,137,182,177,17,20,0,0,3,0,0,3,2,0,541,4,269
"2756","금마면","금마면제2투","대통령선거","충청남도","홍성군",860,529,115,202,162,20,21,1,1,1,0,1,0,1,1,526,3,331
"2757","금마면","금마면제3투","대통령선거","충청남도","홍성군",1061,680,163,249,199,19,37,1,1,1,0,1,1,2,0,674,6,381
"2758","홍동면","관내사전투표","대통령선거","충청남도","홍성군",389,389,192,58,67,19,51,0,0,0,0,0,0,0,1,388,1,0
"2759","홍동면","홍동면제1투","대통령선거","충청남도","홍성군",927,605,215,159,151,22,52,1,0,0,0,1,1,1,1,604,1,322
"2760","홍동면","홍동면제2투","대통령선거","충청남도","홍성군",693,488,158,130,141,13,40,0,0,0,0,0,1,1,0,484,4,205
"2761","홍동면","홍동면제3투","대통령선거","충청남도","홍성군",931,612,152,246,171,18,20,0,0,1,1,0,1,0,0,610,2,319
"2762","장곡면","관내사전투표","대통령선거","충청남도","홍성군",309,309,104,101,61,19,23,0,1,0,0,0,0,0,0,309,0,0
"2763","장곡면","장곡면제1투","대통령선거","충청남도","홍성군",1084,641,141,267,165,23,31,8,0,0,0,0,1,1,0,637,4,443
"2764","장곡면","장곡면제2투","대통령선거","충청남도","홍성군",433,277,62,102,86,11,9,0,0,1,0,0,0,4,0,275,2,156
"2765","장곡면","장곡면제3투","대통령선거","충청남도","홍성군",821,543,116,229,159,13,20,1,0,0,0,0,1,2,1,542,1,278
"2766","은하면","관내사전투표","대통령선거","충청남도","홍성군",226,226,65,77,53,15,12,1,0,0,0,0,1,0,0,224,2,0
"2767","은하면","은하면제1투","대통령선거","충청남도","홍성군",1392,839,200,342,240,17,25,0,0,1,1,1,1,4,3,835,4,553
"2768","은하면","은하면제2투","대통령선거","충청남도","홍성군",582,360,42,212,75,11,14,0,0,1,0,0,0,0,1,356,4,222
"2769","결성면","관내사전투표","대통령선거","충청남도","홍성군",375,375,103,135,86,9,21,0,0,2,2,0,0,4,2,364,11,0
"2770","결성면","결성면제1투","대통령선거","충청남도","홍성군",623,412,82,193,95,16,14,0,0,1,0,4,0,2,2,409,3,211
"2771","결성면","결성면제2투","대통령선거","충청남도","홍성군",456,315,70,111,105,14,7,0,0,1,0,0,1,0,1,310,5,141
"2772","결성면","결성면제3투","대통령선거","충청남도","홍성군",570,376,80,173,94,8,11,0,0,1,0,1,1,0,1,370,6,194
"2773","서부면","관내사전투표","대통령선거","충청남도","홍성군",464,464,125,181,108,21,22,2,0,0,0,0,0,2,0,461,3,0
"2774","서부면","서부면제1투","대통령선거","충청남도","홍성군",1256,758,161,330,194,33,22,0,0,1,0,2,2,3,1,749,9,498
"2775","서부면","서부면제2투","대통령선거","충청남도","홍성군",1241,779,162,365,199,14,26,2,0,0,0,0,3,1,0,772,7,462
"2776","갈산면","관내사전투표","대통령선거","충청남도","홍성군",567,567,164,214,141,18,20,0,0,1,1,0,1,2,1,563,4,0
"2777","갈산면","갈산면제1투","대통령선거","충청남도","홍성군",1761,1091,238,472,289,39,41,0,1,0,0,1,1,4,3,1089,2,670
"2778","갈산면","갈산면제2투","대통령선거","충청남도","홍성군",386,262,63,121,57,8,10,0,0,0,1,0,0,0,0,260,2,124
"2779","갈산면","갈산면제3투","대통령선거","충청남도","홍성군",579,365,73,138,122,15,8,1,0,0,0,0,2,3,0,362,3,214
"2780","구항면","관내사전투표","대통령선거","충청남도","홍성군",392,392,165,89,103,14,18,0,0,0,0,0,1,0,1,391,1,0
"2781","구항면","구항면제1투","대통령선거","충청남도","홍성군",1657,1068,279,345,326,45,48,2,0,3,0,0,0,3,3,1054,14,589
"2782","구항면","구항면제2투","대통령선거","충청남도","홍성군",1215,738,212,264,194,27,29,1,0,1,0,0,0,0,4,732,6,477
"2783","잘못 투입·구분된 투표지","잘못 투입·구분된 투표지","대통령선거","충청남도","홍성군",0,0,0,0,0,0,0,0,0,0,0,0,0,0,0,0,0,0
"2784","거소·선상투표","거소·선상투표","대통령선거","충청남도","청양군",110,89,22,18,32,2,3,1,0,0,1,0,0,1,0,80,9,21
"2785","관외사전투표","관외사전투표","대통령선거","충청남도","청양군",2522,2522,1128,448,507,189,219,4,0,2,0,1,0,1,5,2504,18,0
"2786","재외투표","재외투표","대통령선거","충청남도","청양군",95,70,37,3,18,3,9,0,0,0,0,0,0,0,0,70,0,25
"2787","청양읍","관내사전투표","대통령선거","충청남도","청양군",1548,1548,644,349,307,98,125,0,0,3,1,2,2,2,3,1536,12,0
"2788","청양읍","청양읍제1투","대통령선거","충청남도","청양군",1307,811,177,350,208,28,37,4,0,0,1,0,0,3,0,808,3,496
"2789","청양읍","청양읍제2투","대통령선거","충청남도","청양군",2365,1543,471,534,361,73,87,0,0,2,0,1,0,1,2,1532,11,822
"2790","청양읍","청양읍제3투","대통령선거","충청남도","청양군",1265,763,171,358,179,25,22,0,0,1,0,0,0,0,2,758,5,502
"2791","청양읍","청양읍제4투","대통령선거","충청남도","청양군",1321,838,218,359,179,39,32,0,0,2,1,0,1,0,3,834,4,483
"2792","운곡면","관내사전투표","대통령선거","충청남도","청양군",336,336,99,133,65,12,16,6,0,1,0,1,0,2,1,336,0,0
"2793","운곡면","운곡면투표소","대통령선거","충청남도","청양군",1545,959,185,466,234,17,37,0,1,0,1,1,5,3,1,951,8,586
"2794","대치면","관내사전투표","대통령선거","충청남도","청양군",278,278,85,90,71,17,12,0,1,0,0,0,1,0,1,278,0,0
"2795","대치면","대치면제1투","대통령선거","충청남도","청양군",885,544,135,225,147,9,20,3,1,0,1,1,0,0,1,543,1,341
"2796","대치면","대치면제2투","대통령선거","충청남도","청양군",755,503,109,193,162,19,16,0,0,0,1,0,1,0,0,501,2,252
"2797","정산면","관내사전투표","대통령선거","충청남도","청양군",606,606,213,206,101,20,60,0,1,1,0,0,0,0,1,603,3,0
"2798","정산면","정산면제1투","대통령선거","충청남도","청양군",1288,799,193,300,206,40,48,2,0,1,1,1,1,0,2,795,4,489
"2799","정산면","정산면제2투","대통령선거","충청남도","청양군",1073,649,184,221,188,13,33,1,0,1,0,0,0,2,0,643,6,424
"2800","목면","관내사전투표","대통령선거","충청남도","청양군",174,174,64,38,50,6,10,1,0,0,0,0,1,4,0,174,0,0
"2801","목면","목면제1투","대통령선거","충청남도","청양군",590,386,101,130,116,13,19,0,0,0,0,0,1,2,1,383,3,204
"2802","목면","목면제2투","대통령선거","충청남도","청양군",508,341,92,111,105,10,16,0,0,0,0,0,3,0,2,339,2,167
"2803","청남면","관내사전투표","대통령선거","충청남도","청양군",259,259,103,80,52,6,16,0,0,0,0,0,0,0,1,258,1,0
"2804","청남면","청남면투표소","대통령선거","충청남도","청양군",1428,858,202,368,223,22,31,0,0,2,0,1,1,4,1,855,3,570
"2805","장평면","관내사전투표","대통령선거","충청남도","청양군",271,271,98,71,73,7,14,0,0,1,0,0,0,0,3,267,4,0
"2806","장평면","장평면제1투","대통령선거","충청남도","청양군",818,518,149,164,164,15,19,1,1,0,0,2,0,1,1,517,1,300
"2807","장평면","장평면제2투","대통령선거","충청남도","청양군",441,303,61,115,96,13,15,0,0,0,0,0,0,1,1,302,1,138
"2808","장평면","장평면제3투","대통령선거","충청남도","청양군",551,356,102,116,114,9,11,0,0,1,0,0,1,0,2,356,0,195
"2809","남양면","관내사전투표","대통령선거","충청남도","청양군",375,375,119,135,80,9,24,1,0,1,0,1,0,0,3,373,2,0
"2810","남양면","남양면제1투","대통령선거","충청남도","청양군",1402,857,224,326,236,22,30,0,0,0,1,1,1,6,1,848,9,545
"2811","남양면","남양면제2투","대통령선거","충청남도","청양군",612,404,93,171,101,14,14,1,0,0,0,0,0,5,1,400,4,208
"2812","화성면","관내사전투표","대통령선거","충청남도","청양군",282,282,88,101,65,18,7,2,0,0,0,0,0,0,0,281,1,0
"2813","화성면","화성면제1투","대통령선거","충청남도","청양군",850,541,122,238,137,19,16,0,0,1,1,1,1,1,1,538,3,309
"2814","화성면","화성면제2투","대통령선거","충청남도","청양군",816,505,136,191,141,12,16,0,0,0,0,0,2,3,0,501,4,311
"2815","비봉면","관내사전투표","대통령선거","충청남도","청양군",229,229,70,67,76,7,7,0,0,0,0,0,1,0,0,228,1,0
"2816","비봉면","비봉면제1투","대통령선거","충청남도","청양군",1071,760,197,267,244,14,19,0,2,2,0,1,0,5,1,752,8,311
"2817","비봉면","비봉면제2투","대통령선거","충청남도","청양군",552,390,93,162,102,6,20,1,0,0,1,0,1,1,1,388,2,162
"2818","잘못 투입·구분된 투표지","잘못 투입·구분된 투표지","대통령선거","충청남도","청양군",0,0,0,0,0,0,0,0,0,0,0,0,0,0,0,0,0,0
"2819","거소·선상투표","거소·선상투표","대통령선거","충청남도","예산군",161,148,38,42,41,12,3,2,1,2,0,0,1,1,1,144,4,13
"2820","관외사전투표","관외사전투표","대통령선거","충청남도","예산군",5618,5618,2388,1077,1091,482,518,5,1,2,1,6,1,2,7,5581,37,0
"2821","재외투표","재외투표","대통령선거","충청남도","예산군",292,210,129,17,31,6,25,0,0,0,0,0,1,0,0,209,1,82
"2822","예산읍","관내사전투표","대통령선거","충청남도","예산군",4044,4044,1565,1098,791,246,308,4,1,2,1,4,2,5,1,4028,16,0
"2823","예산읍","예산읍제1투","대통령선거","충청남도","예산군",2528,1365,268,687,289,60,48,0,1,1,1,0,0,0,1,1356,9,1163
"2824","예산읍","예산읍제2투","대통령선거","충청남도","예산군",1366,851,201,395,173,42,31,1,0,2,0,0,0,1,1,847,4,515
"2825","예산읍","예산읍제3투","대통령선거","충청남도","예산군",1730,1160,319,483,232,48,69,1,0,1,1,1,0,0,2,1157,3,570
"2826","예산읍","예산읍제4투","대통령선거","충청남도","예산군",2752,1653,354,806,342,64,74,1,0,1,0,0,0,0,1,1643,10,1099
"2827","예산읍","예산읍제5투","대통령선거","충청남도","예산군",1774,1119,279,466,250,51,61,1,0,0,0,0,0,0,1,1109,10,655
"2828","예산읍","예산읍제6투","대통령선거","충청남도","예산군",2034,1254,387,428,288,56,87,0,0,1,2,2,0,0,0,1251,3,780
"2829","예산읍","예산읍제7투","대통령선거","충청남도","예산군",2539,1587,537,472,391,77,96,4,1,0,0,1,0,1,3,1583,4,952
"2830","예산읍","예산읍제8투","대통령선거","충청남도","예산군",2626,1705,572,530,364,104,119,1,0,0,2,3,0,0,2,1697,8,921
"2831","예산읍","예산읍제9투","대통령선거","충청남도","예산군",2049,1333,273,650,288,52,45,2,2,3,0,0,2,3,2,1322,11,716
"2832","예산읍","예산읍제10투","대통령선거","충청남도","예산군",3015,1851,418,802,421,80,110,2,0,1,1,1,0,1,3,1840,11,1164
"2833","삽교읍","관내사전투표","대통령선거","충청남도","예산군",1040,1040,294,419,210,49,58,1,0,3,0,1,1,0,2,1038,2,0
"2834","삽교읍","삽교읍제1투","대통령선거","충청남도","예산군",1689,1002,224,445,241,43,36,2,0,1,1,1,0,1,3,998,4,687
"2835","삽교읍","삽교읍제2투","대통령선거","충청남도","예산군",951,524,137,211,128,16,23,1,0,0,0,1,2,3,1,523,1,427
"2836","삽교읍","삽교읍제3투","대통령선거","충청남도","예산군",1520,921,210,390,251,26,35,2,0,1,0,0,0,1,3,919,2,599
"2837","삽교읍","삽교읍제4투","대통령선거","충청남도","예산군",1002,557,123,259,119,25,21,1,0,0,0,0,0,0,4,552,5,445
"2838","대술면","관내사전투표","대통령선거","충청남도","예산군",349,349,106,105,88,21,24,1,0,0,0,0,2,1,0,348,1,0
"2839","대술면","대술면투표소","대통령선거","충청남도","예산군",1967,1229,243,574,299,47,50,0,2,2,1,0,0,1,3,1222,7,738
"2840","신양면","관내사전투표","대통령선거","충청남도","예산군",636,636,160,234,185,12,25,0,1,0,1,1,2,2,3,626,10,0
"2841","신양면","신양면투표소","대통령선거","충청남도","예산군",2286,1403,290,621,372,35,60,3,1,0,0,0,3,5,4,1394,9,883
"2842","광시면","관내사전투표","대통령선거","충청남도","예산군",475,475,112,200,110,12,34,1,0,0,0,0,0,0,1,470,5,0
"2843","광시면","광시면제1투","대통령선거","충청남도","예산군",1732,1113,237,502,299,34,28,0,0,1,0,0,0,3,1,1105,8,619
"2844","광시면","광시면제2투","대통령선거","충청남도","예산군",697,428,83,236,76,7,17,0,0,0,0,0,0,3,1,423,5,269
"2845","대흥면","관내사전투표","대통령선거","충청남도","예산군",194,194,62,88,29,6,7,0,0,0,1,0,0,0,0,193,1,0
"2846","대흥면","대흥면제1투","대통령선거","충청남도","예산군",601,377,55,203,83,14,11,3,0,0,0,0,1,3,1,374,3,224
"2847","대흥면","대흥면제2투","대통령선거","충청남도","예산군",735,489,78,261,114,12,17,0,0,0,0,0,1,1,1,485,4,246
"2848","응봉면","관내사전투표","대통령선거","충청남도","예산군",408,408,139,148,89,17,14,0,0,0,0,0,0,0,0,407,1,0
"2849","응봉면","응봉면제1투","대통령선거","충청남도","예산군",1143,666,156,264,177,24,33,2,0,2,0,2,0,2,0,662,4,477
"2850","응봉면","응봉면제2투","대통령선거","충청남도","예산군",669,430,77,221,96,20,8,1,0,0,0,0,0,4,0,427,3,239
"2851","덕산면","관내사전투표","대통령선거","충청남도","예산군",1013,1013,309,375,229,43,46,3,0,1,1,0,0,2,2,1011,2,0
"2852","덕산면","덕산면제1투","대통령선거","충청남도","예산군",2520,1427,358,576,358,53,68,0,0,0,0,1,0,2,5,1421,6,1093
"2853","덕산면","덕산면제2투","대통령선거","충청남도","예산군",1262,820,193,357,199,39,21,1,0,1,0,0,0,4,2,817,3,442
"2854","덕산면","덕산면제3투","대통령선거","충청남도","예산군",1103,712,154,313,167,32,36,2,1,0,0,0,1,3,0,709,3,391
"2855","봉산면","관내사전투표","대통령선거","충청남도","예산군",315,315,84,124,84,9,8,0,0,0,0,2,0,1,2,314,1,0
"2856","봉산면","봉산면제1투","대통령선거","충청남도","예산군",1274,818,172,368,205,23,36,2,1,0,0,2,0,3,2,814,4,456
"2857","봉산면","봉산면제2투","대통령선거","충청남도","예산군",544,353,64,178,79,10,15,0,2,0,0,0,1,0,1,350,3,191
"2858","고덕면","관내사전투표","대통령선거","충청남도","예산군",626,626,202,220,129,28,33,1,0,1,0,2,1,1,3,621,5,0
"2859","고덕면","고덕면제1투","대통령선거","충청남도","예산군",2098,1253,290,559,296,42,52,4,0,0,1,0,1,1,1,1247,6,845
"2860","고덕면","고덕면제2투","대통령선거","충청남도","예산군",753,487,105,225,113,13,23,1,0,0,0,0,1,2,1,484,3,266
"2861","고덕면","고덕면제3투","대통령선거","충청남도","예산군",653,466,120,181,133,13,15,0,0,0,1,0,0,1,1,465,1,187
"2862","신암면","관내사전투표","대통령선거","충청남도","예산군",731,731,228,238,169,40,48,0,0,0,0,0,1,0,2,726,5,0
"2863","신암면","신암면제1투","대통령선거","충청남도","예산군",2034,1227,296,499,310,47,58,0,1,2,0,0,3,0,3,1219,8,807
"2864","신암면","신암면제2투","대통령선거","충청남도","예산군",791,521,142,197,144,18,12,0,0,0,0,3,2,1,0,519,2,270
"2865","오가면","관내사전투표","대통령선거","충청남도","예산군",670,670,198,253,140,35,33,0,0,2,0,0,0,1,0,662,8,0
"2866","오가면","오가면제1투","대통령선거","충청남도","예산군",1972,1138,247,502,283,50,46,2,0,1,0,1,0,2,0,1134,4,834
"2867","오가면","오가면제2투","대통령선거","충청남도","예산군",1513,952,204,412,247,24,48,0,0,4,0,0,1,0,1,941,11,561
"2868","잘못 투입·구분된 투표지","잘못 투입·구분된 투표지","대통령선거","충청남도","예산군",0,0,0,0,0,0,0,0,0,0,0,0,0,0,0,0,0,0
"2869","거소·선상투표","거소·선상투표","대통령선거","대구광역시","중구",104,94,20,32,24,10,4,2,0,0,0,0,0,0,0,92,2,10
"2870","관외사전투표","관외사전투표","대통령선거","대구광역시","중구",5883,5883,1765,1913,892,837,404,16,1,2,0,5,1,5,8,5849,34,0
"2871","재외투표","재외투표","대통령선거","대구광역시","중구",536,340,187,42,55,18,34,1,0,0,0,0,0,1,0,338,2,196
"2872","동인동","관내사전투표","대통령선거","대구광역시","중구",1372,1372,327,619,181,163,67,5,0,1,0,0,0,3,2,1368,4,0
"2873","동인동","동인동제1투","대통령선거","대구광역시","중구",2267,1346,216,735,192,136,60,2,0,0,0,0,1,1,1,1344,2,921
"2874","동인동","동인동제2투","대통령선거","대구광역시","중구",2597,1633,366,726,250,201,75,6,0,2,0,0,0,1,0,1627,6,964
"2875","동인동","동인동제3투","대통령선거","대구광역시","중구",2217,1455,217,842,183,141,54,3,1,0,0,0,2,0,3,1446,9,762
"2876","삼덕동","관내사전투표","대통령선거","대구광역시","중구",1066,1066,336,350,152,150,66,1,0,1,0,1,0,0,2,1059,7,0
"2877","삼덕동","삼덕동제1투","대통령선거","대구광역시","중구",2655,1784,430,705,287,262,86,4,0,2,0,0,0,1,0,1777,7,871
"2878","삼덕동","삼덕동제2투","대통령선거","대구광역시","중구",1462,866,226,328,134,108,66,2,0,0,0,0,0,0,0,864,2,596
"2879","성내1동","관내사전투표","대통령선거","대구광역시","중구",554,554,187,201,65,62,32,2,0,1,0,0,0,0,2,552,2,0
"2880","성내1동","성내1동제1투","대통령선거","대구광역시","중구",1928,1033,204,530,130,103,52,3,0,0,0,0,0,2,0,1024,9,895
"2881","성내1동","성내1동제2투","대통령선거","대구광역시","중구",1269,909,189,438,123,104,44,2,0,0,0,1,0,0,0,901,8,360
"2882","성내2동","관내사전투표","대통령선거","대구광역시","중구",743,743,201,313,90,88,41,2,1,1,0,2,0,1,1,741,2,0
"2883","성내2동","성내2동제1투","대통령선거","대구광역시","중구",1918,1215,188,686,165,118,36,8,0,2,2,0,0,0,1,1206,9,703
"2884","성내2동","성내2동제2투","대통령선거","대구광역시","중구",1542,992,155,622,104,69,34,1,0,0,1,1,0,0,1,988,4,550
"2885","성내3동","관내사전투표","대통령선거","대구광역시","중구",422,422,91,212,56,41,16,3,0,0,0,0,0,1,0,420,2,0
"2886","성내3동","성내3동제1투","대통령선거","대구광역시","중구",1382,809,119,503,86,74,20,5,0,0,0,0,0,1,0,808,1,573
"2887","성내3동","성내3동제2투","대통령선거","대구광역시","중구",1206,782,103,496,109,57,13,2,0,0,0,0,0,1,0,781,1,424
"2888","대신동","관내사전투표","대통령선거","대구광역시","중구",1285,1285,390,515,161,165,47,2,0,0,0,0,0,2,1,1283,2,0
"2889","대신동","대신동제1투","대통령선거","대구광역시","중구",2725,1987,428,948,287,241,69,3,0,0,1,0,0,1,2,1980,7,738
"2890","대신동","대신동제2투","대통령선거","대구광역시","중구",1845,1318,185,811,147,122,42,2,0,0,0,0,1,3,1,1314,4,527
"2891","남산1동","관내사전투표","대통령선거","대구광역시","중구",591,591,171,248,77,58,28,0,0,0,0,0,3,0,0,585,6,0
"2892","남산1동","남산1동제1투","대통령선거","대구광역시","중구",1597,961,150,603,94,72,29,3,0,0,1,1,0,0,1,954,7,636
"2893","남산1동","남산1동제2투","대통령선거","대구광역시","중구",1870,1374,274,685,182,170,48,8,0,0,0,0,0,0,3,1370,4,496
"2894","남산2동","관내사전투표","대통령선거","대구광역시","중구",712,712,176,325,90,79,39,2,0,1,0,0,0,0,0,712,0,0
"2895","남산2동","남산2동제1투","대통령선거","대구광역시","중구",1880,1243,205,641,187,147,50,4,0,0,0,0,0,2,0,1236,7,637
"2896","남산2동","남산2동제2투","대통령선거","대구광역시","중구",1145,795,123,506,81,56,15,6,0,1,0,0,0,1,0,789,6,350
"2897","남산3동","관내사전투표","대통령선거","대구광역시","중구",1050,1050,316,409,139,135,44,4,0,1,0,1,0,0,0,1049,1,0
"2898","남산3동","남산3동제1투","대통령선거","대구광역시","중구",2540,1874,488,746,306,239,82,2,0,1,0,2,0,0,0,1866,8,666
"2899","남산3동","남산3동제2투","대통령선거","대구광역시","중구",1871,1237,199,696,153,124,46,0,0,0,3,1,0,1,2,1225,12,634
"2900","남산4동","관내사전투표","대통령선거","대구광역시","중구",1444,1444,356,673,168,154,72,10,0,2,0,0,1,0,0,1436,8,0
"2901","남산4동","남산4동제1투","대통령선거","대구광역시","중구",2481,1643,262,965,202,124,69,4,0,0,0,1,1,7,3,1638,5,838
"2902","남산4동","남산4동제2투","대통령선거","대구광역시","중구",3535,2762,558,1259,430,332,153,13,1,4,1,0,0,1,1,2753,9,773
"2903","남산4동","남산4동제3투","대통령선거","대구광역시","중구",2312,1838,334,959,263,195,71,7,0,0,0,2,0,0,1,1832,6,474
"2904","대봉1동","관내사전투표","대통령선거","대구광역시","중구",1239,1239,335,543,147,151,51,5,1,0,0,0,0,1,0,1234,5,0
"2905","대봉1동","대봉1동제1투","대통령선거","대구광역시","중구",2338,1632,333,768,242,202,71,5,0,0,0,2,0,1,0,1624,8,706
"2906","대봉1동","대봉1동제2투","대통령선거","대구광역시","중구",2712,2044,326,1114,289,230,79,3,0,0,0,0,0,0,0,2041,3,668
"2907","대봉2동","관내사전투표","대통령선거","대구광역시","중구",396,396,111,169,50,43,17,1,0,0,0,0,0,1,1,393,3,0
"2908","대봉2동","대봉2동제1투","대통령선거","대구광역시","중구",1030,658,115,350,98,67,23,2,0,0,0,0,0,0,0,655,3,372
"2909","대봉2동","대봉2동제2투","대통령선거","대구광역시","중구",1136,799,115,472,99,83,20,1,0,0,0,1,0,3,0,794,5,337
"2910","잘못 투입·구분된 투표지","잘못 투입·구분된 투표지","대통령선거","대구광역시","중구",0,0,0,0,0,0,0,0,0,0,0,0,0,0,0,0,0,0
"2911","거소·선상투표","거소·선상투표","대통령선거","대구광역시","동구",784,742,180,188,146,95,23,8,6,4,2,3,7,4,8,674,68,42
"2912","관외사전투표","관외사전투표","대통령선거","대구광역시","동구",22808,22806,6656,6881,3655,3915,1405,49,7,7,2,17,9,10,45,22658,148,2
"2913","재외투표","재외투표","대통령선거","대구광역시","동구",1312,971,509,84,172,76,110,10,0,1,0,2,1,0,1,966,5,341
"2914","신암1동","관내사전투표","대통령선거","대구광역시","동구",1462,1462,305,707,192,187,56,2,1,0,0,2,1,2,1,1456,6,0
"2915","신암1동","신암1동제1투","대통령선거","대구광역시","동구",2189,1287,183,775,160,110,44,4,0,1,0,0,1,1,5,1284,3,902
"2916","신암1동","신암1동제2투","대통령선거","대구광역시","동구",2578,1900,298,1067,260,198,61,4,2,1,0,0,0,2,0,1893,7,678
"2917","신암1동","신암1동제3투","대통령선거","대구광역시","동구",3035,2113,263,1283,254,219,60,15,1,0,0,0,1,3,2,2101,12,922
"2918","신암2동","관내사전투표","대통령선거","대구광역시","동구",1848,1848,511,680,276,265,98,6,0,0,2,1,0,4,1,1844,4,0
"2919","신암2동","신암2동제1투","대통령선거","대구광역시","동구",2810,2061,459,858,341,304,85,2,1,1,1,0,0,2,3,2057,4,749
"2920","신암2동","신암2동제2투","대통령선거","대구광역시","동구",2338,1582,287,778,232,203,66,4,1,0,0,1,0,0,0,1572,10,756
"2921","신암2동","신암2동제3투","대통령선거","대구광역시","동구",2407,1873,320,939,301,231,61,9,0,0,0,0,0,1,1,1863,10,534
"2922","신암3동","관내사전투표","대통령선거","대구광역시","동구",1193,1193,280,592,137,129,45,4,0,1,0,0,0,0,1,1189,4,0
"2923","신암3동","신암3동제1투","대통령선거","대구광역시","동구",2546,1770,280,903,255,244,76,2,0,0,0,0,0,0,0,1760,10,776
"2924","신암3동","신암3동제2투","대통령선거","대구광역시","동구",2670,1650,279,929,191,188,45,3,0,1,1,3,1,1,2,1644,6,1020
"2925","신암4동","관내사전투표","대통령선거","대구광역시","동구",1959,1959,472,886,259,232,94,3,0,1,0,0,0,0,0,1947,12,0
"2926","신암4동","신암4동제1투","대통령선거","대구광역시","동구",3259,1903,322,973,292,219,80,7,0,1,0,0,0,1,1,1896,7,1356
"2927","신암4동","신암4동제2투","대통령선거","대구광역시","동구",2735,1808,254,1044,248,193,50,7,1,1,1,0,0,1,1,1801,7,927
"2928","신암4동","신암4동제3투","대통령선거","대구광역시","동구",2601,1815,280,995,220,229,78,1,0,2,0,1,0,1,1,1808,7,786
"2929","신암4동","신암4동제4투","대통령선거","대구광역시","동구",3220,2056,336,1090,287,241,83,7,1,1,0,1,1,1,0,2049,7,1164
"2930","신암5동","관내사전투표","대통령선거","대구광역시","동구",2091,2091,550,821,240,345,114,4,0,0,0,3,2,1,2,2082,9,0
"2931","신암5동","신암5동제1투","대통령선거","대구광역시","동구",2679,1807,264,1042,233,199,59,0,0,2,0,1,0,0,0,1800,7,872
"2932","신암5동","신암5동제2투","대통령선거","대구광역시","동구",2736,1874,271,1047,249,226,67,4,0,0,0,1,0,0,1,1866,8,862
"2933","신천1·2동","관내사전투표","대통령선거","대구광역시","동구",1724,1724,452,689,255,202,111,5,1,1,1,1,0,0,1,1719,5,0
"2934","신천1·2동","신천1·2동제1투","대통령선거","대구광역시","동구",2118,1614,313,789,254,172,68,5,1,0,0,4,0,2,0,1608,6,504
"2935","신천1·2동","신천1·2동제2투","대통령선거","대구광역시","동구",2169,1594,321,761,239,203,57,4,0,0,0,0,0,1,0,1586,8,575
"2936","신천1·2동","신천1·2동제3투","대통령선거","대구광역시","동구",2185,1499,227,884,182,136,57,2,1,0,0,0,0,3,1,1493,6,686
"2937","신천1·2동","신천1·2동제4투","대통령선거","대구광역시","동구",2805,2257,535,958,339,313,100,4,0,0,0,0,0,1,0,2250,7,548
"2938","신천3동","관내사전투표","대통령선거","대구광역시","동구",1602,1602,432,659,214,222,64,5,0,1,1,1,0,0,0,1599,3,0
"2939","신천3동","신천3동제1투","대통령선거","대구광역시","동구",1423,887,126,490,128,89,44,3,0,0,0,2,0,1,0,883,4,536
"2940","신천3동","신천3동제2투","대통령선거","대구광역시","동구",3232,2410,461,1137,361,329,96,10,0,1,0,0,1,3,0,2399,11,822
"2941","신천3동","신천3동제3투","대통령선거","대구광역시","동구",3012,2176,369,1079,345,276,89,3,0,0,1,0,1,3,1,2167,9,836
"2942","신천4동","관내사전투표","대통령선거","대구광역시","동구",1479,1479,347,667,185,186,78,5,0,1,1,0,1,1,1,1473,6,0
"2943","신천4동","신천4동제1투","대통령선거","대구광역시","동구",1706,1156,162,640,162,145,38,2,0,1,1,1,0,0,0,1152,4,550
"2944","신천4동","신천4동제2투","대통령선거","대구광역시","동구",2649,1607,364,737,229,178,87,4,0,0,0,1,0,0,2,1602,5,1042
"2945","신천4동","신천4동제3투","대통령선거","대구광역시","동구",1917,1287,174,764,177,134,30,2,0,0,0,0,0,1,1,1283,4,630
"2946","효목1동","관내사전투표","대통령선거","대구광역시","동구",1422,1422,341,664,164,181,63,3,0,0,0,1,0,0,2,1419,3,0
"2947","효목1동","효목1동제1투","대통령선거","대구광역시","동구",1775,1223,171,679,174,142,42,6,0,2,1,0,0,2,1,1220,3,552
"2948","효목1동","효목1동제2투","대통령선거","대구광역시","동구",1968,1390,215,778,191,148,43,1,1,1,2,1,0,0,1,1382,8,578
"2949","효목1동","효목1동제3투","대통령선거","대구광역시","동구",1978,1297,193,747,166,140,38,5,0,0,0,2,0,0,1,1292,5,681
"2950","효목1동","효목1동제4투","대통령선거","대구광역시","동구",2630,2024,353,980,321,278,76,4,1,2,1,0,1,2,2,2021,3,606
"2951","효목1동","효목1동제5투","대통령선거","대구광역시","동구",2259,1422,201,813,179,167,44,2,0,0,0,4,0,3,2,1415,7,837
"2952","효목2동","관내사전투표","대통령선거","대구광역시","동구",2130,2130,539,974,258,259,84,5,0,0,0,0,0,1,0,2120,10,0
"2953","효목2동","효목2동제1투","대통령선거","대구광역시","동구",1613,1037,157,585,150,110,29,1,0,0,0,2,0,0,0,1034,3,576
"2954","효목2동","효목2동제2투","대통령선거","대구광역시","동구",2445,1620,270,860,205,204,63,4,1,1,0,1,0,0,3,1612,8,825
"2955","효목2동","효목2동제3투","대통령선거","대구광역시","동구",1953,1221,189,717,139,126,39,3,0,1,0,0,0,1,1,1216,5,732
"2956","효목2동","효목2동제4투","대통령선거","대구광역시","동구",1680,1191,203,693,136,113,37,3,0,1,0,0,0,1,0,1187,4,489
"2957","효목2동","효목2동제5투","대통령선거","대구광역시","동구",2961,2318,526,977,374,340,88,3,0,1,0,1,0,1,1,2312,6,643
"2958","도평동","관내사전투표","대통령선거","대구광역시","동구",581,581,120,250,69,108,31,1,0,0,0,0,0,0,0,579,2,0
"2959","도평동","도평동제1투","대통령선거","대구광역시","동구",2003,1437,164,802,173,238,45,2,0,1,0,0,3,1,2,1431,6,566
"2960","도평동","도평동제2투","대통령선거","대구광역시","동구",941,650,114,318,87,113,15,0,0,0,0,0,1,0,0,648,2,291
"2961","불로·봉무동","관내사전투표","대통령선거","대구광역시","동구",2061,2061,485,797,236,420,104,8,0,0,0,1,0,0,1,2052,9,0
"2962","불로·봉무동","불로·봉무동제1투","대통령선거","대구광역시","동구",2401,1618,229,831,192,261,73,13,2,2,0,1,0,0,4,1608,10,783
"2963","불로·봉무동","불로·봉무동제2투","대통령선거","대구광역시","동구",2632,2056,383,946,301,343,70,4,0,0,0,0,0,2,1,2050,6,576
"2964","불로·봉무동","불로·봉무동제3투","대통령선거","대구광역시","동구",2089,1390,198,769,142,214,49,2,1,0,2,0,0,3,1,1381,9,699
"2965","불로·봉무동","불로·봉무동제4투","대통령선거","대구광역시","동구",3485,2540,411,1233,350,412,106,5,0,0,3,4,2,2,4,2532,8,945
"2966","불로·봉무동","불로·봉무동제5투","대통령선거","대구광역시","동구",3073,2533,673,825,417,493,105,8,0,0,0,0,1,2,2,2526,7,540
"2967","불로·봉무동","불로·봉무동제6투","대통령선거","대구광역시","동구",2713,2173,507,775,372,436,71,4,0,1,0,0,0,1,0,2167,6,540
"2968","지저동","관내사전투표","대통령선거","대구광역시","동구",1594,1594,355,715,176,250,78,6,0,1,1,1,0,0,2,1585,9,0
"2969","지저동","지저동제1투","대통령선거","대구광역시","동구",2994,1977,287,1040,264,287,79,7,1,0,0,2,2,0,0,1969,8,1017
"2970","지저동","지저동제2투","대통령선거","대구광역시","동구",2723,1830,229,1047,209,264,63,8,0,0,1,0,0,1,0,1822,8,893
"2971","지저동","지저동제3투","대통령선거","대구광역시","동구",1788,1250,187,666,163,188,38,2,0,1,0,1,1,2,0,1249,1,538
"2972","동촌동","관내사전투표","대통령선거","대구광역시","동구",2059,2059,451,878,231,387,88,8,0,1,1,2,1,0,3,2051,8,0
"2973","동촌동","동촌동제1투","대통령선거","대구광역시","동구",2272,1474,234,811,178,189,45,4,0,1,0,2,0,2,2,1468,6,798
"2974","동촌동","동촌동제2투","대통령선거","대구광역시","동구",2774,1756,263,927,247,252,46,8,0,0,1,1,1,1,3,1750,6,1018
"2975","동촌동","동촌동제3투","대통령선거","대구광역시","동구",2681,1835,274,948,247,281,68,2,0,0,0,0,0,1,2,1823,12,846
"2976","동촌동","동촌동제4투","대통령선거","대구광역시","동구",2692,1704,251,864,217,296,54,4,0,1,1,1,1,2,1,1693,11,988
"2977","방촌동","관내사전투표","대통령선거","대구광역시","동구",2835,2835,639,1143,323,574,136,6,0,0,0,2,0,1,1,2825,10,0
"2978","방촌동","방촌동제1투","대통령선거","대구광역시","동구",2113,1592,250,793,192,267,71,9,1,0,0,0,0,1,0,1584,8,521
"2979","방촌동","방촌동제2투","대통령선거","대구광역시","동구",2186,1479,227,760,184,236,62,3,0,1,0,1,0,2,0,1476,3,707
"2980","방촌동","방촌동제3투","대통령선거","대구광역시","동구",2121,1423,200,709,182,259,54,3,0,0,0,1,0,2,2,1412,11,698
"2981","방촌동","방촌동제4투","대통령선거","대구광역시","동구",2710,2233,390,1060,296,397,71,6,0,3,0,0,0,0,1,2224,9,477
"2982","방촌동","방촌동제5투","대통령선거","대구광역시","동구",1984,1573,289,743,182,294,52,7,0,0,0,1,0,0,0,1568,5,411
"2983","방촌동","방촌동제6투","대통령선거","대구광역시","동구",1915,1395,234,685,166,258,38,1,0,1,0,0,0,1,1,1385,10,520
"2984","해안동","관내사전투표","대통령선거","대구광역시","동구",2410,2410,543,936,359,440,101,5,0,3,1,3,2,7,0,2400,10,0
"2985","해안동","해안동제1투","대통령선거","대구광역시","동구",2909,1965,268,1032,256,323,61,9,1,2,0,1,1,2,3,1959,6,944
"2986","해안동","해안동제2투","대통령선거","대구광역시","동구",2195,1410,198,780,159,225,39,2,0,0,0,0,0,2,0,1405,5,785
"2987","해안동","해안동제3투","대통령선거","대구광역시","동구",2364,1520,243,816,183,222,43,2,0,2,0,1,0,3,0,1515,5,844
"2988","해안동","해안동제4투","대통령선거","대구광역시","동구",1597,1082,163,535,165,178,31,0,0,0,0,0,0,4,2,1078,4,515
"2989","해안동","해안동제5투","대통령선거","대구광역시","동구",2076,1416,186,777,164,219,51,6,1,0,0,0,0,1,1,1406,10,660
"2990","안심1동","관내사전투표","대통령선거","대구광역시","동구",3815,3814,1116,1336,441,713,181,7,0,5,2,4,1,0,2,3808,6,1
"2991","안심1동","안심1동제1투","대통령선거","대구광역시","동구",3266,2048,288,1078,249,341,73,6,0,0,0,1,1,2,0,2039,9,1218
"2992","안심1동","안심1동제2투","대통령선거","대구광역시","동구",2057,1333,224,655,162,230,54,4,0,0,0,0,0,1,1,1331,2,724
"2993","안심1동","안심1동제3투","대통령선거","대구광역시","동구",3068,1965,349,935,261,326,75,5,0,1,0,0,0,1,3,1956,9,1103
"2994","안심1동","안심1동제4투","대통령선거","대구광역시","동구",3119,2189,318,1081,307,359,95,12,0,2,0,4,0,2,0,2180,9,930
"2995","안심1동","안심1동제5투","대통령선거","대구광역시","동구",2869,2006,422,847,324,298,84,8,2,1,1,1,0,2,1,1991,15,863
"2996","안심1동","안심1동제6투","대통령선거","대구광역시","동구",2508,1683,298,797,232,283,51,8,1,2,0,0,0,1,1,1674,9,825
"2997","안심1동","안심1동제7투","대통령선거","대구광역시","동구",3094,2252,491,976,317,361,89,4,0,0,1,2,0,0,1,2242,10,842
"2998","안심1동","안심1동제8투","대통령선거","대구광역시","동구",3561,2671,655,929,415,552,101,3,0,0,0,3,1,1,2,2662,9,890
"2999","안심1동","안심1동제9투","대통령선거","대구광역시","동구",3221,2591,716,861,433,460,94,12,0,0,1,6,0,1,0,2584,7,630
"3000","안심1동","안심1동제10투","대통령선거","대구광역시","동구",3095,2419,612,831,381,494,92,2,0,0,0,0,2,0,1,2415,4,676
"3001","안심2동","관내사전투표","대통령선거","대구광역시","동구",1473,1473,357,531,202,322,51,3,0,0,1,0,0,3,0,1470,3,0
"3002","안심2동","안심2동제1투","대통령선거","대구광역시","동구",3194,2101,364,1001,269,378,70,6,0,0,0,0,0,1,2,2091,10,1093
"3003","안심2동","안심2동제2투","대통령선거","대구광역시","동구",2670,2081,311,1088,242,367,52,1,0,3,0,1,0,3,2,2070,11,589
"3004","안심2동","안심2동제3투","대통령선거","대구광역시","동구",1684,1050,133,581,128,160,34,3,0,0,0,1,1,3,2,1046,4,634
"3005","안심3·4동","관내사전투표","대통령선거","대구광역시","동구",5066,5066,1617,1468,657,958,282,13,3,3,1,7,1,2,3,5015,51,0
"3006","안심3·4동","안심3·4동제1투","대통령선거","대구광역시","동구",2313,1438,195,756,169,247,57,2,0,0,0,1,1,0,2,1430,8,875
"3007","안심3·4동","안심3·4동제2투","대통령선거","대구광역시","동구",3323,2334,456,1020,309,450,83,0,0,0,0,5,0,3,1,2327,7,989
"3008","안심3·4동","안심3·4동제3투","대통령선거","대구광역시","동구",3411,2576,552,1028,384,481,112,9,0,0,0,2,0,1,1,2570,6,835
"3009","안심3·4동","안심3·4동제4투","대통령선거","대구광역시","동구",3578,2627,639,918,387,566,105,3,0,0,3,0,0,1,1,2623,4,951
"3010","안심3·4동","안심3·4동제5투","대통령선거","대구광역시","동구",3703,2696,465,1268,339,482,122,4,0,1,1,2,0,0,1,2685,11,1007
"3011","안심3·4동","안심3·4동제6투","대통령선거","대구광역시","동구",3073,2305,500,886,353,456,96,6,0,0,0,1,1,2,2,2303,2,768
"3012","안심3·4동","안심3·4동제7투","대통령선거","대구광역시","동구",2820,2073,597,599,334,403,124,6,0,0,0,1,0,2,2,2068,5,747
"3013","안심3·4동","안심3·4동제8투","대통령선거","대구광역시","동구",3061,2312,706,704,321,439,110,21,0,0,0,1,0,1,1,2304,8,749
"3014","안심3·4동","안심3·4동제9투","대통령선거","대구광역시","동구",3613,2839,742,915,464,560,135,15,0,0,0,0,0,0,2,2833,6,774
"3015","안심3·4동","안심3·4동제10투","대통령선거","대구광역시","동구",3723,2881,743,924,442,613,135,8,0,1,0,3,2,2,0,2873,8,842
"3016","안심3·4동","안심3·4동제11투","대통령선거","대구광역시","동구",2654,2172,805,459,317,458,126,3,0,0,0,0,1,0,0,2169,3,482
"3017","안심3·4동","안심3·4동제12투","대통령선거","대구광역시","동구",2213,1516,369,591,222,213,97,12,0,2,0,0,0,0,2,1508,8,697
"3018","공산동","관내사전투표","대통령선거","대구광역시","동구",1898,1898,415,814,249,336,67,1,0,0,1,1,0,1,6,1891,7,0
"3019","공산동","공산동제1투","대통령선거","대구광역시","동구",2557,1659,155,980,162,291,47,6,0,0,0,1,3,6,1,1652,7,898
"3020","공산동","공산동제2투","대통령선거","대구광역시","동구",3054,2281,356,1187,304,350,70,6,0,2,0,0,0,0,0,2275,6,773
"3021","공산동","공산동제3투","대통령선거","대구광역시","동구",2912,2185,415,1009,283,389,76,2,0,1,0,0,1,5,3,2184,1,727
"3022","공산동","공산동제4투","대통령선거","대구광역시","동구",1542,967,124,619,83,118,6,4,0,0,0,0,1,2,3,960,7,575
"3023","잘못 투입·구분된 투표지","잘못 투입·구분된 투표지","대통령선거","대구광역시","동구",0,0,0,0,0,0,0,0,0,0,0,0,0,0,0,0,0,0
"3024","거소·선상투표","거소·선상투표","대통령선거","대구광역시","서구",306,293,72,87,76,36,7,1,0,1,0,2,0,0,1,283,10,13
"3025","관외사전투표","관외사전투표","대통령선거","대구광역시","서구",11530,11528,3063,3986,1986,1516,781,29,3,10,1,9,5,8,30,11427,101,2
"3026","재외투표","재외투표","대통령선거","대구광역시","서구",596,428,230,44,81,27,42,4,0,0,0,0,0,0,0,428,0,168
"3027","내당1동","관내사전투표","대통령선거","대구광역시","서구",1536,1536,353,730,200,168,64,6,0,0,0,1,0,3,3,1528,8,0
"3028","내당1동","내당1동제1투","대통령선거","대구광역시","서구",2602,1712,258,968,229,180,63,1,1,1,0,2,0,0,1,1704,8,890
"3029","내당1동","내당1동제2투","대통령선거","대구광역시","서구",2746,1678,281,922,212,176,72,4,0,0,0,0,2,0,3,1672,6,1068
"3030","내당1동","내당1동제3투","대통령선거","대구광역시","서구",2247,1530,193,902,203,158,56,2,0,2,0,0,2,2,1,1521,9,717
"3031","내당2·3동","관내사전투표","대통령선거","대구광역시","서구",1191,1191,249,598,133,136,58,1,0,1,0,0,0,2,2,1180,11,0
"3032","내당2·3동","내당2·3동제1투","대통령선거","대구광역시","서구",2707,1735,289,1018,222,118,71,6,1,1,0,0,1,0,2,1729,6,972
"3033","내당2·3동","내당2·3동제2투","대통령선거","대구광역시","서구",2527,1679,225,1024,197,149,64,3,1,2,1,0,1,2,1,1670,9,848
"3034","내당2·3동","내당2·3동제3투","대통령선거","대구광역시","서구",2736,1953,275,1118,305,190,54,2,0,1,0,0,0,1,0,1946,7,783
"3035","내당4동","관내사전투표","대통령선거","대구광역시","서구",2318,2318,547,1066,316,248,121,3,0,1,1,2,1,0,1,2307,11,0
"3036","내당4동","내당4동제1투","대통령선거","대구광역시","서구",2114,1448,277,758,199,146,59,1,0,1,1,3,0,1,1,1447,1,666
"3037","내당4동","내당4동제2투","대통령선거","대구광역시","서구",2490,1688,299,942,195,183,57,5,0,0,0,1,0,1,0,1683,5,802
"3038","내당4동","내당4동제3투","대통령선거","대구광역시","서구",2911,2136,373,1119,274,256,91,6,0,0,1,1,0,1,5,2127,9,775
"3039","내당4동","내당4동제4투","대통령선거","대구광역시","서구",2251,1545,241,850,224,146,71,3,0,0,0,0,2,2,2,1541,4,706
"3040","내당4동","내당4동제5투","대통령선거","대구광역시","서구",2508,1673,274,903,243,176,68,2,0,0,0,0,0,1,1,1668,5,835
"3041","비산1동","관내사전투표","대통령선거","대구광역시","서구",1580,1580,260,891,233,105,67,3,0,0,0,2,0,3,1,1565,15,0
"3042","비산1동","비산1동제1투","대통령선거","대구광역시","서구",2287,1397,194,811,205,116,49,3,1,0,0,0,1,0,1,1381,16,890
"3043","비산1동","비산1동제2투","대통령선거","대구광역시","서구",1970,1221,178,695,180,114,41,0,1,0,1,0,0,5,2,1217,4,749
"3044","비산1동","비산1동제3투","대통령선거","대구광역시","서구",1691,1091,154,642,164,86,33,1,0,1,0,0,1,1,3,1086,5,600
"3045","비산1동","비산1동제4투","대통령선거","대구광역시","서구",1761,1200,159,721,165,98,39,3,0,0,1,4,0,1,6,1197,3,561
"3046","비산2·3동","관내사전투표","대통령선거","대구광역시","서구",1379,1379,219,795,169,127,54,4,0,1,0,0,0,3,1,1373,6,0
"3047","비산2·3동","비산2·3동제1투","대통령선거","대구광역시","서구",2568,1738,239,1072,212,136,62,4,0,0,0,0,0,2,1,1728,10,830
"3048","비산2·3동","비산2·3동제2투","대통령선거","대구광역시","서구",2523,1618,196,983,223,133,65,6,0,2,1,0,0,3,1,1613,5,905
"3049","비산2·3동","비산2·3동제3투","대통령선거","대구광역시","서구",2601,1455,177,907,197,105,52,3,0,0,0,1,0,3,2,1447,8,1146
"3050","비산4동","관내사전투표","대통령선거","대구광역시","서구",1116,1116,225,563,157,108,52,3,0,0,1,1,1,1,0,1112,4,0
"3051","비산4동","비산4동제1투","대통령선거","대구광역시","서구",2679,1758,253,1005,233,159,85,7,1,1,0,1,0,1,2,1748,10,921
"3052","비산4동","비산4동제2투","대통령선거","대구광역시","서구",2359,1537,211,871,222,146,66,4,1,0,0,1,0,1,6,1529,8,822
"3053","비산4동","비산4동제3투","대통령선거","대구광역시","서구",2642,1922,259,1112,266,187,76,3,1,1,0,2,1,1,2,1911,11,720
"3054","비산5동","관내사전투표","대통령선거","대구광역시","서구",1271,1271,215,738,160,99,38,1,0,2,0,1,0,3,1,1258,13,0
"3055","비산5동","비산5동제1투","대통령선거","대구광역시","서구",2294,1474,197,898,186,130,44,4,2,2,1,2,0,3,0,1469,5,820
"3056","비산5동","비산5동제2투","대통령선거","대구광역시","서구",2521,1595,219,975,198,135,54,1,0,0,1,0,1,3,1,1588,7,926
"3057","비산6동","관내사전투표","대통령선거","대구광역시","서구",1276,1276,232,679,190,115,52,0,0,0,0,1,1,2,0,1272,4,0
"3058","비산6동","비산6동제1투","대통령선거","대구광역시","서구",2935,1912,269,1126,261,153,84,2,0,0,0,1,0,3,8,1907,5,1023
"3059","비산6동","비산6동제2투","대통령선거","대구광역시","서구",2976,2019,291,1198,291,145,78,3,1,0,0,0,0,1,2,2010,9,957
"3060","비산7동","관내사전투표","대통령선거","대구광역시","서구",1307,1307,218,760,153,106,51,3,0,1,0,0,1,5,4,1302,5,0
"3061","비산7동","비산7동제1투","대통령선거","대구광역시","서구",1937,1107,143,705,143,75,28,3,0,0,1,0,0,2,0,1100,7,830
"3062","비산7동","비산7동제2투","대통령선거","대구광역시","서구",2117,1484,192,903,201,114,54,4,0,0,1,2,3,2,2,1478,6,633
"3063","비산7동","비산7동제3투","대통령선거","대구광역시","서구",2316,1428,188,848,203,130,48,1,0,0,0,1,0,0,2,1421,7,888
"3064","비산7동","비산7동제4투","대통령선거","대구광역시","서구",2595,1752,238,1092,229,125,47,2,0,2,0,3,1,1,3,1743,9,843
"3065","평리1동","관내사전투표","대통령선거","대구광역시","서구",1330,1330,229,766,163,112,47,2,0,0,0,1,0,2,2,1324,6,0
"3066","평리1동","평리1동제1투","대통령선거","대구광역시","서구",1906,1276,205,760,167,95,33,4,0,1,0,0,1,0,0,1266,10,630
"3067","평리1동","평리1동제2투","대통령선거","대구광역시","서구",2038,1286,176,725,217,108,49,1,0,0,2,0,1,1,3,1283,3,752
"3068","평리1동","평리1동제3투","대통령선거","대구광역시","서구",2105,1326,189,773,190,115,47,3,1,0,0,0,0,0,2,1320,6,779
"3069","평리2동","관내사전투표","대통령선거","대구광역시","서구",1453,1453,343,664,195,163,76,0,0,1,1,1,0,0,1,1445,8,0
"3070","평리2동","평리2동제1투","대통령선거","대구광역시","서구",3370,2434,458,1194,380,294,88,5,0,2,0,1,1,2,0,2425,9,936
"3071","평리2동","평리2동제2투","대통령선거","대구광역시","서구",2442,1604,243,948,222,114,63,1,2,1,0,1,0,2,2,1599,5,838
"3072","평리3동","관내사전투표","대통령선거","대구광역시","서구",2040,2040,500,935,264,206,116,3,1,2,0,2,0,0,5,2034,6,0
"3073","평리3동","평리3동제1투","대통령선거","대구광역시","서구",2378,1414,212,799,204,135,51,5,0,0,1,1,1,1,1,1411,3,964
"3074","평리3동","평리3동제2투","대통령선거","대구광역시","서구",2416,1556,201,944,205,131,60,4,0,3,0,0,1,1,5,1555,1,860
"3075","평리3동","평리3동제3투","대통령선거","대구광역시","서구",2194,1424,187,857,190,128,50,2,0,0,1,0,0,1,3,1419,5,770
"3076","평리3동","평리3동제4투","대통령선거","대구광역시","서구",2133,1458,219,809,195,168,61,1,0,0,0,1,0,0,1,1455,3,675
"3077","평리4동","관내사전투표","대통령선거","대구광역시","서구",2021,2021,462,976,247,223,98,3,0,1,0,1,0,2,2,2015,6,0
"3078","평리4동","평리4동제1투","대통령선거","대구광역시","서구",3391,2354,446,1113,391,287,98,8,0,0,0,0,1,2,1,2347,7,1037
"3079","평리4동","평리4동제2투","대통령선거","대구광역시","서구",3056,2012,290,1170,277,170,88,6,0,0,0,0,1,0,1,2003,9,1044
"3080","평리4동","평리4동제3투","대통령선거","대구광역시","서구",3034,2121,319,1146,300,220,100,8,0,3,1,1,0,1,1,2100,21,913
"3081","평리4동","평리4동제4투","대통령선거","대구광역시","서구",3370,2322,412,1247,342,200,95,6,1,1,0,2,1,0,0,2307,15,1048
"3082","평리5동","관내사전투표","대통령선거","대구광역시","서구",1039,1039,171,591,131,87,49,1,0,0,0,0,0,0,1,1031,8,0
"3083","평리5동","평리5동제1투","대통령선거","대구광역시","서구",2197,1420,183,840,187,144,42,6,0,0,1,3,0,2,3,1411,9,777
"3084","평리5동","평리5동제2투","대통령선거","대구광역시","서구",2394,1591,238,962,211,118,47,3,0,2,2,0,1,0,0,1584,7,803
"3085","평리6동","관내사전투표","대통령선거","대구광역시","서구",901,901,168,479,116,94,34,1,0,0,0,0,1,3,1,897,4,0
"3086","평리6동","평리6동제1투","대통령선거","대구광역시","서구",2077,1368,175,866,162,88,61,2,1,1,1,0,1,0,1,1359,9,709
"3087","평리6동","평리6동제2투","대통령선거","대구광역시","서구",1878,1249,156,776,151,111,42,2,0,2,1,1,0,1,2,1245,4,629
"3088","평리6동","평리6동제3투","대통령선거","대구광역시","서구",1748,1117,152,678,132,81,56,3,1,2,0,0,0,1,1,1107,10,631
"3089","상중이동","관내사전투표","대통령선거","대구광역시","서구",1912,1912,460,858,291,166,114,5,0,1,1,3,0,2,2,1903,9,0
"3090","상중이동","상중이동제1투","대통령선거","대구광역시","서구",1352,660,108,354,95,71,26,1,0,0,0,0,1,0,0,656,4,692
"3091","상중이동","상중이동제2투","대통령선거","대구광역시","서구",2898,2071,282,1223,259,198,83,9,0,3,0,2,0,0,4,2063,8,827
"3092","상중이동","상중이동제3투","대통령선거","대구광역시","서구",2852,2052,363,1108,277,210,77,5,0,2,1,1,0,0,2,2046,6,800
"3093","상중이동","상중이동제4투","대통령선거","대구광역시","서구",2484,1809,296,971,268,183,77,2,1,0,0,2,3,2,0,1805,4,675
"3094","상중이동","상중이동제5투","대통령선거","대구광역시","서구",3645,2982,627,1388,431,381,127,7,1,1,0,4,0,1,2,2970,12,663
"3095","상중이동","상중이동제6투","대통령선거","대구광역시","서구",613,405,54,259,52,29,8,1,0,1,0,0,0,0,0,404,1,208
"3096","상중이동","상중이동제7투","대통령선거","대구광역시","서구",666,459,56,297,46,25,12,0,0,1,0,3,4,0,4,448,11,207
"3097","원대동","관내사전투표","대통령선거","대구광역시","서구",896,896,168,501,108,72,35,0,1,1,1,0,0,2,1,890,6,0
"3098","원대동","원대동제1투","대통령선거","대구광역시","서구",2370,1491,185,927,194,132,32,3,0,2,0,3,0,6,0,1484,7,879
"3099","원대동","원대동제2투","대통령선거","대구광역시","서구",2487,1736,262,1032,234,115,70,5,1,1,0,0,0,1,3,1724,12,751
"3100","원대동","원대동제3투","대통령선거","대구광역시","서구",2256,1362,184,821,178,129,43,1,0,0,0,0,0,1,2,1359,3,894
"3101","잘못 투입·구분된 투표지","잘못 투입·구분된 투표지","대통령선거","대구광역시","서구",0,0,0,0,0,0,0,0,0,0,0,0,0,0,0,0,0,0
"3102","거소·선상투표","거소·선상투표","대통령선거","대구광역시","남구",247,231,66,66,56,20,9,3,0,0,0,0,0,1,2,223,8,16
"3103","관외사전투표","관외사전투표","대통령선거","대구광역시","남구",11118,11116,3148,3753,1782,1508,764,32,2,6,4,9,2,2,19,11031,85,2
"3104","재외투표","재외투표","대통령선거","대구광역시","남구",685,514,281,48,77,44,53,8,0,0,0,0,0,0,1,512,2,171
"3105","이천동","관내사전투표","대통령선거","대구광역시","남구",1258,1258,330,542,171,149,58,2,0,0,0,0,1,1,1,1255,3,0
"3106","이천동","이천동제1투","대통령선거","대구광역시","남구",1569,917,146,536,112,78,37,1,0,0,0,0,1,0,0,911,6,652
"3107","이천동","이천동제2투","대통령선거","대구광역시","남구",2664,1921,346,985,324,192,62,3,0,0,1,2,0,1,0,1916,5,743
"3108","이천동","이천동제3투","대통령선거","대구광역시","남구",2895,2150,440,997,358,256,78,3,2,0,1,0,0,2,2,2139,11,745
"3109","이천동","이천동제4투","대통령선거","대구광역시","남구",2363,1742,304,918,241,195,67,5,1,1,0,2,0,0,2,1736,6,621
"3110","봉덕1동","관내사전투표","대통령선거","대구광역시","남구",1282,1282,323,603,154,135,57,4,0,0,0,0,0,1,1,1278,4,0
"3111","봉덕1동","봉덕1동제1투","대통령선거","대구광역시","남구",1781,1071,149,665,122,84,43,1,0,1,0,1,0,1,0,1067,4,710
"3112","봉덕1동","봉덕1동제2투","대통령선거","대구광역시","남구",2362,1660,247,880,272,181,67,7,0,0,1,1,0,0,1,1657,3,702
"3113","봉덕1동","봉덕1동제3투","대통령선거","대구광역시","남구",2451,1491,254,802,212,155,50,6,0,0,1,0,1,3,1,1485,6,960
"3114","봉덕2동","관내사전투표","대통령선거","대구광역시","남구",1108,1108,261,559,126,115,43,2,0,0,0,1,0,0,0,1107,1,0
"3115","봉덕2동","봉덕2동제1투","대통령선거","대구광역시","남구",1660,978,129,602,119,85,35,1,0,2,0,0,1,2,0,976,2,682
"3116","봉덕2동","봉덕2동제2투","대통령선거","대구광역시","남구",1558,1116,145,656,153,117,38,1,0,0,0,0,0,3,0,1113,3,442
"3117","봉덕2동","봉덕2동제3투","대통령선거","대구광역시","남구",2343,1678,269,943,229,160,53,5,1,1,1,1,1,2,1,1667,11,665
"3118","봉덕2동","봉덕2동제4투","대통령선거","대구광역시","남구",2399,1910,309,1066,243,224,53,5,0,0,0,0,1,1,1,1903,7,489
"3119","봉덕3동","관내사전투표","대통령선거","대구광역시","남구",1959,1959,450,977,236,186,95,3,1,1,1,1,1,0,2,1954,5,0
"3120","봉덕3동","봉덕3동제1투","대통령선거","대구광역시","남구",3478,1822,283,1018,260,171,69,7,0,0,0,3,0,3,2,1816,6,1656
"3121","봉덕3동","봉덕3동제2투","대통령선거","대구광역시","남구",3035,1846,285,1061,243,168,72,5,1,1,0,0,0,4,0,1840,6,1189
"3122","봉덕3동","봉덕3동제3투","대통령선거","대구광역시","남구",2082,1395,239,756,221,111,55,1,0,1,1,1,1,2,0,1389,6,687
"3123","봉덕3동","봉덕3동제4투","대통령선거","대구광역시","남구",2598,1989,334,1084,248,244,66,7,0,0,0,0,0,1,0,1984,5,609
"3124","대명1동","관내사전투표","대통령선거","대구광역시","남구",1576,1576,383,742,197,159,83,0,0,0,1,2,1,0,0,1568,8,0
"3125","대명1동","대명1동제1투","대통령선거","대구광역시","남구",2880,1899,298,995,306,190,91,3,0,1,0,2,0,1,0,1887,12,981
"3126","대명1동","대명1동제2투","대통령선거","대구광역시","남구",2254,1481,270,807,189,139,61,2,1,0,0,0,0,1,3,1473,8,773
"3127","대명1동","대명1동제3투","대통령선거","대구광역시","남구",3034,2136,399,1055,338,227,95,6,0,0,0,0,0,1,3,2124,12,898
"3128","대명2동","관내사전투표","대통령선거","대구광역시","남구",1291,1291,403,480,155,150,91,5,0,0,0,0,0,0,0,1284,7,0
"3129","대명2동","대명2동제1투","대통령선거","대구광역시","남구",2371,1477,315,685,205,188,70,7,0,0,1,2,0,0,0,1473,4,894
"3130","대명2동","대명2동제2투","대통령선거","대구광역시","남구",1732,1249,212,679,165,118,60,5,0,0,1,0,0,0,0,1240,9,483
"3131","대명2동","대명2동제3투","대통령선거","대구광역시","남구",2394,1652,295,886,267,145,45,1,0,1,0,0,0,0,2,1642,10,742
"3132","대명2동","대명2동제4투","대통령선거","대구광역시","남구",2136,1432,229,797,206,126,54,4,1,0,1,0,0,2,2,1422,10,704
"3133","대명3동","관내사전투표","대통령선거","대구광역시","남구",1471,1471,387,656,190,144,79,3,0,0,0,0,2,1,4,1466,5,0
"3134","대명3동","대명3동제1투","대통령선거","대구광역시","남구",2576,1548,260,833,232,142,70,2,0,0,0,1,2,1,0,1543,5,1028
"3135","대명3동","대명3동제2투","대통령선거","대구광역시","남구",2421,1528,278,837,198,131,69,5,0,2,1,0,1,0,2,1524,4,893
"3136","대명3동","대명3동제3투","대통령선거","대구광역시","남구",2177,1394,217,854,147,120,37,1,0,0,0,1,0,3,3,1383,11,783
"3137","대명3동","대명3동제4투","대통령선거","대구광역시","남구",2344,1502,242,875,201,108,53,5,2,1,0,0,1,4,2,1494,8,842
"3138","대명4동","관내사전투표","대통령선거","대구광역시","남구",1387,1387,325,662,178,136,72,4,0,0,0,0,0,2,3,1382,5,0
"3139","대명4동","대명4동제1투","대통령선거","대구광역시","남구",2826,1840,296,1022,240,188,71,5,0,2,0,0,1,4,1,1830,10,986
"3140","대명4동","대명4동제2투","대통령선거","대구광역시","남구",2205,1462,235,863,184,124,45,1,0,1,0,0,0,1,2,1456,6,743
"3141","대명4동","대명4동제3투","대통령선거","대구광역시","남구",1948,1337,184,829,160,106,39,3,0,1,0,1,2,4,2,1331,6,611
"3142","대명4동","대명4동제4투","대통령선거","대구광역시","남구",1190,752,139,391,101,74,35,3,0,0,0,1,0,2,0,746,6,438
"3143","대명5동","관내사전투표","대통령선거","대구광역시","남구",1056,1056,255,476,132,128,53,2,0,2,1,0,1,0,2,1052,4,0
"3144","대명5동","대명5동제1투","대통령선거","대구광역시","남구",1992,1269,247,645,193,106,62,6,1,0,0,0,0,1,1,1262,7,723
"3145","대명5동","대명5동제2투","대통령선거","대구광역시","남구",2269,1544,268,768,240,179,70,5,0,0,0,1,0,0,1,1532,12,725
"3146","대명5동","대명5동제3투","대통령선거","대구광역시","남구",1549,1032,191,537,156,103,38,2,0,1,0,1,0,1,1,1031,1,517
"3147","대명6동","관내사전투표","대통령선거","대구광역시","남구",1313,1313,328,585,159,148,79,7,0,0,0,0,0,3,1,1310,3,0
"3148","대명6동","대명6동제1투","대통령선거","대구광역시","남구",2128,1307,239,708,165,122,62,6,0,1,1,0,0,0,0,1304,3,821
"3149","대명6동","대명6동제2투","대통령선거","대구광역시","남구",2586,1797,314,943,257,195,67,6,0,1,0,1,0,2,1,1787,10,789
"3150","대명6동","대명6동제3투","대통령선거","대구광역시","남구",2195,1456,262,748,207,148,70,9,0,0,0,3,0,2,2,1451,5,739
"3151","대명9동","관내사전투표","대통령선거","대구광역시","남구",2521,2521,623,1110,345,289,129,11,0,2,0,1,0,1,2,2513,8,0
"3152","대명9동","대명9동제1투","대통령선거","대구광역시","남구",2813,1685,278,904,247,170,71,4,1,1,0,1,1,1,0,1679,6,1128
"3153","대명9동","대명9동제2투","대통령선거","대구광역시","남구",2214,1526,280,833,196,153,50,5,0,0,1,0,1,1,2,1522,4,688
"3154","대명9동","대명9동제3투","대통령선거","대구광역시","남구",2622,1614,348,756,236,187,78,3,0,0,0,0,0,1,2,1611,3,1008
"3155","대명9동","대명9동제4투","대통령선거","대구광역시","남구",2511,1504,301,747,221,148,73,4,0,1,0,0,0,0,1,1496,8,1007
"3156","대명10동","관내사전투표","대통령선거","대구광역시","남구",1147,1147,267,538,151,114,61,6,0,0,0,2,0,0,0,1139,8,0
"3157","대명10동","대명10동제1투","대통령선거","대구광역시","남구",2424,1565,280,793,243,178,57,3,0,0,1,0,2,1,1,1559,6,859
"3158","대명10동","대명10동제2투","대통령선거","대구광역시","남구",1996,1398,189,838,165,127,57,10,0,0,1,0,0,1,2,1390,8,598
"3159","대명10동","대명10동제3투","대통령선거","대구광역시","남구",2191,1440,233,817,203,114,61,3,0,2,0,0,1,0,2,1436,4,751
"3160","대명11동","관내사전투표","대통령선거","대구광역시","남구",1141,1141,232,593,142,108,52,3,1,0,0,0,0,3,0,1134,7,0
"3161","대명11동","대명11동제1투","대통령선거","대구광역시","남구",2371,1497,234,893,174,122,53,4,0,1,0,0,0,1,1,1483,14,874
"3162","대명11동","대명11동제2투","대통령선거","대구광역시","남구",1990,1289,185,799,148,101,42,4,0,0,1,0,0,1,1,1282,7,701
"3163","대명11동","대명11동제3투","대통령선거","대구광역시","남구",2069,1390,203,808,180,132,57,4,0,1,0,1,0,1,0,1387,3,679
"3164","잘못 투입·구분된 투표지","잘못 투입·구분된 투표지","대통령선거","대구광역시","남구",0,0,0,0,0,0,0,0,0,0,0,0,0,0,0,0,0,0
"3165","거소·선상투표","거소·선상투표","대통령선거","대구광역시","북구",872,836,219,209,217,104,15,8,3,4,2,3,1,4,10,799,37,36
"3166","관외사전투표","관외사전투표","대통령선거","대구광역시","북구",25746,25740,7702,7565,4452,3816,1819,56,10,6,11,10,13,7,62,25529,211,6
"3167","재외투표","재외투표","대통령선거","대구광역시","북구",1376,1022,510,96,173,82,149,4,0,0,0,1,0,1,0,1016,6,354
"3168","고성동","관내사전투표","대통령선거","대구광역시","북구",1032,1032,291,435,116,115,57,5,1,1,0,1,0,2,1,1025,7,0
"3169","고성동","고성동제1투","대통령선거","대구광역시","북구",1494,960,154,551,133,81,30,2,0,0,1,0,0,1,1,954,6,534
"3170","고성동","고성동제2투","대통령선거","대구광역시","북구",2419,1678,246,1012,212,125,63,2,2,1,0,1,0,1,2,1667,11,741
"3171","칠성동","관내사전투표","대통령선거","대구광역시","북구",1989,1989,523,904,228,233,84,7,0,0,0,3,1,1,3,1987,2,0
"3172","칠성동","칠성동제1투","대통령선거","대구광역시","북구",2530,1632,183,1087,173,117,50,6,0,1,1,0,1,3,1,1623,9,898
"3173","칠성동","칠성동제2투","대통령선거","대구광역시","북구",2676,2044,574,769,336,255,93,7,0,1,0,1,0,0,1,2037,7,632
"3174","칠성동","칠성동제3투","대통령선거","대구광역시","북구",2445,1639,289,849,245,186,52,4,0,1,0,0,1,5,0,1632,7,806
"3175","칠성동","칠성동제4투","대통령선거","대구광역시","북구",3347,2598,512,1222,381,365,91,8,1,1,1,3,0,0,3,2588,10,749
"3176","칠성동","칠성동제5투","대통령선거","대구광역시","북구",2910,2206,512,892,344,332,112,6,1,1,0,0,0,2,1,2203,3,704
"3177","침산1동","관내사전투표","대통령선거","대구광역시","북구",883,883,194,451,99,90,38,1,0,1,0,0,1,1,2,878,5,0
"3178","침산1동","침산1동제1투","대통령선거","대구광역시","북구",1732,1172,150,727,133,102,46,2,1,0,1,0,1,1,1,1165,7,560
"3179","침산1동","침산1동제2투","대통령선거","대구광역시","북구",1623,1041,159,637,126,81,28,0,0,0,0,1,1,1,3,1037,4,582
"3180","침산2동","관내사전투표","대통령선거","대구광역시","북구",2289,2289,699,823,315,313,112,8,1,0,1,1,1,2,4,2280,9,0
"3181","침산2동","침산2동제1투","대통령선거","대구광역시","북구",2629,2024,374,979,291,255,107,1,0,1,0,0,2,1,1,2012,12,605
"3182","침산2동","침산2동제2투","대통령선거","대구광역시","북구",3327,2357,497,1099,382,273,89,9,0,0,0,1,1,0,1,2352,5,970
"3183","침산2동","침산2동제3투","대통령선거","대구광역시","북구",3760,3029,705,1206,541,398,166,2,0,0,1,2,0,1,4,3026,3,731
"3184","침산3동","관내사전투표","대통령선거","대구광역시","북구",2723,2723,789,996,395,363,147,10,0,0,3,0,2,1,2,2708,15,0
"3185","침산3동","침산3동제1투","대통령선거","대구광역시","북구",3081,2200,395,1072,347,280,82,5,2,0,0,1,2,2,2,2190,10,881
"3186","침산3동","침산3동제2투","대통령선거","대구광역시","북구",3159,2337,409,1252,335,237,84,5,0,2,0,0,0,1,0,2325,12,822
"3187","침산3동","침산3동제3투","대통령선거","대구광역시","북구",3227,2466,501,1152,380,285,128,8,0,0,0,1,1,1,3,2460,6,761
"3188","침산3동","침산3동제4투","대통령선거","대구광역시","북구",3684,2951,621,1325,469,372,138,5,2,0,0,2,0,1,2,2937,14,733
"3189","노원동","관내사전투표","대통령선거","대구광역시","북구",1476,1476,284,837,175,121,49,0,0,0,0,2,0,1,1,1470,6,0
"3190","노원동","노원동제1투","대통령선거","대구광역시","북구",1626,1138,159,693,134,98,41,7,0,2,0,0,0,0,1,1135,3,488
"3191","노원동","노원동제2투","대통령선거","대구광역시","북구",2683,1773,236,1133,200,142,42,4,0,2,0,0,1,1,3,1764,9,910
"3192","노원동","노원동제3투","대통령선거","대구광역시","북구",2108,1496,169,942,190,130,51,3,1,0,1,0,0,0,1,1488,8,612
"3193","노원동","노원동제4투","대통령선거","대구광역시","북구",1353,797,69,561,87,52,20,2,1,0,0,0,0,0,1,793,4,556
"3194","산격1동","관내사전투표","대통령선거","대구광역시","북구",1230,1230,225,699,154,89,44,7,0,0,0,1,1,1,1,1222,8,0
"3195","산격1동","산격1동제1투","대통령선거","대구광역시","북구",2647,1832,243,1113,223,181,46,6,1,0,2,3,1,2,2,1823,9,815
"3196","산격1동","산격1동제2투","대통령선거","대구광역시","북구",2729,1949,309,1124,251,186,56,7,0,0,1,0,0,4,2,1940,9,780
"3197","산격1동","산격1동제3투","대통령선거","대구광역시","북구",2588,1527,199,914,211,133,45,10,1,3,0,0,0,3,1,1520,7,1061
"3198","산격2동","관내사전투표","대통령선거","대구광역시","북구",2298,2298,525,988,346,312,110,9,0,0,0,1,0,1,0,2292,6,0
"3199","산격2동","산격2동제1투","대통령선거","대구광역시","북구",2323,1695,294,880,241,212,55,1,0,0,1,4,0,2,2,1692,3,628
"3200","산격2동","산격2동제2투","대통령선거","대구광역시","북구",2283,1518,244,803,245,150,62,3,1,0,0,1,0,2,0,1511,7,765
"3201","산격2동","산격2동제3투","대통령선거","대구광역시","북구",2930,2259,413,1128,366,258,84,5,0,0,1,0,0,0,1,2256,3,671
"3202","산격3동","관내사전투표","대통령선거","대구광역시","북구",1494,1494,515,379,194,266,121,3,1,0,0,0,0,0,4,1483,11,0
"3203","산격3동","산격3동제1투","대통령선거","대구광역시","북구",2770,1752,406,777,246,213,87,3,1,1,0,2,2,2,1,1741,11,1018
"3204","산격3동","산격3동제2투","대통령선거","대구광역시","북구",3364,2255,346,1256,329,204,90,10,0,2,1,1,0,1,1,2241,14,1109
"3205","산격4동","관내사전투표","대통령선거","대구광역시","북구",1427,1427,342,626,209,178,64,3,0,1,0,0,0,1,0,1424,3,0
"3206","산격4동","산격4동제1투","대통령선거","대구광역시","북구",2137,1397,244,760,176,132,73,3,0,1,0,1,0,0,2,1392,5,740
"3207","산격4동","산격4동제2투","대통령선거","대구광역시","북구",2187,1483,201,855,216,141,60,3,0,0,0,2,1,1,0,1480,3,704
"3208","산격4동","산격4동제3투","대통령선거","대구광역시","북구",2200,1550,224,897,206,169,44,3,0,0,0,2,0,1,1,1547,3,650
"3209","복현1동","관내사전투표","대통령선거","대구광역시","북구",1472,1472,454,480,220,214,87,1,0,1,1,2,0,1,4,1465,7,0
"3210","복현1동","복현1동제1투","대통령선거","대구광역시","북구",2295,1446,275,725,190,161,75,0,0,2,0,1,0,4,2,1435,11,849
"3211","복현1동","복현1동제2투","대통령선거","대구광역시","북구",2425,1528,351,658,232,193,83,7,0,0,1,0,0,1,0,1526,2,897
"3212","복현2동","관내사전투표","대통령선거","대구광역시","북구",3069,3069,967,1030,431,448,160,9,0,0,1,2,1,1,0,3050,19,0
"3213","복현2동","복현2동제1투","대통령선거","대구광역시","북구",3457,2342,487,999,420,312,104,6,0,0,0,2,0,0,1,2331,11,1115
"3214","복현2동","복현2동제2투","대통령선거","대구광역시","북구",2736,1812,356,920,246,204,75,1,0,0,0,1,0,1,1,1805,7,924
"3215","복현2동","복현2동제3투","대통령선거","대구광역시","북구",3110,2381,663,921,382,287,115,3,2,0,0,1,1,1,1,2377,4,729
"3216","복현2동","복현2동제4투","대통령선거","대구광역시","북구",3556,2807,577,1373,398,322,113,3,1,2,2,6,0,1,3,2801,6,749
"3217","복현2동","복현2동제5투","대통령선거","대구광역시","북구",3605,2702,562,1181,423,392,118,5,0,1,0,1,1,1,2,2687,15,903
"3218","복현2동","복현2동제6투","대통령선거","대구광역시","북구",2850,2044,402,978,272,259,97,4,0,0,0,1,1,5,7,2026,18,806
"3219","대현동","관내사전투표","대통령선거","대구광역시","북구",2975,2975,787,1331,353,335,139,7,0,0,2,0,2,2,4,2962,13,0
"3220","대현동","대현동제1투","대통령선거","대구광역시","북구",2337,1369,236,719,185,158,54,2,1,0,1,0,0,3,1,1360,9,968
"3221","대현동","대현동제2투","대통령선거","대구광역시","북구",2339,1529,305,763,217,152,75,3,0,2,0,2,0,0,1,1520,9,810
"3222","대현동","대현동제3투","대통령선거","대구광역시","북구",2827,1839,334,893,307,205,81,3,0,3,0,0,2,1,0,1829,10,988
"3223","대현동","대현동제4투","대통령선거","대구광역시","북구",2857,2133,412,1087,293,261,65,2,0,0,1,1,1,0,2,2125,8,724
"3224","대현동","대현동제5투","대통령선거","대구광역시","북구",2061,1594,397,610,269,228,77,3,0,1,1,0,0,0,1,1587,7,467
"3225","검단동","관내사전투표","대통령선거","대구광역시","북구",916,916,234,415,119,100,40,0,0,0,0,0,1,0,0,909,7,0
"3226","검단동","검단동제1투","대통령선거","대구광역시","북구",2666,1770,255,1056,225,153,61,4,1,1,0,0,0,5,3,1764,6,896
"3227","검단동","검단동제2투","대통령선거","대구광역시","북구",2786,2080,364,1037,342,217,98,1,0,1,0,0,0,3,4,2067,13,706
"3228","무태조야동","관내사전투표","대통령선거","대구광역시","북구",3481,3481,1070,1284,439,472,198,6,0,1,0,1,2,0,1,3474,7,0
"3229","무태조야동","무태조야동제1투","대통령선거","대구광역시","북구",3337,2282,488,976,400,294,110,3,0,1,1,0,1,1,2,2277,5,1055
"3230","무태조야동","무태조야동제2투","대통령선거","대구광역시","북구",2545,1822,358,872,279,222,73,7,0,1,0,1,0,2,3,1818,4,723
"3231","무태조야동","무태조야동제3투","대통령선거","대구광역시","북구",2914,2044,457,891,335,257,95,6,0,0,0,0,0,0,0,2041,3,870
"3232","무태조야동","무태조야동제4투","대통령선거","대구광역시","북구",1992,1161,223,566,190,124,51,2,0,0,0,0,3,0,0,1159,2,831
"3233","무태조야동","무태조야동제5투","대통령선거","대구광역시","북구",2095,1586,361,670,261,217,71,0,0,0,0,0,1,3,0,1584,2,509
"3234","무태조야동","무태조야동제6투","대통령선거","대구광역시","북구",3428,2760,627,1174,427,400,122,4,0,1,0,1,0,0,2,2758,2,668
"3235","무태조야동","무태조야동제7투","대통령선거","대구광역시","북구",1364,970,112,608,126,74,37,1,0,0,0,0,0,4,2,964,6,394
"3236","관문동","관내사전투표","대통령선거","대구광역시","북구",2036,2036,529,880,292,218,100,2,1,2,0,1,0,2,0,2027,9,0
"3237","관문동","관문동제1투","대통령선거","대구광역시","북구",1904,1120,152,656,148,108,39,6,0,0,0,0,3,3,0,1115,5,784
"3238","관문동","관문동제2투","대통령선거","대구광역시","북구",2839,2233,509,905,372,311,109,9,1,0,0,2,1,0,2,2221,12,606
"3239","관문동","관문동제3투","대통령선거","대구광역시","북구",2518,1919,321,982,302,226,74,1,0,1,0,1,1,1,2,1912,7,599
"3240","관문동","관문동제4투","대통령선거","대구광역시","북구",2533,1957,311,1090,269,207,63,6,1,1,0,1,0,1,1,1951,6,576
"3241","관문동","관문동제5투","대통령선거","대구광역시","북구",834,595,70,382,66,52,17,1,0,0,0,0,1,2,0,591,4,239
"3242","관문동","관문동제6투","대통령선거","대구광역시","북구",2690,1928,561,704,319,228,103,4,0,0,0,0,0,0,2,1921,7,762
"3243","관문동","관문동제7투","대통령선거","대구광역시","북구",2366,1744,398,776,270,206,79,8,0,0,0,0,1,1,0,1739,5,622
"3244","관문동","관문동제8투","대통령선거","대구광역시","북구",2835,2130,528,843,364,286,97,0,0,0,0,1,0,0,4,2123,7,705
"3245","태전1동","관내사전투표","대통령선거","대구광역시","북구",2060,2060,573,711,312,287,155,6,0,1,0,4,0,1,3,2053,7,0
"3246","태전1동","태전1동제1투","대통령선거","대구광역시","북구",3506,2440,476,1187,370,263,130,4,0,0,0,0,0,2,1,2433,7,1066
"3247","태전1동","태전1동제2투","대통령선거","대구광역시","북구",2528,1813,374,848,277,221,82,1,0,0,0,1,0,0,2,1806,7,715
"3248","태전1동","태전1동제3투","대통령선거","대구광역시","북구",2016,1284,217,662,171,148,70,3,0,0,0,0,1,0,3,1275,9,732
"3249","태전1동","태전1동제4투","대통령선거","대구광역시","북구",2602,1706,299,863,238,198,86,10,0,0,0,2,0,0,3,1699,7,896
"3250","태전1동","태전1동제5투","대통령선거","대구광역시","북구",2905,2159,387,1075,345,243,94,4,0,0,0,0,1,1,1,2151,8,746
"3251","태전1동","태전1동제6투","대통령선거","대구광역시","북구",2276,1815,353,878,274,207,84,7,0,0,0,1,1,3,3,1811,4,461
"3252","태전2동","관내사전투표","대통령선거","대구광역시","북구",3252,3252,871,1341,439,398,180,6,0,0,0,3,0,1,3,3242,10,0
"3253","태전2동","태전2동제1투","대통령선거","대구광역시","북구",3101,2286,427,1176,310,253,101,1,0,0,0,1,1,0,4,2274,12,815
"3254","태전2동","태전2동제2투","대통령선거","대구광역시","북구",3069,2054,373,1090,285,198,93,2,1,1,0,1,0,1,1,2046,8,1015
"3255","태전2동","태전2동제3투","대통령선거","대구광역시","북구",2806,1818,309,888,288,229,84,3,0,0,0,1,1,1,2,1806,12,988
"3256","태전2동","태전2동제4투","대통령선거","대구광역시","북구",3076,2305,442,1168,332,227,109,16,0,0,0,2,1,3,0,2300,5,771
"3257","태전2동","태전2동제5투","대통령선거","대구광역시","북구",3485,2462,541,1096,389,283,131,8,1,0,0,1,2,1,3,2456,6,1023
"3258","구암동","관내사전투표","대통령선거","대구광역시","북구",3927,3926,1402,1140,611,491,240,9,0,1,0,6,0,3,4,3907,19,1
"3259","구암동","구암동제1투","대통령선거","대구광역시","북구",2442,1671,288,873,260,166,68,3,0,1,0,1,0,0,4,1664,7,771
"3260","구암동","구암동제2투","대통령선거","대구광역시","북구",3039,2373,491,1039,384,331,111,6,0,0,0,0,1,2,2,2367,6,666
"3261","구암동","구암동제3투","대통령선거","대구광역시","북구",2758,2058,460,882,353,257,88,3,0,2,2,1,1,1,0,2050,8,700
"3262","구암동","구암동제4투","대통령선거","대구광역시","북구",2736,2099,447,938,333,261,109,0,1,0,0,0,0,0,2,2091,8,637
"3263","구암동","구암동제5투","대통령선거","대구광역시","북구",2957,2166,478,841,415,278,135,4,1,0,0,0,0,0,0,2152,14,791
"3264","구암동","구암동제6투","대통령선거","대구광역시","북구",3036,2198,474,863,397,319,128,4,0,1,0,1,0,1,1,2189,9,838
"3265","구암동","구암동제7투","대통령선거","대구광역시","북구",2922,2106,531,769,375,300,117,3,1,1,0,0,0,0,3,2100,6,816
"3266","구암동","구암동제8투","대통령선거","대구광역시","북구",3284,2452,583,945,448,317,139,8,0,0,0,3,0,3,0,2446,6,832
"3267","관음동","관내사전투표","대통령선거","대구광역시","북구",2497,2497,673,1015,341,292,155,2,0,1,1,0,1,3,1,2485,12,0
"3268","관음동","관음동제1투","대통령선거","대구광역시","북구",3420,2178,327,1241,312,193,80,4,0,2,1,0,3,0,4,2167,11,1242
"3269","관음동","관음동제2투","대통령선거","대구광역시","북구",3649,2560,447,1256,415,273,144,6,1,0,1,0,0,2,1,2546,14,1089
"3270","관음동","관음동제3투","대통령선거","대구광역시","북구",2452,1650,285,864,242,175,64,10,1,1,0,0,1,1,2,1646,4,802
"3271","관음동","관음동제4투","대통령선거","대구광역시","북구",3027,2361,434,1123,391,303,90,6,0,0,0,1,1,1,2,2352,9,666
"3272","읍내동","관내사전투표","대통령선거","대구광역시","북구",2652,2652,697,1110,348,325,150,8,0,2,1,0,0,0,2,2643,9,0
"3273","읍내동","읍내동제1투","대통령선거","대구광역시","북구",3407,2196,386,1076,354,245,115,2,0,1,0,1,0,2,2,2184,12,1211
"3274","읍내동","읍내동제2투","대통령선거","대구광역시","북구",3582,2656,538,1257,409,331,106,2,0,1,0,2,2,3,0,2651,5,926
"3275","읍내동","읍내동제3투","대통령선거","대구광역시","북구",3729,2477,506,1151,392,279,126,4,1,0,2,1,0,0,4,2466,11,1252
"3276","읍내동","읍내동제4투","대통령선거","대구광역시","북구",3572,2507,448,1278,375,263,113,6,0,0,0,1,1,4,2,2491,16,1065
"3277","읍내동","읍내동제5투","대통령선거","대구광역시","북구",3487,2558,532,1223,377,301,107,6,0,0,0,1,1,2,2,2552,6,929
"3278","동천동","관내사전투표","대통령선거","대구광역시","북구",4423,4423,1397,1326,711,634,318,7,0,5,0,0,0,1,4,4403,20,0
"3279","동천동","동천동제1투","대통령선거","대구광역시","북구",2962,1999,459,893,272,237,116,9,0,0,1,0,0,0,4,1991,8,963
"3280","동천동","동천동제2투","대통령선거","대구광역시","북구",2309,1692,367,743,257,216,89,9,0,0,0,2,0,0,1,1684,8,617
"3281","동천동","동천동제3투","대통령선거","대구광역시","북구",2644,2162,531,743,420,323,129,4,0,2,0,0,0,0,4,2156,6,482
"3282","동천동","동천동제4투","대통령선거","대구광역시","북구",2811,2109,488,758,389,323,130,3,0,1,3,0,0,0,6,2101,8,702
"3283","동천동","동천동제5투","대통령선거","대구광역시","북구",3601,2880,768,980,518,440,160,3,0,0,1,1,0,0,0,2871,9,721
"3284","동천동","동천동제6투","대통령선거","대구광역시","북구",3350,2462,629,907,415,341,152,4,0,1,0,1,0,0,1,2451,11,888
"3285","국우동","관내사전투표","대통령선거","대구광역시","북구",2252,2252,738,641,376,309,163,6,0,1,0,2,0,2,4,2242,10,0
"3286","국우동","국우동제1투","대통령선거","대구광역시","북구",3701,2647,582,1159,416,325,140,5,0,1,0,1,0,4,3,2636,11,1054
"3287","국우동","국우동제2투","대통령선거","대구광역시","북구",2617,1753,356,821,259,198,95,6,1,1,1,1,0,2,1,1742,11,864
"3288","국우동","국우동제3투","대통령선거","대구광역시","북구",3024,2285,601,811,406,327,125,6,0,0,1,0,1,0,3,2281,4,739
"3289","국우동","국우동제4투","대통령선거","대구광역시","북구",2727,2090,517,752,379,307,129,1,0,1,0,0,0,1,1,2088,2,637
"3290","국우동","국우동제5투","대통령선거","대구광역시","북구",3205,2405,676,856,384,350,124,3,0,1,0,3,1,0,1,2399,6,800
"3291","잘못 투입·구분된 투표지","잘못 투입·구분된 투표지","대통령선거","대구광역시","북구",0,1,0,1,0,0,0,0,0,0,0,0,0,0,0,1,0,-1
"3292","거소·선상투표","거소·선상투표","대통령선거","대구광역시","수성구",603,570,135,172,161,58,17,5,1,0,1,1,1,2,2,556,14,33
"3293","관외사전투표","관외사전투표","대통령선거","대구광역시","수성구",30992,30985,8676,9572,5269,5016,2063,67,8,8,7,25,7,17,44,30779,206,7
"3294","재외투표","재외투표","대통령선거","대구광역시","수성구",2426,1911,906,218,314,185,265,12,0,0,0,0,0,2,0,1902,9,515
"3295","범어1동","관내사전투표","대통령선거","대구광역시","수성구",2748,2748,756,1097,342,401,132,8,0,1,0,2,0,0,1,2740,8,0
"3296","범어1동","범어1동제1투","대통령선거","대구광역시","수성구",3795,2760,619,1216,428,386,99,3,0,0,0,1,0,0,1,2753,7,1035
"3297","범어1동","범어1동제2투","대통령선거","대구광역시","수성구",2852,2276,405,1195,325,279,64,5,0,0,0,1,0,0,0,2274,2,576
"3298","범어1동","범어1동제3투","대통령선거","대구광역시","수성구",3819,2985,616,1402,419,399,119,15,0,0,1,3,0,1,1,2976,9,834
"3299","범어2동","관내사전투표","대통령선거","대구광역시","수성구",1988,1988,534,813,242,286,98,1,0,0,0,0,0,1,3,1978,10,0
"3300","범어2동","범어2동제1투","대통령선거","대구광역시","수성구",1971,1288,249,624,210,150,48,1,0,1,0,0,0,0,0,1283,5,683
"3301","범어2동","범어2동제2투","대통령선거","대구광역시","수성구",2189,1616,406,686,257,199,54,4,0,0,2,1,0,0,0,1609,7,573
"3302","범어2동","범어2동제3투","대통령선거","대구광역시","수성구",2101,1441,256,736,205,155,76,6,0,0,0,2,0,0,0,1436,5,660
"3303","범어2동","범어2동제4투","대통령선거","대구광역시","수성구",2832,2301,324,1192,386,342,48,2,0,0,0,0,0,0,2,2296,5,531
"3304","범어3동","관내사전투표","대통령선거","대구광역시","수성구",1523,1523,461,551,200,219,81,4,0,0,0,0,0,0,2,1518,5,0
"3305","범어3동","범어3동제1투","대통령선거","대구광역시","수성구",3023,2278,595,805,417,360,81,9,1,0,0,0,0,1,3,2272,6,745
"3306","범어3동","범어3동제2투","대통령선거","대구광역시","수성구",2786,2100,446,908,318,308,105,2,0,1,0,1,0,1,1,2091,9,686
"3307","범어3동","범어3동제3투","대통령선거","대구광역시","수성구",2489,1862,394,777,314,286,78,8,0,1,0,0,0,0,0,1858,4,627
"3308","범어4동","관내사전투표","대통령선거","대구광역시","수성구",2186,2186,585,923,273,290,96,6,0,1,0,1,0,3,2,2180,6,0
"3309","범어4동","범어4동제1투","대통령선거","대구광역시","수성구",2075,1420,287,658,215,182,65,2,0,1,0,0,0,0,1,1411,9,655
"3310","범어4동","범어4동제2투","대통령선거","대구광역시","수성구",2441,1956,490,677,386,307,86,4,0,1,0,1,0,1,0,1953,3,485
"3311","범어4동","범어4동제3투","대통령선거","대구광역시","수성구",2047,1489,278,744,222,173,55,7,0,0,2,0,1,1,1,1484,5,558
"3312","범어4동","범어4동제4투","대통령선거","대구광역시","수성구",2666,2165,542,810,407,301,89,8,0,1,0,0,0,0,1,2159,6,501
"3313","만촌1동","관내사전투표","대통령선거","대구광역시","수성구",3853,3853,1038,1563,529,509,175,10,0,0,1,4,1,5,0,3835,18,0
"3314","만촌1동","만촌1동제1투","대통령선거","대구광역시","수성구",2677,1865,324,973,251,244,58,7,0,0,1,2,0,0,0,1860,5,812
"3315","만촌1동","만촌1동제2투","대통령선거","대구광역시","수성구",2880,2356,531,988,391,344,92,3,0,2,0,0,0,0,2,2353,3,524
"3316","만촌1동","만촌1동제3투","대통령선거","대구광역시","수성구",2350,1744,347,846,265,190,80,5,0,0,1,2,0,1,0,1737,7,606
"3317","만촌1동","만촌1동제4투","대통령선거","대구광역시","수성구",3191,2232,404,1067,366,269,105,5,0,2,0,0,2,2,1,2223,9,959
"3318","만촌1동","만촌1동제5투","대통령선거","대구광역시","수성구",3434,2641,498,1295,384,353,96,6,0,1,1,1,0,0,2,2637,4,793
"3319","만촌2동","관내사전투표","대통령선거","대구광역시","수성구",1695,1695,465,640,242,240,92,6,0,1,0,1,0,0,1,1688,7,0
"3320","만촌2동","만촌2동제1투","대통령선거","대구광역시","수성구",3226,2264,483,996,384,291,94,4,0,0,0,2,0,0,2,2256,8,962
"3321","만촌2동","만촌2동제2투","대통령선거","대구광역시","수성구",2329,1621,265,830,237,219,61,4,0,0,0,2,0,0,0,1618,3,708
"3322","만촌2동","만촌2동제3투","대통령선거","대구광역시","수성구",2258,1650,270,885,228,188,60,5,0,0,0,0,0,1,2,1639,11,608
"3323","만촌3동","관내사전투표","대통령선거","대구광역시","수성구",2533,2533,727,866,403,395,128,3,0,1,1,1,0,1,0,2526,7,0
"3324","만촌3동","만촌3동제1투","대통령선거","대구광역시","수성구",3014,2141,390,1026,339,301,76,2,0,0,0,0,0,0,0,2134,7,873
"3325","만촌3동","만촌3동제2투","대통령선거","대구광역시","수성구",1829,1330,256,663,178,162,54,4,0,1,0,2,0,0,0,1320,10,499
"3326","만촌3동","만촌3동제3투","대통령선거","대구광역시","수성구",2663,2078,492,845,356,289,91,2,0,1,0,0,0,0,0,2076,2,585
"3327","만촌3동","만촌3동제4투","대통령선거","대구광역시","수성구",3362,2693,635,1062,425,438,117,2,0,1,0,1,0,0,0,2681,12,669
"3328","수성1가동","관내사전투표","대통령선거","대구광역시","수성구",3035,3035,835,1253,388,405,131,3,0,2,0,2,1,2,6,3028,7,0
"3329","수성1가동","수성1가동제1투","대통령선거","대구광역시","수성구",2519,2012,487,790,334,291,93,6,0,1,0,1,2,0,0,2005,7,507
"3330","수성1가동","수성1가동제2투","대통령선거","대구광역시","수성구",3288,2409,505,1114,358,324,88,4,0,0,1,3,0,1,2,2400,9,879
"3331","수성1가동","수성1가동제3투","대통령선거","대구광역시","수성구",2826,2198,359,1194,282,286,59,12,0,0,0,1,0,0,1,2194,4,628
"3332","수성1가동","수성1가동제4투","대통령선거","대구광역시","수성구",2928,1986,319,1168,236,167,76,7,0,1,0,2,2,2,1,1981,5,942
"3333","수성2·3가동","관내사전투표","대통령선거","대구광역시","수성구",2127,2127,500,1016,279,243,75,5,0,0,0,0,0,1,4,2123,4,0
"3334","수성2·3가동","수성2·3가동제1투","대통령선거","대구광역시","수성구",2622,2058,400,916,376,283,79,2,0,0,0,0,0,0,0,2056,2,564
"3335","수성2·3가동","수성2·3가동제2투","대통령선거","대구광역시","수성구",2150,1633,300,794,258,218,51,4,0,0,1,0,0,3,1,1630,3,517
"3336","수성2·3가동","수성2·3가동제3투","대통령선거","대구광역시","수성구",2384,1575,260,877,201,168,59,3,1,0,1,1,0,2,0,1573,2,809
"3337","수성4가동","관내사전투표","대통령선거","대구광역시","수성구",2640,2640,686,1085,370,375,106,4,1,3,0,0,0,0,1,2631,9,0
"3338","수성4가동","수성4가동제1투","대통령선거","대구광역시","수성구",2855,2073,414,992,310,242,96,9,0,0,0,0,0,1,1,2065,8,782
"3339","수성4가동","수성4가동제2투","대통령선거","대구광역시","수성구",2740,1963,374,977,267,259,72,3,0,0,0,1,0,1,0,1954,9,777
"3340","수성4가동","수성4가동제3투","대통령선거","대구광역시","수성구",1921,1467,228,801,218,168,42,4,0,1,0,0,0,1,0,1463,4,454
"3341","수성4가동","수성4가동제4투","대통령선거","대구광역시","수성구",2264,1803,344,826,288,274,59,3,0,0,0,0,0,0,1,1795,8,461
"3342","황금1동","관내사전투표","대통령선거","대구광역시","수성구",2970,2969,901,1059,417,437,138,5,0,1,0,0,1,1,0,2960,9,1
"3343","황금1동","황금1동제1투","대통령선거","대구광역시","수성구",3053,2346,422,1095,400,334,87,4,0,0,1,1,0,1,0,2345,1,707
"3344","황금1동","황금1동제2투","대통령선거","대구광역시","수성구",1859,1268,227,662,205,121,33,6,1,1,0,0,1,0,1,1258,10,591
"3345","황금1동","황금1동제3투","대통령선거","대구광역시","수성구",2426,1919,401,830,316,294,71,4,0,0,0,0,0,0,1,1917,2,507
"3346","황금1동","황금1동제4투","대통령선거","대구광역시","수성구",3014,2463,651,873,427,392,96,7,0,0,0,2,0,3,1,2452,11,551
"3347","황금1동","황금1동제5투","대통령선거","대구광역시","수성구",2389,1983,504,704,384,291,88,3,0,0,0,0,0,1,2,1977,6,406
"3348","황금2동","관내사전투표","대통령선거","대구광역시","수성구",1420,1420,343,586,209,194,79,3,0,0,1,0,0,0,2,1417,3,0
"3349","황금2동","황금2동제1투","대통령선거","대구광역시","수성구",2793,1812,285,999,247,191,71,8,0,0,1,0,0,0,1,1803,9,981
"3350","황금2동","황금2동제2투","대통령선거","대구광역시","수성구",2833,1802,317,923,274,190,82,4,1,0,1,1,0,0,2,1795,7,1031
"3351","황금2동","황금2동제3투","대통령선거","대구광역시","수성구",2630,1658,265,955,210,149,65,5,0,0,0,0,0,0,1,1650,8,972
"3352","중동","관내사전투표","대통령선거","대구광역시","수성구",1897,1897,446,900,229,200,98,9,0,1,0,3,1,1,1,1889,8,0
"3353","중동","중동제1투","대통령선거","대구광역시","수성구",2303,1346,211,780,166,140,38,5,1,0,0,0,0,0,1,1342,4,957
"3354","중동","중동제2투","대통령선거","대구광역시","수성구",1827,1251,191,763,144,99,40,4,0,0,0,1,1,2,1,1246,5,576
"3355","중동","중동제3투","대통령선거","대구광역시","수성구",2162,1338,249,680,171,157,61,7,0,0,1,0,1,2,0,1329,9,824
"3356","중동","중동제4투","대통령선거","대구광역시","수성구",2112,1456,217,830,224,128,44,6,0,0,0,0,0,1,1,1451,5,656
"3357","상동","관내사전투표","대통령선거","대구광역시","수성구",1965,1965,514,890,239,231,72,6,1,1,1,2,0,1,1,1959,6,0
"3358","상동","상동제1투","대통령선거","대구광역시","수성구",2811,1623,317,793,235,194,70,6,1,0,0,0,1,0,1,1618,5,1188
"3359","상동","상동제2투","대통령선거","대구광역시","수성구",4012,2946,514,1578,410,354,70,6,0,0,3,0,0,1,0,2936,10,1066
"3360","상동","상동제3투","대통령선거","대구광역시","수성구",2753,2038,328,1147,258,226,60,5,0,0,0,0,1,3,1,2029,9,715
"3361","상동","상동제4투","대통령선거","대구광역시","수성구",2390,1583,306,830,199,175,57,3,0,1,2,0,0,0,2,1575,8,807
"3362","파동","관내사전투표","대통령선거","대구광역시","수성구",2062,2062,439,1028,248,244,87,7,0,1,1,0,2,1,1,2059,3,0
"3363","파동","파동제1투","대통령선거","대구광역시","수성구",3111,2027,331,1136,270,198,68,11,0,0,0,0,0,0,1,2015,12,1084
"3364","파동","파동제2투","대통령선거","대구광역시","수성구",3166,2387,454,1145,372,316,72,5,1,2,1,3,1,5,1,2378,9,779
"3365","파동","파동제3투","대통령선거","대구광역시","수성구",3426,2461,409,1329,321,276,103,6,0,0,0,0,1,2,2,2449,12,965
"3366","두산동","관내사전투표","대통령선거","대구광역시","수성구",2105,2105,493,942,271,288,97,2,1,0,0,0,0,1,1,2096,9,0
"3367","두산동","두산동제1투","대통령선거","대구광역시","수성구",2512,1493,248,766,221,193,57,3,0,0,0,0,1,0,1,1490,3,1019
"3368","두산동","두산동제2투","대통령선거","대구광역시","수성구",2925,1637,316,792,230,215,68,9,0,0,0,0,0,0,0,1630,7,1288
"3369","두산동","두산동제3투","대통령선거","대구광역시","수성구",3934,2912,529,1335,501,450,83,5,0,0,1,1,0,0,1,2906,6,1022
"3370","지산1동","관내사전투표","대통령선거","대구광역시","수성구",3588,3588,899,1459,501,532,167,4,2,0,4,0,0,2,3,3573,15,0
"3371","지산1동","지산1동제1투","대통령선거","대구광역시","수성구",2565,1824,332,902,259,247,66,2,0,1,0,1,0,1,5,1816,8,741
"3372","지산1동","지산1동제2투","대통령선거","대구광역시","수성구",1940,1317,242,673,196,151,42,1,0,1,0,0,0,1,3,1310,7,623
"3373","지산1동","지산1동제3투","대통령선거","대구광역시","수성구",2166,1449,272,784,207,122,48,4,0,0,0,0,2,1,2,1442,7,717
"3374","지산1동","지산1동제4투","대통령선거","대구광역시","수성구",2902,2078,372,993,309,278,100,12,0,0,0,1,1,0,3,2069,9,824
"3375","지산1동","지산1동제5투","대통령선거","대구광역시","수성구",3057,2105,363,1048,318,273,84,8,0,1,0,2,1,0,0,2098,7,952
"3376","지산1동","지산1동제6투","대통령선거","대구광역시","수성구",3046,2025,376,1021,289,231,90,2,0,2,1,1,1,0,3,2017,8,1021
"3377","지산2동","관내사전투표","대통령선거","대구광역시","수성구",2626,2626,663,1114,349,357,119,5,0,2,1,4,1,0,0,2615,11,0
"3378","지산2동","지산2동제1투","대통령선거","대구광역시","수성구",2907,1832,352,923,261,200,85,4,0,0,1,0,0,1,1,1828,4,1075
"3379","지산2동","지산2동제2투","대통령선거","대구광역시","수성구",3001,2354,432,1064,399,349,95,8,0,0,0,0,0,0,1,2348,6,647
"3380","지산2동","지산2동제3투","대통령선거","대구광역시","수성구",2631,1849,351,871,285,245,78,7,0,3,0,3,0,0,0,1843,6,782
"3381","지산2동","지산2동제4투","대통령선거","대구광역시","수성구",2414,1647,293,857,240,185,57,6,0,1,0,1,1,1,2,1644,3,767
"3382","지산2동","지산2동제5투","대통령선거","대구광역시","수성구",2484,1809,352,832,250,279,82,6,1,0,0,0,0,1,3,1806,3,675
"3383","범물1동","관내사전투표","대통령선거","대구광역시","수성구",1994,1994,430,959,269,229,83,4,1,1,0,1,1,3,3,1984,10,0
"3384","범물1동","범물1동제1투","대통령선거","대구광역시","수성구",2260,1405,205,817,186,126,54,5,1,1,0,3,2,1,0,1401,4,855
"3385","범물1동","범물1동제2투","대통령선거","대구광역시","수성구",1704,1099,171,646,139,96,24,8,0,1,0,0,0,0,3,1088,11,605
"3386","범물1동","범물1동제3투","대통령선거","대구광역시","수성구",2380,1831,361,867,262,269,58,8,1,0,0,0,0,1,1,1828,3,549
"3387","범물1동","범물1동제4투","대통령선거","대구광역시","수성구",2403,1759,295,889,272,227,61,1,0,1,0,0,0,2,0,1748,11,644
"3388","범물2동","관내사전투표","대통령선거","대구광역시","수성구",2202,2202,555,922,326,279,103,4,0,2,0,0,0,3,1,2195,7,0
"3389","범물2동","범물2동제1투","대통령선거","대구광역시","수성구",2282,1593,280,769,285,215,34,4,0,0,0,0,0,0,0,1587,6,689
"3390","범물2동","범물2동제2투","대통령선거","대구광역시","수성구",2270,1646,379,697,276,213,69,2,0,0,1,0,0,1,2,1640,6,624
"3391","범물2동","범물2동제3투","대통령선거","대구광역시","수성구",2675,2080,447,876,352,302,92,3,0,4,0,0,0,0,0,2076,4,595
"3392","범물2동","범물2동제4투","대통령선거","대구광역시","수성구",2710,2081,420,926,320,299,98,6,1,1,1,0,2,1,1,2076,5,629
"3393","고산1동","관내사전투표","대통령선거","대구광역시","수성구",4443,4443,1450,1340,686,657,283,10,0,3,2,1,0,0,1,4433,10,0
"3394","고산1동","고산1동제1투","대통령선거","대구광역시","수성구",2263,1743,489,583,318,238,98,6,0,1,0,1,0,1,1,1736,7,520
"3395","고산1동","고산1동제2투","대통령선거","대구광역시","수성구",2624,1929,406,882,296,241,88,6,0,0,0,0,0,1,1,1921,8,695
"3396","고산1동","고산1동제3투","대통령선거","대구광역시","수성구",2619,1962,445,867,311,235,86,8,1,1,0,0,0,0,1,1955,7,657
"3397","고산1동","고산1동제4투","대통령선거","대구광역시","수성구",2288,1729,382,691,286,250,104,4,0,0,2,0,0,1,2,1722,7,559
"3398","고산1동","고산1동제5투","대통령선거","대구광역시","수성구",2686,2211,471,965,363,307,90,3,0,0,0,1,0,2,2,2204,7,475
"3399","고산1동","고산1동제6투","대통령선거","대구광역시","수성구",3664,2905,732,1117,486,402,139,17,0,0,0,1,0,2,2,2898,7,759
"3400","고산1동","고산1동제7투","대통령선거","대구광역시","수성구",2982,2503,749,786,451,401,99,4,1,1,2,1,0,0,0,2495,8,479
"3401","고산2동","관내사전투표","대통령선거","대구광역시","수성구",3997,3997,1190,1476,558,528,211,5,1,1,2,3,0,1,4,3980,17,0
"3402","고산2동","고산2동제1투","대통령선거","대구광역시","수성구",2684,1941,434,863,283,274,79,1,0,0,0,2,0,0,1,1937,4,743
"3403","고산2동","고산2동제2투","대통령선거","대구광역시","수성구",2929,2241,532,974,320,292,107,3,0,0,1,1,1,1,1,2233,8,688
"3404","고산2동","고산2동제3투","대통령선거","대구광역시","수성구",2730,1981,435,900,292,265,73,3,0,0,0,0,0,0,3,1971,10,749
"3405","고산2동","고산2동제4투","대통령선거","대구광역시","수성구",3491,2811,684,1148,458,376,114,14,0,0,0,2,0,0,2,2798,13,680
"3406","고산2동","고산2동제5투","대통령선거","대구광역시","수성구",3748,2846,622,1223,473,415,98,2,0,1,0,4,1,2,0,2841,5,902
"3407","고산3동","관내사전투표","대통령선거","대구광역시","수성구",4834,4834,1469,1610,749,702,266,12,0,3,0,1,0,3,3,4818,16,0
"3408","고산3동","고산3동제1투","대통령선거","대구광역시","수성구",3077,2255,448,1045,345,289,104,5,0,3,2,4,0,1,1,2247,8,822
"3409","고산3동","고산3동제2투","대통령선거","대구광역시","수성구",2778,1958,391,919,283,246,99,7,0,2,0,2,0,1,2,1952,6,820
"3410","고산3동","고산3동제3투","대통령선거","대구광역시","수성구",2551,1917,477,716,324,305,87,1,0,0,0,0,0,1,3,1914,3,634
"3411","고산3동","고산3동제4투","대통령선거","대구광역시","수성구",2048,1607,401,604,274,225,84,8,1,1,0,2,0,0,2,1602,5,441
"3412","고산3동","고산3동제5투","대통령선거","대구광역시","수성구",3197,2612,610,1095,414,367,105,5,0,0,2,0,0,2,2,2602,10,585
"3413","고산3동","고산3동제6투","대통령선거","대구광역시","수성구",3357,2640,628,1014,435,429,118,4,0,0,1,1,0,2,0,2632,8,717
"3414","고산3동","고산3동제7투","대통령선거","대구광역시","수성구",3186,2579,711,873,491,371,118,6,0,0,0,1,0,0,2,2573,6,607
"3415","잘못 투입·구분된 투표지","잘못 투입·구분된 투표지","대통령선거","대구광역시","수성구",0,1,0,0,1,0,0,0,0,0,0,0,0,0,0,1,0,-1
"3416","거소·선상투표","거소·선상투표","대통령선거","대구광역시","달서구",888,831,198,237,251,93,19,7,2,2,0,0,2,0,3,814,17,57
"3417","관외사전투표","관외사전투표","대통령선거","대구광역시","달서구",36257,36256,10362,11151,6304,5257,2563,109,15,18,19,31,15,17,84,35945,311,1
"3418","재외투표","재외투표","대통령선거","대구광역시","달서구",2039,1558,863,122,222,132,201,10,0,1,0,0,0,0,1,1552,6,481
"3419","성당동","관내사전투표","대통령선거","대구광역시","달서구",2632,2632,583,1260,331,285,138,15,2,1,0,2,1,0,1,2619,13,0
"3420","성당동","성당동제1투","대통령선거","대구광역시","달서구",3471,2169,301,1229,318,193,99,12,0,1,0,0,1,2,3,2159,10,1302
"3421","성당동","성당동제2투","대통령선거","대구광역시","달서구",2607,1733,285,1035,201,140,54,6,1,1,0,0,1,0,0,1724,9,874
"3422","성당동","성당동제3투","대통령선거","대구광역시","달서구",3174,2069,291,1208,258,189,98,13,0,0,0,0,0,1,0,2058,11,1105
"3423","성당동","성당동제4투","대통령선거","대구광역시","달서구",3600,2733,683,1117,426,355,126,15,0,0,0,0,0,2,2,2726,7,867
"3424","성당동","성당동제5투","대통령선거","대구광역시","달서구",3746,2584,479,1288,393,282,118,14,0,0,0,0,1,2,2,2579,5,1162
"3425","두류1·2동","관내사전투표","대통령선거","대구광역시","달서구",1473,1473,328,732,177,134,84,8,1,0,0,2,0,0,0,1466,7,0
"3426","두류1·2동","두류1·2동제1투","대통령선거","대구광역시","달서구",2089,1244,181,727,159,104,54,5,0,0,0,0,1,2,1,1234,10,845
"3427","두류1·2동","두류1·2동제2투","대통령선거","대구광역시","달서구",2304,1511,235,882,184,127,59,11,0,1,1,0,1,2,1,1504,7,793
"3428","두류1·2동","두류1·2동제3투","대통령선거","대구광역시","달서구",2416,1561,200,959,207,129,47,4,0,0,0,2,0,0,0,1548,13,855
"3429","두류1·2동","두류1·2동제4투","대통령선거","대구광역시","달서구",2487,1663,286,934,214,144,59,4,1,1,0,0,2,3,1,1649,14,824
"3430","두류1·2동","두류1·2동제5투","대통령선거","대구광역시","달서구",3204,2026,392,1014,268,231,94,8,0,2,1,1,1,1,1,2014,12,1178
"3431","두류3동","관내사전투표","대통령선거","대구광역시","달서구",1955,1955,465,871,253,225,116,9,0,0,0,0,0,2,3,1944,11,0
"3432","두류3동","두류3동제1투","대통령선거","대구광역시","달서구",2733,2033,369,1042,283,240,78,8,0,0,1,1,0,0,3,2025,8,700
"3433","두류3동","두류3동제2투","대통령선거","대구광역시","달서구",2192,1389,229,727,200,150,67,6,0,1,0,0,0,2,1,1383,6,803
"3434","두류3동","두류3동제3투","대통령선거","대구광역시","달서구",1699,1179,197,652,150,118,52,1,0,0,0,1,0,1,1,1173,6,520
"3435","본리동","관내사전투표","대통령선거","대구광역시","달서구",3577,3577,1024,1336,501,491,193,18,0,1,0,4,0,1,0,3569,8,0
"3436","본리동","본리동제1투","대통령선거","대구광역시","달서구",2614,2057,524,797,322,305,83,12,0,1,0,1,0,0,1,2046,11,557
"3437","본리동","본리동제2투","대통령선거","대구광역시","달서구",2107,1224,230,576,210,120,75,5,0,1,0,0,0,0,2,1219,5,883
"3438","본리동","본리동제3투","대통령선거","대구광역시","달서구",2138,1400,245,718,187,173,63,7,0,1,0,2,2,0,0,1398,2,738
"3439","본리동","본리동제4투","대통령선거","대구광역시","달서구",2155,1660,385,727,282,192,58,9,0,1,1,2,0,1,0,1658,2,495
"3440","본리동","본리동제5투","대통령선거","대구광역시","달서구",3051,1914,351,938,316,198,91,11,1,1,0,0,0,1,1,1909,5,1137
"3441","본리동","본리동제6투","대통령선거","대구광역시","달서구",2307,1669,378,757,251,193,68,11,0,1,0,0,1,2,3,1665,4,638
"3442","감삼동","관내사전투표","대통령선거","대구광역시","달서구",2024,2023,530,837,282,239,111,7,0,0,0,1,0,4,2,2013,10,1
"3443","감삼동","감삼동제1투","대통령선거","대구광역시","달서구",2634,1670,292,877,226,166,81,12,1,1,0,1,0,1,2,1660,10,964
"3444","감삼동","감삼동제2투","대통령선거","대구광역시","달서구",3006,1981,276,1140,295,161,80,17,0,0,0,1,0,1,1,1972,9,1025
"3445","감삼동","감삼동제3투","대통령선거","대구광역시","달서구",2363,1576,257,836,242,150,63,10,0,1,0,4,0,1,0,1564,12,787
"3446","감삼동","감삼동제4투","대통령선거","대구광역시","달서구",3198,2462,498,1162,405,267,103,15,0,1,0,1,1,0,1,2454,8,736
"3447","감삼동","감삼동제5투","대통령선거","대구광역시","달서구",4265,3467,729,1564,539,451,159,11,0,0,1,2,0,0,3,3459,8,798
"3448","감삼동","감삼동제6투","대통령선거","대구광역시","달서구",3423,2561,450,1218,415,357,103,6,0,2,0,0,0,1,2,2554,7,862
"3449","죽전동","관내사전투표","대통령선거","대구광역시","달서구",1290,1290,274,576,192,160,73,1,0,3,0,0,0,1,0,1280,10,0
"3450","죽전동","죽전동제1투","대통령선거","대구광역시","달서구",2087,1341,198,750,182,123,71,2,0,0,0,4,0,0,2,1332,9,746
"3451","죽전동","죽전동제2투","대통령선거","대구광역시","달서구",2392,1678,281,868,243,186,79,4,1,0,0,2,0,2,2,1668,10,714
"3452","죽전동","죽전동제3투","대통령선거","대구광역시","달서구",3344,2312,401,1169,358,256,108,2,0,1,0,0,0,0,2,2297,15,1032
"3453","죽전동","죽전동제4투","대통령선거","대구광역시","달서구",3322,2297,377,1229,318,252,98,10,0,1,0,1,3,0,2,2291,6,1025
"3454","장기동","관내사전투표","대통령선거","대구광역시","달서구",3230,3230,940,1166,442,452,198,9,0,2,0,2,1,0,1,3213,17,0
"3455","장기동","장기동제1투","대통령선거","대구광역시","달서구",3170,2317,437,1066,341,350,98,10,0,0,0,2,0,1,2,2307,10,853
"3456","장기동","장기동제2투","대통령선거","대구광역시","달서구",1846,1213,202,680,145,121,46,2,0,2,0,0,0,3,3,1204,9,633
"3457","장기동","장기동제3투","대통령선거","대구광역시","달서구",3384,2621,561,1168,410,340,118,9,0,1,0,0,1,0,2,2610,11,763
"3458","장기동","장기동제4투","대통령선거","대구광역시","달서구",2570,1757,336,821,296,211,78,8,0,0,1,1,0,0,1,1753,4,813
"3459","용산1동","관내사전투표","대통령선거","대구광역시","달서구",4045,4045,1061,1523,581,546,297,10,2,3,0,1,2,1,3,4030,15,0
"3460","용산1동","용산1동제1투","대통령선거","대구광역시","달서구",2867,1954,378,920,288,234,116,3,0,1,0,0,0,1,5,1946,8,913
"3461","용산1동","용산1동제2투","대통령선거","대구광역시","달서구",3150,2419,499,1062,383,309,148,6,0,1,1,2,0,0,3,2414,5,731
"3462","용산1동","용산1동제3투","대통령선거","대구광역시","달서구",2499,1787,318,843,273,243,94,1,0,0,0,0,0,3,1,1776,11,712
"3463","용산1동","용산1동제4투","대통령선거","대구광역시","달서구",2810,2217,443,943,402,310,97,4,1,1,0,0,1,1,4,2207,10,593
"3464","용산1동","용산1동제5투","대통령선거","대구광역시","달서구",2978,2134,397,974,353,285,106,4,0,0,0,1,0,0,1,2121,13,844
"3465","용산1동","용산1동제6투","대통령선거","대구광역시","달서구",3076,2348,389,1189,341,301,100,6,0,2,0,1,1,1,4,2335,13,728
"3466","용산1동","용산1동제7투","대통령선거","대구광역시","달서구",3611,2962,597,1377,467,387,120,6,0,0,0,0,2,1,1,2958,4,649
"3467","용산2동","관내사전투표","대통령선거","대구광역시","달서구",3164,3164,876,1167,489,402,202,3,1,1,0,7,1,1,4,3154,10,0
"3468","용산2동","용산2동제1투","대통령선거","대구광역시","달서구",2576,1722,327,814,270,208,89,4,0,0,3,1,0,1,2,1719,3,854
"3469","용산2동","용산2동제2투","대통령선거","대구광역시","달서구",3219,2022,425,911,304,250,113,7,0,1,1,0,0,0,1,2013,9,1197
"3470","용산2동","용산2동제3투","대통령선거","대구광역시","달서구",1940,1554,310,666,271,207,89,1,0,0,0,1,0,0,4,1549,5,386
"3471","용산2동","용산2동제4투","대통령선거","대구광역시","달서구",3192,2655,567,1116,429,393,130,5,1,0,1,2,0,0,1,2645,10,537
"3472","용산2동","용산2동제5투","대통령선거","대구광역시","달서구",3648,2790,598,1189,473,375,132,9,1,0,0,1,0,1,4,2783,7,858
"3473","용산2동","용산2동제6투","대통령선거","대구광역시","달서구",2628,2031,407,907,334,246,115,6,0,1,1,0,1,1,3,2022,9,597
"3474","용산2동","용산2동제7투","대통령선거","대구광역시","달서구",2992,2287,443,1078,367,267,108,4,1,1,1,0,1,1,4,2276,11,705
"3475","이곡1동","관내사전투표","대통령선거","대구광역시","달서구",2852,2852,802,1033,446,388,160,3,2,1,1,1,1,1,3,2842,10,0
"3476","이곡1동","이곡1동제1투","대통령선거","대구광역시","달서구",2443,1493,294,759,223,133,77,3,0,0,0,0,0,0,2,1491,2,950
"3477","이곡1동","이곡1동제2투","대통령선거","대구광역시","달서구",1776,1368,246,666,241,167,41,1,0,0,0,1,0,1,1,1365,3,408
"3478","이곡1동","이곡1동제3투","대통령선거","대구광역시","달서구",3053,2427,556,962,413,354,119,7,0,1,0,3,0,1,1,2417,10,626
"3479","이곡1동","이곡1동제4투","대통령선거","대구광역시","달서구",2551,1843,347,826,323,228,105,4,0,0,0,2,0,0,0,1835,8,708
"3480","이곡1동","이곡1동제5투","대통령선거","대구광역시","달서구",2664,2037,431,840,346,281,125,4,0,0,0,0,0,3,0,2030,7,627
"3481","이곡1동","이곡1동제6투","대통령선거","대구광역시","달서구",3741,2737,504,1302,455,316,138,5,0,2,0,0,0,1,5,2728,9,1004
"3482","이곡2동","관내사전투표","대통령선거","대구광역시","달서구",3993,3993,1027,1591,586,492,251,13,1,2,0,4,1,4,5,3977,16,0
"3483","이곡2동","이곡2동제1투","대통령선거","대구광역시","달서구",2492,1782,361,821,278,214,88,7,0,1,0,1,2,0,2,1775,7,710
"3484","이곡2동","이곡2동제2투","대통령선거","대구광역시","달서구",2960,1959,398,861,346,228,105,2,1,1,0,4,0,3,1,1950,9,1001
"3485","이곡2동","이곡2동제3투","대통령선거","대구광역시","달서구",2856,2247,397,1135,315,290,98,6,0,0,0,0,0,1,1,2243,4,609
"3486","이곡2동","이곡2동제4투","대통령선거","대구광역시","달서구",2926,2252,369,1153,349,250,113,6,0,1,0,0,0,0,3,2244,8,674
"3487","신당동","관내사전투표","대통령선거","대구광역시","달서구",2074,2074,627,730,308,261,126,2,0,1,0,1,1,2,0,2059,15,0
"3488","신당동","신당동제1투","대통령선거","대구광역시","달서구",3089,1724,289,880,283,157,90,2,0,3,0,1,3,0,6,1714,10,1365
"3489","신당동","신당동제2투","대통령선거","대구광역시","달서구",1781,1071,211,498,170,114,58,2,0,0,2,2,1,2,1,1061,10,710
"3490","신당동","신당동제3투","대통령선거","대구광역시","달서구",1476,859,183,386,123,98,58,3,0,0,1,0,0,0,1,853,6,617
"3491","신당동","신당동제4투","대통령선거","대구광역시","달서구",2574,1591,277,847,241,131,70,7,0,1,0,1,3,5,0,1583,8,983
"3492","신당동","신당동제5투","대통령선거","대구광역시","달서구",2795,1809,319,933,308,148,75,6,0,2,0,0,1,0,2,1794,15,986
"3493","신당동","신당동제6투","대통령선거","대구광역시","달서구",3291,2726,591,1196,440,361,120,3,1,0,0,0,0,0,1,2713,13,565
"3494","신당동","신당동제7투","대통령선거","대구광역시","달서구",3198,1915,374,823,289,300,112,5,1,0,0,0,0,1,0,1905,10,1283
"3495","신당동","신당동제8투","대통령선거","대구광역시","달서구",3919,3176,659,1400,525,422,138,7,0,1,1,4,1,1,3,3162,14,743
"3496","신당동","신당동제9투","대통령선거","대구광역시","달서구",1666,1410,273,615,232,194,82,1,0,0,0,2,0,2,1,1402,8,256
"3497","월성1동","관내사전투표","대통령선거","대구광역시","달서구",3949,3949,1361,1122,610,607,224,6,0,0,0,2,1,3,1,3937,12,0
"3498","월성1동","월성1동제1투","대통령선거","대구광역시","달서구",3724,2780,778,945,520,372,147,7,0,0,1,3,0,0,2,2775,5,944
"3499","월성1동","월성1동제2투","대통령선거","대구광역시","달서구",3761,2891,817,972,477,450,154,5,1,0,0,7,1,1,1,2886,5,870
"3500","월성1동","월성1동제3투","대통령선거","대구광역시","달서구",2981,2465,651,899,425,373,104,3,0,2,0,1,0,0,1,2459,6,516
"3501","월성1동","월성1동제4투","대통령선거","대구광역시","달서구",2209,1838,498,640,365,257,71,6,0,0,0,0,0,0,0,1837,1,371
"3502","월성1동","월성1동제5투","대통령선거","대구광역시","달서구",3087,2425,497,1201,335,272,104,4,0,1,0,1,2,1,0,2418,7,662
"3503","월성1동","월성1동제6투","대통령선거","대구광역시","달서구",2252,1804,349,875,275,214,79,4,0,0,0,1,0,0,1,1798,6,448
"3504","월성1동","월성1동제7투","대통령선거","대구광역시","달서구",3183,2555,722,848,492,355,126,4,0,2,0,0,0,2,1,2552,3,628
"3505","월성1동","월성1동제8투","대통령선거","대구광역시","달서구",2921,2286,733,681,424,335,105,2,1,0,0,0,0,0,0,2281,5,635
"3506","월성2동","관내사전투표","대통령선거","대구광역시","달서구",3166,3166,838,1308,446,376,153,11,0,2,2,2,0,5,4,3147,19,0
"3507","월성2동","월성2동제1투","대통령선거","대구광역시","달서구",1843,1071,151,649,152,80,22,3,0,0,0,0,2,2,1,1062,9,772
"3508","월성2동","월성2동제2투","대통령선거","대구광역시","달서구",2158,1508,248,794,232,164,59,3,1,0,0,0,0,2,1,1504,4,650
"3509","월성2동","월성2동제3투","대통령선거","대구광역시","달서구",2123,1434,220,780,225,140,45,5,1,1,0,0,0,0,5,1422,12,689
"3510","월성2동","월성2동제4투","대통령선거","대구광역시","달서구",2608,1980,347,1074,264,210,64,8,0,1,2,0,0,0,1,1971,9,628
"3511","월성2동","월성2동제5투","대통령선거","대구광역시","달서구",1919,1297,185,746,210,94,34,5,0,2,0,0,1,2,7,1286,11,622
"3512","월성2동","월성2동제6투","대통령선거","대구광역시","달서구",2211,1603,287,774,264,176,84,6,0,0,1,0,0,1,3,1596,7,608
"3513","진천동","관내사전투표","대통령선거","대구광역시","달서구",6375,6375,1903,2341,894,811,368,16,2,3,0,2,3,5,5,6353,22,0
"3514","진천동","진천동제1투","대통령선거","대구광역시","달서구",3294,2339,429,1143,352,270,107,10,0,4,0,3,0,1,4,2323,16,955
"3515","진천동","진천동제2투","대통령선거","대구광역시","달서구",3108,2186,371,1177,297,237,86,4,0,3,0,1,0,2,3,2181,5,922
"3516","진천동","진천동제3투","대통령선거","대구광역시","달서구",3126,2083,323,1164,292,200,82,2,1,1,0,0,0,3,3,2071,12,1043
"3517","진천동","진천동제4투","대통령선거","대구광역시","달서구",3009,2095,444,993,316,209,104,3,0,3,1,0,1,2,6,2082,13,914
"3518","진천동","진천동제5투","대통령선거","대구광역시","달서구",2939,2365,500,1008,400,315,115,11,0,3,1,1,0,4,2,2360,5,574
"3519","진천동","진천동제6투","대통령선거","대구광역시","달서구",2560,1939,337,994,304,211,75,3,0,2,0,1,0,2,2,1931,8,621
"3520","진천동","진천동제7투","대통령선거","대구광역시","달서구",3099,2270,517,1022,359,276,86,3,1,0,2,0,1,0,1,2268,2,829
"3521","진천동","진천동제8투","대통령선거","대구광역시","달서구",2723,2035,471,898,317,238,100,2,0,0,0,0,0,0,0,2026,9,688
"3522","진천동","진천동제9투","대통령선거","대구광역시","달서구",3007,2469,588,979,433,336,117,8,0,0,0,1,1,0,1,2464,5,538
"3523","진천동","진천동제10투","대통령선거","대구광역시","달서구",3390,2436,546,1051,410,285,119,7,2,0,0,0,1,2,1,2424,12,954
"3524","진천동","진천동제11투","대통령선거","대구광역시","달서구",1539,1139,260,504,167,154,47,3,0,0,0,0,1,0,0,1136,3,400
"3525","진천동","진천동제12투","대통령선거","대구광역시","달서구",2810,2314,698,728,406,338,130,7,0,1,1,0,0,1,0,2310,4,496
"3526","진천동","진천동제13투","대통령선거","대구광역시","달서구",2981,2372,783,663,448,356,109,5,0,0,1,2,2,1,1,2371,1,609
"3527","진천동","진천동제14투","대통령선거","대구광역시","달서구",3269,2654,879,671,519,469,101,4,1,0,0,0,0,1,3,2648,6,615
"3528","상인1동","관내사전투표","대통령선거","대구광역시","달서구",4426,4426,1226,1727,569,631,237,16,1,0,0,2,1,1,2,4413,13,0
"3529","상인1동","상인1동제1투","대통령선거","대구광역시","달서구",2896,2223,388,1124,303,294,98,6,0,1,0,4,0,2,0,2220,3,673
"3530","상인1동","상인1동제2투","대통령선거","대구광역시","달서구",1970,1588,280,786,238,211,61,3,0,0,0,0,0,1,1,1581,7,382
"3531","상인1동","상인1동제3투","대통령선거","대구광역시","달서구",2760,2136,400,1023,330,266,96,9,0,0,0,2,0,0,0,2126,10,624
"3532","상인1동","상인1동제4투","대통령선거","대구광역시","달서구",1925,1421,258,722,211,149,65,6,0,0,0,0,1,1,1,1414,7,504
"3533","상인1동","상인1동제5투","대통령선거","대구광역시","달서구",1887,1533,256,735,244,202,85,4,0,0,0,1,0,1,0,1528,5,354
"3534","상인1동","상인1동제6투","대통령선거","대구광역시","달서구",3111,2459,468,1194,405,267,110,3,0,0,0,3,0,2,3,2455,4,652
"3535","상인1동","상인1동제7투","대통령선거","대구광역시","달서구",3219,2626,623,1024,464,356,148,4,0,0,0,1,0,1,0,2621,5,593
"3536","상인1동","상인1동제8투","대통령선거","대구광역시","달서구",3135,2593,567,1084,435,362,127,9,0,1,0,0,0,0,0,2585,8,542
"3537","상인1동","상인1동제9투","대통령선거","대구광역시","달서구",2205,1796,354,798,316,239,82,4,0,0,0,0,0,1,1,1795,1,409
"3538","상인1동","상인1동제10투","대통령선거","대구광역시","달서구",2409,2024,576,756,331,276,80,3,0,0,0,0,0,0,0,2022,2,385
"3539","상인2동","관내사전투표","대통령선거","대구광역시","달서구",2951,2951,668,1333,426,339,160,3,1,2,1,3,1,1,1,2939,12,0
"3540","상인2동","상인2동제1투","대통령선거","대구광역시","달서구",2485,1552,227,869,222,156,67,1,0,0,1,2,0,0,1,1546,6,933
"3541","상인2동","상인2동제2투","대통령선거","대구광역시","달서구",2393,1567,280,811,229,165,67,5,0,0,0,0,1,0,2,1560,7,826
"3542","상인2동","상인2동제3투","대통령선거","대구광역시","달서구",2283,1548,275,808,216,157,70,2,0,1,0,1,0,0,3,1533,15,735
"3543","상인2동","상인2동제4투","대통령선거","대구광역시","달서구",2817,2019,420,962,324,216,81,3,1,1,0,1,1,1,3,2014,5,798
"3544","상인2동","상인2동제5투","대통령선거","대구광역시","달서구",2178,1563,302,751,241,192,64,3,0,1,0,1,0,1,2,1558,5,615
"3545","상인2동","상인2동제6투","대통령선거","대구광역시","달서구",1799,1258,224,671,170,123,59,1,0,1,0,3,0,0,0,1252,6,541
"3546","상인3동","관내사전투표","대통령선거","대구광역시","달서구",1682,1682,335,901,213,140,76,4,1,1,1,2,1,3,0,1678,4,0
"3547","상인3동","상인3동제1투","대통령선거","대구광역시","달서구",2160,1435,213,823,196,141,52,2,0,0,1,1,0,0,0,1429,6,725
"3548","상인3동","상인3동제2투","대통령선거","대구광역시","달서구",2448,1734,315,912,221,196,78,4,0,0,2,0,0,0,2,1730,4,714
"3549","상인3동","상인3동제3투","대통령선거","대구광역시","달서구",2597,1714,248,1022,244,114,50,10,0,1,3,2,0,4,0,1698,16,883
"3550","상인3동","상인3동제4투","대통령선거","대구광역시","달서구",2026,1354,241,767,184,101,40,6,1,3,1,0,0,3,1,1348,6,672
"3551","도원동","관내사전투표","대통령선거","대구광역시","달서구",5429,5429,1488,2096,747,722,331,14,0,2,1,1,0,1,1,5404,25,0
"3552","도원동","도원동제1투","대통령선거","대구광역시","달서구",2592,1844,334,862,301,220,107,8,0,0,0,0,0,1,2,1835,9,748
"3553","도원동","도원동제2투","대통령선거","대구광역시","달서구",2356,1701,347,845,241,178,78,3,0,0,0,1,0,0,0,1693,8,655
"3554","도원동","도원동제3투","대통령선거","대구광역시","달서구",2523,1825,377,857,280,202,96,1,1,0,0,1,1,0,2,1818,7,698
"3555","도원동","도원동제4투","대통령선거","대구광역시","달서구",2248,1714,354,854,236,164,86,5,1,2,1,1,1,1,2,1708,6,534
"3556","도원동","도원동제5투","대통령선거","대구광역시","달서구",1877,1463,320,615,239,170,112,3,0,0,0,0,0,1,0,1460,3,414
"3557","도원동","도원동제6투","대통령선거","대구광역시","달서구",2166,1620,363,695,263,200,87,4,1,0,0,0,0,0,2,1615,5,546
"3558","도원동","도원동제7투","대통령선거","대구광역시","달서구",2557,2101,401,1015,301,286,82,4,0,0,0,1,0,2,2,2094,7,456
"3559","도원동","도원동제8투","대통령선거","대구광역시","달서구",2964,2472,471,1205,372,307,106,6,0,0,1,2,0,0,1,2471,1,492
"3560","도원동","도원동제9투","대통령선거","대구광역시","달서구",3027,2336,484,1105,356,299,78,1,0,0,1,0,0,1,2,2327,9,691
"3561","도원동","도원동제10투","대통령선거","대구광역시","달서구",2119,1698,368,763,242,227,88,2,0,1,1,0,0,1,0,1693,5,421
"3562","송현1동","관내사전투표","대통령선거","대구광역시","달서구",2509,2509,606,1189,301,268,110,15,0,0,0,3,1,2,2,2497,12,0
"3563","송현1동","송현1동제1투","대통령선거","대구광역시","달서구",2649,1713,260,938,277,145,80,4,0,0,1,0,1,0,0,1706,7,936
"3564","송현1동","송현1동제2투","대통령선거","대구광역시","달서구",2681,1658,276,897,233,176,62,5,0,1,0,0,1,3,0,1654,4,1023
"3565","송현1동","송현1동제3투","대통령선거","대구광역시","달서구",2799,1819,324,933,270,181,83,17,1,0,0,0,1,1,1,1812,7,980
"3566","송현1동","송현1동제4투","대통령선거","대구광역시","달서구",3440,2222,382,1154,337,224,100,9,0,1,0,0,0,1,2,2210,12,1218
"3567","송현1동","송현1동제5투","대통령선거","대구광역시","달서구",2895,1941,338,1023,275,188,90,8,1,1,0,3,0,0,0,1927,14,954
"3568","송현2동","관내사전투표","대통령선거","대구광역시","달서구",1901,1901,440,874,238,213,113,9,0,0,2,1,1,3,0,1894,7,0
"3569","송현2동","송현2동제1투","대통령선거","대구광역시","달서구",2731,1666,288,945,222,124,55,14,0,0,1,1,0,0,5,1655,11,1065
"3570","송현2동","송현2동제2투","대통령선거","대구광역시","달서구",2096,1460,261,764,217,137,53,10,0,1,0,1,0,4,1,1449,11,636
"3571","송현2동","송현2동제3투","대통령선거","대구광역시","달서구",2666,1644,269,896,236,155,75,5,0,0,0,1,0,2,1,1640,4,1022
"3572","송현2동","송현2동제4투","대통령선거","대구광역시","달서구",2474,1785,328,882,275,214,71,4,0,0,1,1,0,1,0,1777,8,689
"3573","송현2동","송현2동제5투","대통령선거","대구광역시","달서구",2303,1716,292,930,243,181,59,5,0,1,1,0,0,0,2,1714,2,587
"3574","송현2동","송현2동제6투","대통령선거","대구광역시","달서구",2522,1586,202,988,187,138,52,9,1,1,0,1,0,1,1,1581,5,936
"3575","본동","관내사전투표","대통령선거","대구광역시","달서구",1560,1560,423,659,214,179,70,10,0,0,0,1,0,0,0,1556,4,0
"3576","본동","본동제1투","대통령선거","대구광역시","달서구",2026,1273,219,690,181,105,57,7,1,1,0,0,1,1,1,1264,9,753
"3577","본동","본동제2투","대통령선거","대구광역시","달서구",2605,1967,377,1001,300,219,54,10,1,0,0,0,0,0,0,1962,5,638
"3578","본동","본동제3투","대통령선거","대구광역시","달서구",2282,1632,322,762,259,179,76,14,0,1,1,3,1,2,3,1623,9,650
"3579","본동","본동제4투","대통령선거","대구광역시","달서구",2970,1850,264,996,286,187,90,17,0,1,0,0,0,1,2,1844,6,1120
"3580","잘못 투입·구분된 투표지","잘못 투입·구분된 투표지","대통령선거","대구광역시","달서구",0,4,0,2,1,0,1,0,0,0,0,0,0,0,0,4,0,-4
"3581","거소·선상투표","거소·선상투표","대통령선거","대구광역시","달성군",553,525,146,131,125,45,15,6,4,5,2,1,2,3,6,491,34,28
"3582","관외사전투표","관외사전투표","대통령선거","대구광역시","달성군",15746,15740,4509,5205,2550,2225,1052,24,5,3,5,16,2,7,39,15642,98,6
"3583","재외투표","재외투표","대통령선거","대구광역시","달성군",740,479,247,44,88,43,52,1,0,0,0,0,0,0,0,475,4,261
"3584","화원읍","관내사전투표","대통령선거","대구광역시","달성군",4961,4961,1262,2040,714,586,312,9,0,2,0,3,2,1,6,4937,24,0
"3585","화원읍","화원읍제1투","대통령선거","대구광역시","달성군",3137,1902,317,1051,242,202,71,7,0,0,0,1,2,2,3,1898,4,1235
"3586","화원읍","화원읍제2투","대통령선거","대구광역시","달성군",3073,2165,342,1121,347,235,89,7,0,1,4,0,1,1,2,2150,15,908
"3587","화원읍","화원읍제3투","대통령선거","대구광역시","달성군",2555,1721,236,975,248,165,68,5,0,1,2,0,0,1,4,1705,16,834
"3588","화원읍","화원읍제4투","대통령선거","대구광역시","달성군",2982,1478,278,731,228,168,65,3,0,1,0,0,0,1,0,1475,3,1504
"3589","화원읍","화원읍제5투","대통령선거","대구광역시","달성군",2995,2219,505,1031,315,226,124,3,1,0,0,2,0,2,4,2213,6,776
"3590","화원읍","화원읍제6투","대통령선거","대구광역시","달성군",3209,2326,426,1155,373,251,106,3,1,1,0,1,0,0,2,2319,7,883
"3591","화원읍","화원읍제7투","대통령선거","대구광역시","달성군",1131,875,145,471,109,97,46,0,0,2,0,0,1,0,0,871,4,256
"3592","화원읍","화원읍제8투","대통령선거","대구광역시","달성군",2225,1453,177,857,201,144,57,2,1,2,0,0,0,3,0,1444,9,772
"3593","화원읍","화원읍제9투","대통령선거","대구광역시","달성군",3651,2746,519,1316,417,311,151,9,0,0,2,2,0,1,2,2730,16,905
"3594","화원읍","화원읍제10투","대통령선거","대구광역시","달성군",2636,2000,406,894,348,212,123,2,0,0,0,0,0,1,3,1989,11,636
"3595","화원읍","화원읍제11투","대통령선거","대구광역시","달성군",1677,1271,283,558,179,171,70,2,0,1,1,0,0,0,1,1266,5,406
"3596","화원읍","화원읍제12투","대통령선거","대구광역시","달성군",2755,2361,591,982,366,311,96,5,0,1,0,3,0,2,1,2358,3,394
"3597","논공읍","관내사전투표","대통령선거","대구광역시","달성군",1477,1477,376,628,176,179,97,3,0,0,0,2,1,6,3,1471,6,0
"3598","논공읍","논공읍제1투","대통령선거","대구광역시","달성군",1465,951,109,635,114,58,24,2,1,0,0,0,0,3,0,946,5,514
"3599","논공읍","논공읍제2투","대통령선거","대구광역시","달성군",945,620,62,430,65,36,16,1,0,0,0,0,0,3,1,614,6,325
"3600","논공읍","논공읍제3투","대통령선거","대구광역시","달성군",2098,1307,266,607,232,103,77,2,0,0,2,5,2,1,3,1300,7,791
"3601","논공읍","논공읍제4투","대통령선거","대구광역시","달성군",1604,1081,233,488,172,100,75,1,0,3,0,3,0,1,3,1079,2,523
"3602","논공읍","논공읍제5투","대통령선거","대구광역시","달성군",2520,1714,361,706,285,202,139,1,0,0,0,5,0,1,1,1701,13,806
"3603","논공읍","논공읍제6투","대통령선거","대구광역시","달성군",2488,1458,265,733,229,125,78,6,1,1,1,2,1,3,6,1451,7,1030
"3604","논공읍","논공읍제7투","대통령선거","대구광역시","달성군",1950,1367,289,599,221,135,101,2,1,0,0,2,0,0,6,1356,11,583
"3605","다사읍","관내사전투표","대통령선거","대구광역시","달성군",4993,4993,1595,1680,732,626,312,7,1,1,2,3,2,2,5,4968,25,0
"3606","다사읍","다사읍제1투","대통령선거","대구광역시","달성군",2286,1602,308,728,268,199,85,5,0,0,0,0,0,1,0,1594,8,684
"3607","다사읍","다사읍제2투","대통령선거","대구광역시","달성군",2744,1993,413,972,309,193,90,7,0,0,0,0,0,1,1,1986,7,751
"3608","다사읍","다사읍제3투","대통령선거","대구광역시","달성군",2299,1576,321,790,247,147,61,1,0,0,0,1,0,1,3,1572,4,723
"3609","다사읍","다사읍제4투","대통령선거","대구광역시","달성군",595,433,41,282,67,34,7,0,0,0,0,0,0,1,0,432,1,162
"3610","다사읍","다사읍제5투","대통령선거","대구광역시","달성군",2327,1696,324,785,285,198,96,1,0,0,0,0,0,0,1,1690,6,631
"3611","다사읍","다사읍제6투","대통령선거","대구광역시","달성군",2627,2019,391,928,341,237,98,4,1,2,0,1,0,1,6,2010,9,608
"3612","다사읍","다사읍제7투","대통령선거","대구광역시","달성군",2774,2053,429,891,351,248,111,1,1,0,1,0,1,2,6,2042,11,721
"3613","다사읍","다사읍제8투","대통령선거","대구광역시","달성군",2869,2079,425,942,345,238,111,5,0,1,0,2,0,2,5,2076,3,790
"3614","다사읍","다사읍제9투","대통령선거","대구광역시","달성군",2613,1968,421,867,361,213,91,4,0,0,0,2,0,1,2,1962,6,645
"3615","다사읍","다사읍제10투","대통령선거","대구광역시","달성군",3183,2488,544,1102,397,306,130,2,1,0,0,0,1,0,1,2484,4,695
"3616","다사읍","다사읍제11투","대통령선거","대구광역시","달성군",3651,2883,732,1042,502,415,177,6,0,0,0,0,0,1,3,2878,5,768
"3617","다사읍","다사읍제12투","대통령선거","대구광역시","달성군",2859,2088,448,906,389,234,101,5,0,0,1,0,0,0,1,2085,3,771
"3618","다사읍","다사읍제13투","대통령선거","대구광역시","달성군",2666,2113,622,780,329,281,87,5,0,0,1,0,1,0,1,2107,6,553
"3619","다사읍","다사읍제14투","대통령선거","대구광역시","달성군",1956,1369,294,588,228,171,77,0,0,2,1,1,0,0,1,1363,6,587
"3620","다사읍","다사읍제15투","대통령선거","대구광역시","달성군",3022,2160,622,718,380,317,110,6,0,0,1,1,1,1,0,2157,3,862
"3621","다사읍","다사읍제16투","대통령선거","대구광역시","달성군",2530,1876,483,586,341,320,139,2,2,0,0,0,0,0,0,1873,3,654
"3622","다사읍","다사읍제17투","대통령선거","대구광역시","달성군",2866,2385,626,851,439,334,125,1,1,1,1,0,0,0,2,2381,4,481
"3623","다사읍","다사읍제18투","대통령선거","대구광역시","달성군",2372,1857,522,526,351,335,105,3,0,0,0,1,1,1,1,1846,11,515
"3624","가창면","관내사전투표","대통령선거","대구광역시","달성군",1089,1089,231,551,150,94,49,2,0,0,0,0,2,3,1,1083,6,0
"3625","가창면","가창면제1투","대통령선거","대구광역시","달성군",1412,912,187,450,131,97,40,2,1,0,0,0,0,0,1,909,3,500
"3626","가창면","가창면제2투","대통령선거","대구광역시","달성군",1233,843,136,439,137,87,36,0,0,2,0,0,0,1,0,838,5,390
"3627","가창면","가창면제3투","대통령선거","대구광역시","달성군",1699,1215,179,761,155,91,18,2,1,1,0,0,3,2,1,1214,1,484
"3628","가창면","가창면제4투","대통령선거","대구광역시","달성군",1013,696,76,469,78,49,10,2,0,0,0,1,1,2,2,690,6,317
"3629","하빈면","관내사전투표","대통령선거","대구광역시","달성군",559,559,105,321,72,41,16,2,0,0,0,0,0,1,0,558,1,0
"3630","하빈면","하빈면제1투","대통령선거","대구광역시","달성군",1566,1002,127,663,117,48,26,1,2,0,0,0,0,5,2,991,11,564
"3631","하빈면","하빈면제2투","대통령선거","대구광역시","달성군",1375,902,86,622,101,58,24,2,0,0,1,0,1,3,0,898,4,473
"3632","옥포면","관내사전투표","대통령선거","대구광역시","달성군",2069,2068,522,908,280,242,100,2,0,0,0,0,0,1,5,2060,8,1
"3633","옥포면","옥포면제1투","대통령선거","대구광역시","달성군",2480,1631,270,928,200,150,61,6,0,0,1,0,2,2,2,1622,9,849
"3634","옥포면","옥포면제2투","대통령선거","대구광역시","달성군",1654,1166,135,794,125,74,23,6,1,0,0,0,1,2,1,1162,4,488
"3635","옥포면","옥포면제3투","대통령선거","대구광역시","달성군",1703,1205,161,709,171,102,41,6,0,0,2,0,2,2,1,1197,8,498
"3636","옥포면","옥포면제4투","대통령선거","대구광역시","달성군",3418,2315,419,1235,353,206,74,6,0,1,0,1,1,0,3,2299,16,1103
"3637","옥포면","옥포면제5투","대통령선거","대구광역시","달성군",2887,2169,503,906,348,297,98,1,0,2,0,1,0,1,2,2159,10,718
"3638","현풍면","관내사전투표","대통령선거","대구광역시","달성군",2068,2068,605,841,271,191,131,2,0,1,2,1,3,3,2,2053,15,0
"3639","현풍면","현풍면제1투","대통령선거","대구광역시","달성군",2093,1302,222,745,157,98,60,2,0,0,0,0,0,3,4,1291,11,791
"3640","현풍면","현풍면제2투","대통령선거","대구광역시","달성군",1922,1204,185,688,147,90,73,1,0,0,1,0,2,3,5,1195,9,718
"3641","현풍면","현풍면제3투","대통령선거","대구광역시","달성군",1344,867,115,570,89,55,27,1,0,1,0,0,0,1,1,860,7,477
"3642","현풍면","현풍면제4투","대통령선거","대구광역시","달성군",780,549,63,386,55,15,11,0,0,0,1,1,3,3,4,542,7,231
"3643","현풍면","현풍면제5투","대통령선거","대구광역시","달성군",2510,1698,429,570,313,259,114,2,1,1,1,2,0,0,2,1694,4,812
"3644","현풍면","현풍면제6투","대통령선거","대구광역시","달성군",2930,2040,504,818,353,238,113,2,1,1,1,0,0,1,1,2033,7,890
"3645","유가면","관내사전투표","대통령선거","대구광역시","달성군",3653,3653,1354,960,563,506,237,5,0,2,0,7,0,0,4,3638,15,0
"3646","유가면","유가면제1투","대통령선거","대구광역시","달성군",1745,1192,239,553,191,141,57,1,1,0,0,1,0,2,1,1187,5,553
"3647","유가면","유가면제2투","대통령선거","대구광역시","달성군",1052,682,74,496,53,34,17,0,0,0,0,1,0,3,0,678,4,370
"3648","유가면","유가면제3투","대통령선거","대구광역시","달성군",3227,2298,641,764,423,316,134,5,0,0,1,2,0,0,2,2288,10,929
"3649","유가면","유가면제4투","대통령선거","대구광역시","달성군",3236,2343,700,711,434,327,153,2,1,2,0,1,0,2,3,2336,7,893
"3650","유가면","유가면제5투","대통령선거","대구광역시","달성군",3297,2480,799,697,455,350,166,1,1,1,0,0,0,2,4,2476,4,817
"3651","구지면","관내사전투표","대통령선거","대구광역시","달성군",1087,1087,291,492,128,106,57,1,1,0,1,0,1,5,1,1084,3,0
"3652","구지면","구지면제1투","대통령선거","대구광역시","달성군",1000,634,50,477,50,30,13,3,0,1,0,0,0,3,2,629,5,366
"3653","구지면","구지면제2투","대통령선거","대구광역시","달성군",614,444,42,312,45,18,14,1,0,1,1,0,3,2,2,441,3,170
"3654","구지면","구지면제3투","대통령선거","대구광역시","달성군",1063,638,150,257,114,78,35,1,0,0,0,0,0,2,0,637,1,425
"3655","구지면","구지면제4투","대통령선거","대구광역시","달성군",1789,1141,242,587,162,100,42,1,1,0,0,1,0,0,0,1136,5,648
"3656","잘못 투입·구분된 투표지","잘못 투입·구분된 투표지","대통령선거","대구광역시","달성군",0,0,0,0,0,0,0,0,0,0,0,0,0,0,0,0,0,0
"3657","거소·선상투표","거소·선상투표","대통령선거","대전광역시","동구",444,423,162,58,136,27,6,4,1,1,3,0,2,2,2,404,19,21
"3658","관외사전투표","관외사전투표","대통령선거","대전광역시","동구",16304,16299,7630,2374,3458,1231,1406,16,4,5,3,10,4,9,31,16181,118,5
"3659","재외투표","재외투표","대통령선거","대전광역시","동구",781,619,396,46,77,20,75,2,0,1,0,0,0,1,0,618,1,162
"3660","중앙동","관내사전투표","대통령선거","대전광역시","동구",922,922,367,271,194,36,44,0,1,1,2,2,0,0,1,919,3,0
"3661","중앙동","중앙동제1투","대통령선거","대전광역시","동구",1787,965,259,400,240,30,28,0,0,0,0,0,1,1,2,961,4,822
"3662","중앙동","중앙동제2투","대통령선거","대전광역시","동구",865,522,143,207,131,13,25,1,0,1,0,0,0,0,0,521,1,343
"3663","중앙동","중앙동제3투","대통령선거","대전광역시","동구",1793,880,243,340,212,29,43,0,0,3,0,0,0,1,0,871,9,913
"3664","신인동","관내사전투표","대통령선거","대전광역시","동구",3023,3023,1459,591,630,148,172,1,2,0,1,1,0,2,5,3012,11,0
"3665","신인동","신인동제1투","대통령선거","대전광역시","동구",2291,1485,510,439,352,77,90,2,0,2,1,1,0,1,1,1476,9,806
"3666","신인동","신인동제2투","대통령선거","대전광역시","동구",2376,1669,596,439,435,93,94,4,0,4,0,2,0,0,0,1667,2,707
"3667","신인동","신인동제3투","대통령선거","대전광역시","동구",2062,1500,572,359,395,66,91,1,2,5,0,1,0,1,1,1494,6,562
"3668","신인동","신인동제4투","대통령선거","대전광역시","동구",1142,742,212,246,198,34,42,1,0,0,1,0,0,0,3,737,5,400
"3669","효동","관내사전투표","대통령선거","대전광역시","동구",3097,3097,1711,401,587,159,217,6,0,2,0,2,3,1,2,3091,6,0
"3670","효동","효동제1투","대통령선거","대전광역시","동구",2597,1792,580,535,478,92,99,1,0,1,0,0,0,1,2,1789,3,805
"3671","효동","효동제2투","대통령선거","대전광역시","동구",3219,2261,880,520,576,88,172,7,0,2,2,0,1,1,1,2250,11,958
"3672","효동","효동제3투","대통령선거","대전광역시","동구",3399,2156,902,429,558,118,124,4,1,4,1,0,0,1,4,2146,10,1243
"3673","효동","효동제4투","대통령선거","대전광역시","동구",3522,2556,1196,423,630,132,158,3,0,3,0,1,1,1,4,2552,4,966
"3674","효동","효동제5투","대통령선거","대전광역시","동구",2845,2092,946,408,495,106,121,3,0,1,0,1,0,0,1,2082,10,753
"3675","판암1동","관내사전투표","대통령선거","대전광역시","동구",1664,1664,685,348,381,99,137,2,0,0,0,0,1,1,4,1658,6,0
"3676","판암1동","판암1동제1투","대통령선거","대전광역시","동구",2236,1507,527,437,394,65,61,2,1,2,2,1,1,5,1,1499,8,729
"3677","판암1동","판암1동제2투","대통령선거","대전광역시","동구",1796,1180,469,251,294,80,80,0,0,1,0,0,0,2,0,1177,3,616
"3678","판암1동","판암1동제3투","대통령선거","대전광역시","동구",1899,1276,413,347,350,74,87,1,0,0,0,1,0,1,1,1275,1,623
"3679","판암2동","관내사전투표","대통령선거","대전광역시","동구",1894,1894,736,519,452,61,101,3,2,0,2,1,1,1,1,1880,14,0
"3680","판암2동","판암2동제1투","대통령선거","대전광역시","동구",1817,1092,340,355,270,38,71,7,0,3,0,1,0,2,2,1089,3,725
"3681","판암2동","판암2동제2투","대통령선거","대전광역시","동구",2324,1386,394,395,460,63,50,2,3,2,0,1,0,1,2,1373,13,938
"3682","판암2동","판암2동제3투","대통령선거","대전광역시","동구",2758,1768,655,442,451,90,113,3,0,3,0,1,0,1,1,1760,8,990
"3683","용운동","관내사전투표","대통령선거","대전광역시","동구",2544,2544,1141,534,534,140,177,3,1,6,0,2,0,0,2,2540,4,0
"3684","용운동","용운동제1투","대통령선거","대전광역시","동구",1939,1182,416,318,287,64,87,0,0,2,0,0,0,1,0,1175,7,757
"3685","용운동","용운동제2투","대통령선거","대전광역시","동구",2707,1610,544,453,425,68,99,6,2,2,0,2,0,1,0,1602,8,1097
"3686","용운동","용운동제3투","대통령선거","대전광역시","동구",3304,2299,931,533,543,133,143,2,1,0,1,0,0,2,3,2292,7,1005
"3687","용운동","용운동제4투","대통령선거","대전광역시","동구",3020,2111,898,409,521,119,149,1,0,0,0,1,2,0,4,2104,7,909
"3688","대동","관내사전투표","대통령선거","대전광역시","동구",1644,1644,694,354,382,89,111,5,0,2,1,0,0,1,1,1640,4,0
"3689","대동","대동제1투","대통령선거","대전광역시","동구",2879,1866,790,411,444,110,98,2,1,0,0,1,0,1,1,1859,7,1013
"3690","대동","대동제2투","대통령선거","대전광역시","동구",2141,1242,404,374,331,57,67,3,0,0,0,0,0,1,1,1238,4,899
"3691","대동","대동제3투","대통령선거","대전광역시","동구",2710,1828,710,464,460,96,85,1,0,1,0,2,2,1,2,1824,4,882
"3692","자양동","관내사전투표","대통령선거","대전광역시","동구",2366,2366,1052,410,475,180,223,2,0,0,0,4,0,0,3,2349,17,0
"3693","자양동","자양동제1투","대통령선거","대전광역시","동구",2244,1339,476,306,339,85,113,3,2,2,2,3,1,1,0,1333,6,905
"3694","자양동","자양동제2투","대통령선거","대전광역시","동구",2363,1368,467,339,310,107,130,0,0,1,0,2,2,0,3,1361,7,995
"3695","자양동","자양동제3투","대통령선거","대전광역시","동구",2524,1617,550,506,390,76,76,3,0,1,0,4,0,0,1,1607,10,907
"3696","가양1동","관내사전투표","대통령선거","대전광역시","동구",1983,1983,870,467,429,79,118,0,0,3,0,0,2,1,2,1971,12,0
"3697","가양1동","가양1동제1투","대통령선거","대전광역시","동구",2088,1262,389,395,341,64,64,1,0,0,0,0,0,0,1,1255,7,826
"3698","가양1동","가양1동제2투","대통령선거","대전광역시","동구",1580,998,306,320,259,51,57,0,0,1,0,1,0,0,0,995,3,582
"3699","가양1동","가양1동제3투","대통령선거","대전광역시","동구",3401,2281,833,541,616,130,143,2,1,0,0,2,1,1,1,2271,10,1120
"3700","가양1동","가양1동제4투","대통령선거","대전광역시","동구",2497,1598,506,469,408,89,110,0,0,3,1,0,2,1,0,1589,9,899
"3701","가양2동","관내사전투표","대통령선거","대전광역시","동구",2711,2711,1192,560,601,136,196,1,0,3,1,1,0,0,3,2694,17,0
"3702","가양2동","가양2동제1투","대통령선거","대전광역시","동구",3045,2126,805,511,574,108,109,2,0,3,0,1,0,0,4,2117,9,919
"3703","가양2동","가양2동제2투","대통령선거","대전광역시","동구",2563,1629,596,421,398,102,102,0,0,2,0,0,0,4,0,1625,4,934
"3704","가양2동","가양2동제3투","대통령선거","대전광역시","동구",2584,1530,506,392,419,80,117,0,0,0,1,0,0,0,5,1520,10,1054
"3705","가양2동","가양2동제4투","대통령선거","대전광역시","동구",2775,1760,625,466,443,80,125,4,3,2,2,1,1,1,0,1753,7,1015
"3706","가양2동","가양2동제5투","대통령선거","대전광역시","동구",2135,1290,472,354,281,67,103,0,0,0,0,2,0,0,3,1282,8,845
"3707","용전동","관내사전투표","대통령선거","대전광역시","동구",2761,2761,1307,453,616,142,215,2,0,3,0,7,0,2,3,2750,11,0
"3708","용전동","용전동제1투","대통령선거","대전광역시","동구",3179,2088,818,482,512,107,154,0,1,0,1,5,0,0,2,2082,6,1091
"3709","용전동","용전동제2투","대통령선거","대전광역시","동구",3201,1997,721,461,548,106,147,1,0,2,2,0,1,0,1,1990,7,1204
"3710","용전동","용전동제3투","대통령선거","대전광역시","동구",3769,2166,802,523,554,128,140,1,1,2,0,0,2,0,3,2156,10,1603
"3711","용전동","용전동제4투","대통령선거","대전광역시","동구",3217,2107,856,469,499,117,150,3,0,1,0,1,1,2,1,2100,7,1110
"3712","성남동","관내사전투표","대통령선거","대전광역시","동구",1897,1897,878,363,413,99,125,1,1,6,1,0,1,1,0,1889,8,0
"3713","성남동","성남동제1투","대통령선거","대전광역시","동구",3572,2535,977,585,675,129,154,1,1,0,2,1,1,1,2,2529,6,1037
"3714","성남동","성남동제2투","대통령선거","대전광역시","동구",2043,1371,474,388,377,61,58,2,0,1,1,1,0,1,1,1365,6,672
"3715","성남동","성남동제3투","대통령선거","대전광역시","동구",2799,1801,655,451,482,87,111,2,0,4,0,1,1,0,0,1794,7,998
"3716","홍도동","관내사전투표","대통령선거","대전광역시","동구",1922,1922,893,342,409,102,164,0,0,1,1,1,0,0,1,1914,8,0
"3717","홍도동","홍도동제1투","대통령선거","대전광역시","동구",1739,1183,383,355,318,52,67,0,1,1,2,0,1,1,0,1181,2,556
"3718","홍도동","홍도동제2투","대통령선거","대전광역시","동구",3041,2094,807,522,536,96,113,4,0,2,2,1,2,0,4,2089,5,947
"3719","홍도동","홍도동제3투","대통령선거","대전광역시","동구",2823,1550,572,366,402,89,108,0,0,0,0,1,2,1,0,1541,9,1273
"3720","삼성동","관내사전투표","대통령선거","대전광역시","동구",2011,2011,919,437,434,100,97,0,1,5,0,3,0,1,3,2000,11,0
"3721","삼성동","삼성동제1투","대통령선거","대전광역시","동구",1571,1031,312,352,278,37,45,0,0,1,1,0,0,1,0,1027,4,540
"3722","삼성동","삼성동제2투","대통령선거","대전광역시","동구",1975,1300,482,345,322,80,64,2,2,0,1,0,0,0,1,1299,1,675
"3723","삼성동","삼성동제3투","대통령선거","대전광역시","동구",3453,2402,885,657,602,111,129,4,1,3,0,1,0,0,2,2395,7,1051
"3724","삼성동","삼성동제4투","대통령선거","대전광역시","동구",3313,2081,673,595,559,114,115,4,2,4,1,0,0,1,4,2072,9,1232
"3725","대청동","관내사전투표","대통령선거","대전광역시","동구",340,340,138,104,73,12,11,0,0,0,1,0,0,1,0,340,0,0
"3726","대청동","대청동제1투","대통령선거","대전광역시","동구",887,588,171,242,135,10,24,4,0,0,0,0,1,0,0,587,1,299
"3727","대청동","대청동제2투","대통령선거","대전광역시","동구",910,565,149,247,127,16,17,1,0,0,0,1,0,1,3,562,3,345
"3728","산내동","관내사전투표","대통령선거","대전광역시","동구",2655,2655,1252,507,585,129,159,4,1,5,1,1,0,2,2,2648,7,0
"3729","산내동","산내동제1투","대통령선거","대전광역시","동구",3507,2280,942,451,606,103,157,7,0,3,0,5,2,1,0,2277,3,1227
"3730","산내동","산내동제2투","대통령선거","대전광역시","동구",816,483,138,171,136,22,7,0,1,0,0,0,0,2,2,479,4,333
"3731","산내동","산내동제3투","대통령선거","대전광역시","동구",2729,2091,922,370,541,107,146,0,0,0,0,1,0,0,2,2089,2,638
"3732","산내동","산내동제4투","대통령선거","대전광역시","동구",2052,1407,524,361,345,87,77,1,0,1,0,0,0,1,0,1397,10,645
"3733","산내동","산내동제5투","대통령선거","대전광역시","동구",981,645,183,198,198,36,24,0,0,0,0,1,0,0,1,641,4,336
"3734","산내동","산내동제6투","대통령선거","대전광역시","동구",2422,1518,591,331,403,88,89,1,1,0,0,3,0,1,5,1513,5,904
"3735","잘못 투입·구분된 투표지","잘못 투입·구분된 투표지","대통령선거","대전광역시","동구",0,0,0,0,0,0,0,0,0,0,0,0,0,0,0,0,0,0
"3736","거소·선상투표","거소·선상투표","대통령선거","대전광역시","중구",497,465,155,74,154,21,20,4,2,3,6,1,1,1,1,443,22,32
"3737","관외사전투표","관외사전투표","대통령선거","대전광역시","중구",17515,17514,8299,2566,3663,1334,1433,26,8,9,6,20,4,9,26,17403,111,1
"3738","재외투표","재외투표","대통령선거","대전광역시","중구",1134,862,545,60,137,38,80,0,0,0,0,0,0,1,0,861,1,272
"3739","은행선화동","관내사전투표","대통령선거","대전광역시","중구",1838,1838,839,397,336,93,160,2,0,1,1,1,1,0,2,1833,5,0
"3740","은행선화동","은행선화동제1투","대통령선거","대전광역시","중구",3044,1763,700,417,421,93,117,3,0,0,1,0,1,1,2,1756,7,1281
"3741","은행선화동","은행선화동제2투","대통령선거","대전광역시","중구",3013,1892,745,435,464,111,127,0,0,2,1,0,0,1,2,1888,4,1121
"3742","은행선화동","은행선화동제3투","대통령선거","대전광역시","중구",3225,1919,715,511,471,102,108,3,0,0,0,2,2,0,2,1916,3,1306
"3743","은행선화동","은행선화동제4투","대통령선거","대전광역시","중구",2450,1268,451,355,285,81,85,1,0,2,0,0,0,0,2,1262,6,1182
"3744","목동","관내사전투표","대통령선거","대전광역시","중구",2636,2636,1394,367,493,182,187,2,0,3,0,1,0,1,1,2631,5,0
"3745","목동","목동제1투","대통령선거","대전광역시","중구",2262,1596,660,382,333,89,122,0,0,2,1,1,1,1,0,1592,4,666
"3746","목동","목동제2투","대통령선거","대전광역시","중구",3131,2233,1009,366,555,123,160,5,1,1,1,1,2,2,0,2226,7,898
"3747","목동","목동제3투","대통령선거","대전광역시","중구",2622,2022,864,392,499,123,135,2,0,2,0,1,0,0,3,2021,1,600
"3748","중촌동","관내사전투표","대통령선거","대전광역시","중구",1972,1972,865,382,448,112,155,1,1,3,0,0,0,0,0,1967,5,0
"3749","중촌동","중촌동제1투","대통령선거","대전광역시","중구",1562,971,334,285,225,74,46,0,1,0,0,1,0,0,2,968,3,591
"3750","중촌동","중촌동제2투","대통령선거","대전광역시","중구",1645,1270,531,289,305,76,64,1,0,2,0,1,0,0,0,1269,1,375
"3751","중촌동","중촌동제3투","대통령선거","대전광역시","중구",2504,1735,648,398,458,102,109,5,0,2,1,0,0,0,1,1724,11,769
"3752","중촌동","중촌동제4투","대통령선거","대전광역시","중구",2503,1832,786,361,442,109,122,1,0,2,0,0,0,0,1,1824,8,671
"3753","중촌동","중촌동제5투","대통령선거","대전광역시","중구",1265,855,267,239,250,40,38,4,0,0,3,2,2,0,1,846,9,410
"3754","대흥동","관내사전투표","대통령선거","대전광역시","중구",2223,2223,1053,398,446,134,171,6,0,1,0,1,1,1,1,2213,10,0
"3755","대흥동","대흥동제1투","대통령선거","대전광역시","중구",3131,1780,689,407,439,98,133,2,0,0,1,0,0,1,3,1773,7,1351
"3756","대흥동","대흥동제2투","대통령선거","대전광역시","중구",2126,1347,490,444,266,65,70,2,0,2,0,1,0,1,0,1341,6,779
"3757","대흥동","대흥동제3투","대통령선거","대전광역시","중구",3288,2344,954,499,631,132,116,2,1,1,1,1,1,0,3,2342,2,944
"3758","문창동","관내사전투표","대통령선거","대전광역시","중구",642,642,256,195,126,24,37,0,0,1,1,0,0,0,1,641,1,0
"3759","문창동","문창동제1투","대통령선거","대전광역시","중구",1574,926,304,310,230,39,35,1,0,1,1,0,0,0,0,921,5,648
"3760","문창동","문창동제2투","대통령선거","대전광역시","중구",2064,1330,379,462,343,51,81,0,0,2,1,1,2,1,0,1323,7,734
"3761","석교동","관내사전투표","대통령선거","대전광역시","중구",1658,1658,691,392,390,68,97,3,0,4,1,3,1,0,0,1650,8,0
"3762","석교동","석교동제1투","대통령선거","대전광역시","중구",2344,1454,467,437,396,68,73,2,0,1,0,0,0,1,0,1445,9,890
"3763","석교동","석교동제2투","대통령선거","대전광역시","중구",2424,1575,527,485,394,61,87,6,0,1,1,1,1,1,1,1566,9,849
"3764","석교동","석교동제3투","대통령선거","대전광역시","중구",2161,1373,477,406,343,59,75,0,0,2,0,2,1,1,1,1367,6,788
"3765","석교동","석교동제4투","대통령선거","대전광역시","중구",2452,1626,523,473,452,64,102,1,0,1,1,0,1,0,2,1620,6,826
"3766","석교동","석교동제5투","대통령선거","대전광역시","중구",2493,1700,511,467,509,78,110,5,0,1,0,0,2,3,2,1688,12,793
"3767","대사동","관내사전투표","대통령선거","대전광역시","중구",1722,1722,714,460,345,84,101,2,1,0,1,1,1,0,2,1712,10,0
"3768","대사동","대사동제1투","대통령선거","대전광역시","중구",2477,1579,439,549,431,64,74,2,0,3,3,0,0,1,3,1569,10,898
"3769","대사동","대사동제2투","대통령선거","대전광역시","중구",1430,864,341,207,213,53,45,2,0,0,0,0,0,0,1,862,2,566
"3770","부사동","관내사전투표","대통령선거","대전광역시","중구",963,963,397,237,217,42,55,1,2,1,0,1,0,0,4,957,6,0
"3771","부사동","부사동제1투","대통령선거","대전광역시","중구",2391,1511,478,462,412,73,75,3,0,0,0,0,0,1,0,1504,7,880
"3772","부사동","부사동제2투","대통령선거","대전광역시","중구",2617,1616,540,422,454,78,102,5,0,3,0,2,0,0,2,1608,8,1001
"3773","용두동","관내사전투표","대통령선거","대전광역시","중구",1820,1820,823,383,377,87,135,2,0,0,0,1,0,2,1,1811,9,0
"3774","용두동","용두동제1투","대통령선거","대전광역시","중구",1971,1476,609,305,368,73,106,2,0,3,0,0,0,0,2,1468,8,495
"3775","용두동","용두동제2투","대통령선거","대전광역시","중구",1832,1112,388,325,260,56,71,2,1,1,0,2,0,2,0,1108,4,720
"3776","용두동","용두동제3투","대통령선거","대전광역시","중구",2424,1639,586,392,436,99,118,3,0,2,0,0,0,0,0,1636,3,785
"3777","오류동","관내사전투표","대통령선거","대전광역시","중구",1983,1983,860,443,409,121,136,1,0,2,0,3,0,0,0,1975,8,0
"3778","오류동","오류동제1투","대통령선거","대전광역시","중구",1679,1011,352,272,255,64,55,1,2,3,0,0,0,1,1,1006,5,668
"3779","오류동","오류동제2투","대통령선거","대전광역시","중구",2372,1839,661,532,443,118,74,4,0,1,0,0,0,0,2,1835,4,533
"3780","오류동","오류동제3투","대통령선거","대전광역시","중구",1939,1422,484,440,336,89,59,5,0,0,1,3,0,0,1,1418,4,517
"3781","태평1동","관내사전투표","대통령선거","대전광역시","중구",1917,1917,937,357,408,90,116,1,0,0,1,1,0,0,4,1915,2,0
"3782","태평1동","태평1동제1투","대통령선거","대전광역시","중구",2325,1778,781,329,426,106,125,0,0,1,0,2,0,0,1,1771,7,547
"3783","태평1동","태평1동제2투","대통령선거","대전광역시","중구",2206,1337,443,391,331,72,83,2,1,0,2,0,1,1,1,1328,9,869
"3784","태평1동","태평1동제3투","대통령선거","대전광역시","중구",3872,2991,1312,618,675,177,182,3,1,3,0,6,1,2,1,2981,10,881
"3785","태평2동","관내사전투표","대통령선거","대전광역시","중구",3864,3864,1749,855,809,211,217,5,0,2,2,2,0,2,1,3855,9,0
"3786","태평2동","태평2동제1투","대통령선거","대전광역시","중구",1826,1131,352,361,320,45,45,1,0,0,0,0,2,0,1,1127,4,695
"3787","태평2동","태평2동제2투","대통령선거","대전광역시","중구",2157,1530,509,488,349,81,90,3,1,2,0,1,0,0,1,1525,5,627
"3788","태평2동","태평2동제3투","대통령선거","대전광역시","중구",2740,1924,679,557,465,108,99,8,1,2,0,0,0,0,0,1919,5,816
"3789","태평2동","태평2동제4투","대통령선거","대전광역시","중구",3050,2296,892,574,557,120,139,8,0,0,1,0,0,0,1,2292,4,754
"3790","태평2동","태평2동제5투","대통령선거","대전광역시","중구",2818,2211,798,618,541,136,95,8,1,0,0,0,2,4,1,2204,7,607
"3791","태평2동","태평2동제6투","대통령선거","대전광역시","중구",3602,2853,1047,711,745,172,167,2,0,2,0,0,1,0,0,2847,6,749
"3792","유천1동","관내사전투표","대통령선거","대전광역시","중구",1076,1076,443,261,250,55,62,1,0,0,0,0,0,1,1,1074,2,0
"3793","유천1동","유천1동제1투","대통령선거","대전광역시","중구",2446,1424,430,481,364,58,78,1,0,2,0,1,2,0,0,1417,7,1022
"3794","유천1동","유천1동제2투","대통령선거","대전광역시","중구",2097,1254,424,367,331,68,58,1,0,0,0,0,1,0,0,1250,4,843
"3795","유천2동","관내사전투표","대통령선거","대전광역시","중구",1725,1725,758,395,364,107,88,1,1,2,0,1,1,1,1,1720,5,0
"3796","유천2동","유천2동제1투","대통령선거","대전광역시","중구",1403,951,280,310,250,44,57,1,0,1,0,1,0,1,3,948,3,452
"3797","유천2동","유천2동제2투","대통령선거","대전광역시","중구",2163,1351,473,395,356,56,60,3,0,1,1,0,0,0,1,1346,5,812
"3798","유천2동","유천2동제3투","대통령선거","대전광역시","중구",2575,1764,681,461,416,79,112,3,0,0,2,0,0,3,2,1759,5,811
"3799","유천2동","유천2동제4투","대통령선거","대전광역시","중구",3200,2514,834,831,593,121,117,9,0,0,1,0,1,0,0,2507,7,686
"3800","문화1동","관내사전투표","대통령선거","대전광역시","중구",3256,3256,1490,630,702,189,222,3,2,0,1,2,1,4,1,3247,9,0
"3801","문화1동","문화1동제1투","대통령선거","대전광역시","중구",3386,2458,881,643,640,142,127,2,1,1,1,4,1,4,2,2449,9,928
"3802","문화1동","문화1동제2투","대통령선거","대전광역시","중구",1454,980,338,279,242,42,66,1,0,1,1,0,0,1,2,973,7,474
"3803","문화1동","문화1동제3투","대통령선거","대전광역시","중구",2400,1665,598,409,440,104,99,1,0,1,0,0,0,3,3,1658,7,735
"3804","문화1동","문화1동제4투","대통령선거","대전광역시","중구",3184,2557,1039,570,648,161,124,1,0,5,0,1,0,3,2,2554,3,627
"3805","문화1동","문화1동제5투","대통령선거","대전광역시","중구",2855,2112,833,522,484,138,116,4,0,0,0,2,0,0,0,2099,13,743
"3806","문화2동","관내사전투표","대통령선거","대전광역시","중구",2197,2197,887,512,488,141,142,5,1,2,0,5,2,2,0,2187,10,0
"3807","문화2동","문화2동제1투","대통령선거","대전광역시","중구",1640,1016,316,323,255,54,58,0,0,1,1,0,1,2,3,1014,2,624
"3808","문화2동","문화2동제2투","대통령선거","대전광역시","중구",2805,1898,664,514,490,88,128,2,3,1,1,1,0,1,3,1896,2,907
"3809","문화2동","문화2동제3투","대통령선거","대전광역시","중구",2237,1461,504,416,353,87,83,3,1,2,1,1,1,0,1,1453,8,776
"3810","문화2동","문화2동제4투","대통령선거","대전광역시","중구",2250,1507,549,384,384,88,89,1,0,1,1,1,1,0,1,1500,7,743
"3811","산성동","관내사전투표","대통령선거","대전광역시","중구",2641,2641,1073,641,613,137,158,5,0,2,1,1,1,0,3,2635,6,0
"3812","산성동","산성동제1투","대통령선거","대전광역시","중구",2135,1286,383,411,328,65,82,2,0,0,0,2,0,2,2,1277,9,849
"3813","산성동","산성동제2투","대통령선거","대전광역시","중구",2347,1588,548,419,434,93,77,3,0,0,0,0,0,1,3,1578,10,759
"3814","산성동","산성동제3투","대통령선거","대전광역시","중구",3141,1813,626,504,470,90,101,8,0,2,0,3,2,1,2,1809,4,1328
"3815","산성동","산성동제4투","대통령선거","대전광역시","중구",2408,1782,586,494,489,103,98,1,0,1,1,2,0,1,0,1776,6,626
"3816","산성동","산성동제5투","대통령선거","대전광역시","중구",2481,1566,555,406,415,88,86,4,0,4,0,0,1,0,3,1562,4,915
"3817","산성동","산성동제6투","대통령선거","대전광역시","중구",3273,2082,714,485,593,112,148,4,0,4,1,5,1,1,2,2070,12,1191
"3818","산성동","산성동제7투","대통령선거","대전광역시","중구",3113,2016,790,495,489,97,128,3,0,2,0,0,2,2,2,2010,6,1097
"3819","산성동","산성동제8투","대통령선거","대전광역시","중구",734,447,119,160,137,15,12,0,0,0,0,0,0,1,0,444,3,287
"3820","잘못 투입·구분된 투표지","잘못 투입·구분된 투표지","대통령선거","대전광역시","중구",0,0,0,0,0,0,0,0,0,0,0,0,0,0,0,0,0,0
"3821","거소·선상투표","거소·선상투표","대통령선거","대전광역시","서구",753,722,258,101,261,49,18,3,2,4,1,3,1,0,1,702,20,31
"3822","관외사전투표","관외사전투표","대통령선거","대전광역시","서구",36372,36360,17522,4755,7697,2936,3035,44,8,17,9,31,9,17,48,36128,232,12
"3823","재외투표","재외투표","대통령선거","대전광역시","서구",2274,1855,1102,115,302,73,245,9,0,0,1,0,0,0,1,1848,7,419
"3824","복수동","관내사전투표","대통령선거","대전광역시","서구",2856,2856,1397,507,617,150,166,3,0,0,0,3,1,0,2,2846,10,0
"3825","복수동","복수동제1투","대통령선거","대전광역시","서구",2367,1590,555,432,402,89,101,0,0,0,3,1,0,3,1,1587,3,777
"3826","복수동","복수동제2투","대통령선거","대전광역시","서구",2826,2036,817,451,512,132,113,2,0,0,0,1,0,1,0,2029,7,790
"3827","복수동","복수동제3투","대통령선거","대전광역시","서구",3066,2404,1107,500,549,132,107,2,0,0,0,0,1,0,0,2398,6,662
"3828","복수동","복수동제4투","대통령선거","대전광역시","서구",3272,2118,895,373,547,134,163,2,0,1,1,0,0,0,0,2116,2,1154
"3829","도마1동","관내사전투표","대통령선거","대전광역시","서구",1489,1489,615,349,329,87,95,0,0,2,0,0,1,1,1,1480,9,0
"3830","도마1동","도마1동제1투","대통령선거","대전광역시","서구",2305,1403,414,432,403,59,86,4,0,1,0,1,1,0,0,1401,2,902
"3831","도마1동","도마1동제2투","대통령선거","대전광역시","서구",2736,1827,582,531,489,104,113,1,0,1,0,0,0,0,0,1821,6,909
"3832","도마1동","도마1동제3투","대통령선거","대전광역시","서구",1785,1141,362,338,312,64,58,0,0,3,0,1,0,0,0,1138,3,644
"3833","도마1동","도마1동제4투","대통령선거","대전광역시","서구",2347,1386,459,368,401,63,90,0,1,0,0,1,0,0,1,1384,2,961
"3834","도마1동","도마1동제5투","대통령선거","대전광역시","서구",2440,1460,505,370,385,83,103,1,0,0,1,3,0,0,2,1453,7,980
"3835","도마2동","관내사전투표","대통령선거","대전광역시","서구",2688,2688,1161,562,617,151,175,3,0,1,0,4,2,0,3,2679,9,0
"3836","도마2동","도마2동제1투","대통령선거","대전광역시","서구",2659,1522,498,439,405,69,100,1,1,3,0,0,1,0,1,1518,4,1137
"3837","도마2동","도마2동제2투","대통령선거","대전광역시","서구",2678,1654,558,507,397,83,94,1,2,1,0,2,2,1,1,1649,5,1024
"3838","도마2동","도마2동제3투","대통령선거","대전광역시","서구",2104,1252,379,383,345,52,78,1,0,2,0,3,0,2,4,1249,3,852
"3839","도마2동","도마2동제4투","대통령선거","대전광역시","서구",2950,1996,718,499,507,133,124,2,0,1,0,2,1,1,2,1990,6,954
"3840","도마2동","도마2동제5투","대통령선거","대전광역시","서구",2903,2205,702,634,575,150,130,2,0,1,0,1,0,1,1,2197,8,698
"3841","정림동","관내사전투표","대통령선거","대전광역시","서구",3368,3368,1431,748,742,162,255,3,0,5,0,2,1,3,3,3355,13,0
"3842","정림동","정림동제1투","대통령선거","대전광역시","서구",2104,1425,563,329,341,90,91,3,2,3,0,0,0,1,0,1423,2,679
"3843","정림동","정림동제2투","대통령선거","대전광역시","서구",2099,1547,613,354,370,94,104,1,0,2,1,1,0,0,2,1542,5,552
"3844","정림동","정림동제3투","대통령선거","대전광역시","서구",1807,1161,415,280,299,73,78,1,0,2,0,1,1,1,2,1153,8,646
"3845","정림동","정림동제4투","대통령선거","대전광역시","서구",2073,1314,466,352,329,73,83,0,0,2,0,1,1,1,1,1309,5,759
"3846","정림동","정림동제5투","대통령선거","대전광역시","서구",2221,1630,633,314,437,100,130,3,0,5,0,1,1,1,0,1625,5,591
"3847","변동","관내사전투표","대통령선거","대전광역시","서구",1927,1927,843,456,401,83,129,1,1,1,0,0,0,0,4,1919,8,0
"3848","변동","변동제1투","대통령선거","대전광역시","서구",2526,1556,532,426,399,59,122,4,0,3,0,2,1,2,0,1550,6,970
"3849","변동","변동제2투","대통령선거","대전광역시","서구",3923,2487,912,646,630,121,163,3,0,1,0,1,0,0,1,2478,9,1436
"3850","변동","변동제3투","대통령선거","대전광역시","서구",2000,1240,406,319,324,76,103,0,0,0,0,2,1,1,1,1233,7,760
"3851","변동","변동제4투","대통령선거","대전광역시","서구",2666,1651,580,463,418,84,97,0,0,1,2,0,1,1,1,1648,3,1015
"3852","용문동","관내사전투표","대통령선거","대전광역시","서구",2115,2115,965,404,439,122,170,1,0,2,0,2,0,1,1,2107,8,0
"3853","용문동","용문동제1투","대통령선거","대전광역시","서구",3847,2088,825,475,489,112,172,2,1,2,2,1,1,0,1,2083,5,1759
"3854","용문동","용문동제2투","대통령선거","대전광역시","서구",3133,2117,737,550,538,121,151,5,0,1,2,1,1,4,3,2114,3,1016
"3855","용문동","용문동제3투","대통령선거","대전광역시","서구",3193,2141,700,589,587,101,150,1,0,1,0,1,1,1,2,2134,7,1052
"3856","탄방동","관내사전투표","대통령선거","대전광역시","서구",3260,3260,1663,477,641,215,237,3,0,6,0,2,1,1,3,3249,11,0
"3857","탄방동","탄방동제1투","대통령선거","대전광역시","서구",3472,1875,739,392,488,105,139,2,0,0,0,0,1,1,2,1869,6,1597
"3858","탄방동","탄방동제2투","대통령선거","대전광역시","서구",3553,2297,925,476,524,162,191,5,0,1,0,2,0,1,1,2288,9,1256
"3859","탄방동","탄방동제3투","대통령선거","대전광역시","서구",1847,1421,580,281,363,88,103,1,0,0,0,0,0,1,0,1417,4,426
"3860","탄방동","탄방동제4투","대통령선거","대전광역시","서구",1646,1278,512,252,299,105,103,3,0,0,0,0,0,0,1,1275,3,368
"3861","탄방동","탄방동제5투","대통령선거","대전광역시","서구",2968,2082,889,386,516,145,128,0,0,1,1,5,1,3,3,2078,4,886
"3862","탄방동","탄방동제6투","대통령선거","대전광역시","서구",3443,2362,987,457,576,152,174,3,0,1,0,1,0,1,1,2353,9,1081
"3863","둔산1동","관내사전투표","대통령선거","대전광역시","서구",5823,5823,3010,778,1064,445,482,8,0,1,0,7,0,1,2,5798,25,0
"3864","둔산1동","둔산1동제1투","대통령선거","대전광역시","서구",2283,1707,610,452,454,119,58,3,0,0,0,1,0,1,1,1699,8,576
"3865","둔산1동","둔산1동제2투","대통령선거","대전광역시","서구",2086,1744,696,366,452,143,78,4,0,0,0,0,0,0,0,1739,5,342
"3866","둔산1동","둔산1동제3투","대통령선거","대전광역시","서구",2357,1880,745,489,393,144,100,1,0,1,0,1,1,1,0,1876,4,477
"3867","둔산1동","둔산1동제4투","대통령선거","대전광역시","서구",2019,1658,616,447,401,114,73,2,0,1,1,0,0,0,1,1656,2,361
"3868","둔산2동","관내사전투표","대통령선거","대전광역시","서구",4239,4239,2302,505,806,302,306,5,0,0,0,4,0,0,2,4232,7,0
"3869","둔산2동","둔산2동제1투","대통령선거","대전광역시","서구",3294,2624,1158,519,600,178,154,1,0,0,0,2,0,0,1,2613,11,670
"3870","둔산2동","둔산2동제2투","대통령선거","대전광역시","서구",3205,2565,1224,432,545,182,168,3,1,2,0,1,0,1,1,2560,5,640
"3871","둔산2동","둔산2동제3투","대통령선거","대전광역시","서구",3421,2727,1152,554,646,191,165,6,1,1,2,3,1,0,0,2722,5,694
"3872","둔산2동","둔산2동제4투","대통령선거","대전광역시","서구",2863,2331,962,498,572,146,139,2,0,3,0,1,0,0,0,2323,8,532
"3873","둔산2동","둔산2동제5투","대통령선거","대전광역시","서구",2837,2348,1127,328,526,210,147,2,0,1,0,1,1,1,1,2345,3,489
"3874","둔산2동","둔산2동제6투","대통령선거","대전광역시","서구",2813,2387,1303,295,465,180,141,0,0,0,0,0,0,0,1,2385,2,426
"3875","둔산2동","둔산2동제7투","대통령선거","대전광역시","서구",2578,1505,707,228,332,105,123,2,1,1,0,0,1,0,0,1500,5,1073
"3876","둔산3동","관내사전투표","대통령선거","대전광역시","서구",4198,4198,2016,818,841,267,235,2,0,1,1,0,1,0,0,4182,16,0
"3877","둔산3동","둔산3동제1투","대통령선거","대전광역시","서구",2091,1570,662,359,372,97,73,0,0,0,0,4,1,0,0,1568,2,521
"3878","둔산3동","둔산3동제2투","대통령선거","대전광역시","서구",2578,2031,786,469,522,142,103,1,0,0,0,2,0,2,1,2028,3,547
"3879","둔산3동","둔산3동제3투","대통령선거","대전광역시","서구",2050,1630,551,474,407,123,72,1,0,0,0,0,0,0,0,1628,2,420
"3880","둔산3동","둔산3동제4투","대통령선거","대전광역시","서구",3146,2236,851,555,552,124,133,4,0,0,1,3,1,1,1,2226,10,910
"3881","둔산3동","둔산3동제5투","대통령선거","대전광역시","서구",1824,1163,416,339,303,46,39,3,0,2,0,1,1,1,3,1154,9,661
"3882","괴정동","관내사전투표","대통령선거","대전광역시","서구",2703,2703,1353,380,530,185,240,2,0,0,1,1,0,1,0,2693,10,0
"3883","괴정동","괴정동제1투","대통령선거","대전광역시","서구",3823,2213,904,458,532,126,172,2,1,4,0,0,1,0,3,2203,10,1610
"3884","괴정동","괴정동제2투","대통령선거","대전광역시","서구",4296,2327,997,426,520,150,214,3,0,5,1,0,0,1,1,2318,9,1969
"3885","괴정동","괴정동제3투","대통령선거","대전광역시","서구",2588,1532,577,368,377,80,120,1,0,2,0,0,0,1,1,1527,5,1056
"3886","괴정동","괴정동제4투","대통령선거","대전광역시","서구",2269,1589,630,358,367,105,123,1,0,0,0,1,0,0,0,1585,4,680
"3887","가장동","관내사전투표","대통령선거","대전광역시","서구",1405,1405,589,355,305,56,93,1,1,0,0,1,1,0,1,1403,2,0
"3888","가장동","가장동제1투","대통령선거","대전광역시","서구",1435,843,302,249,207,30,49,0,0,1,0,1,0,0,1,840,3,592
"3889","가장동","가장동제2투","대통령선거","대전광역시","서구",1974,1310,442,317,349,70,123,1,1,1,0,1,0,1,1,1307,3,664
"3890","가장동","가장동제3투","대통령선거","대전광역시","서구",2713,2170,805,565,507,149,129,1,0,2,1,2,0,1,1,2163,7,543
"3891","가장동","가장동제4투","대통령선거","대전광역시","서구",2161,1611,608,415,398,78,102,0,0,1,0,2,0,1,1,1606,5,550
"3892","내동","관내사전투표","대통령선거","대전광역시","서구",3113,3113,1450,617,649,179,207,1,0,1,0,1,2,0,1,3108,5,0
"3893","내동","내동제1투","대통령선거","대전광역시","서구",2221,1505,588,372,368,81,86,2,0,1,0,0,0,1,0,1499,6,716
"3894","내동","내동제2투","대통령선거","대전광역시","서구",2365,1425,487,421,355,72,82,1,1,2,0,1,0,0,0,1422,3,940
"3895","내동","내동제3투","대통령선거","대전광역시","서구",3617,2480,956,559,591,177,178,0,1,2,1,0,0,1,3,2469,11,1137
"3896","내동","내동제4투","대통령선거","대전광역시","서구",3181,2637,973,674,642,169,162,1,0,0,1,0,1,2,2,2627,10,544
"3897","내동","내동제5투","대통령선거","대전광역시","서구",3068,2376,955,484,622,156,148,1,0,2,1,1,0,2,0,2372,4,692
"3898","갈마1동","관내사전투표","대통령선거","대전광역시","서구",3550,3550,1570,735,753,212,258,6,0,0,0,8,0,2,1,3545,5,0
"3899","갈마1동","갈마1동제1투","대통령선거","대전광역시","서구",2122,1604,638,420,339,100,94,2,1,1,0,3,0,0,1,1599,5,518
"3900","갈마1동","갈마1동제2투","대통령선거","대전광역시","서구",2148,1433,519,353,333,97,125,2,0,0,1,1,0,0,1,1432,1,715
"3901","갈마1동","갈마1동제3투","대통령선거","대전광역시","서구",3315,1856,740,381,463,119,145,1,1,0,0,2,0,0,0,1852,4,1459
"3902","갈마1동","갈마1동제4투","대통령선거","대전광역시","서구",2840,1751,663,405,429,101,136,2,0,2,1,0,0,1,3,1743,8,1089
"3903","갈마1동","갈마1동제5투","대통령선거","대전광역시","서구",3046,1851,765,380,432,130,120,7,0,1,0,4,0,1,5,1845,6,1195
"3904","갈마2동","관내사전투표","대통령선거","대전광역시","서구",4197,4197,2112,568,808,302,362,1,0,4,1,5,0,1,5,4169,28,0
"3905","갈마2동","갈마2동제1투","대통령선거","대전광역시","서구",3310,1573,694,246,333,115,170,1,0,2,1,3,0,0,2,1567,6,1737
"3906","갈마2동","갈마2동제2투","대통령선거","대전광역시","서구",3174,2221,957,423,541,132,154,4,0,1,0,3,1,0,1,2217,4,953
"3907","갈마2동","갈마2동제3투","대통령선거","대전광역시","서구",2922,2054,920,344,494,114,171,0,1,2,0,0,0,0,2,2048,6,868
"3908","갈마2동","갈마2동제4투","대통령선거","대전광역시","서구",2798,1575,690,294,346,93,140,1,0,0,0,5,0,1,1,1571,4,1223
"3909","갈마2동","갈마2동제5투","대통령선거","대전광역시","서구",3464,2221,911,495,512,141,139,3,0,1,1,1,0,1,1,2206,15,1243
"3910","월평1동","관내사전투표","대통령선거","대전광역시","서구",2099,2099,992,330,475,123,161,0,0,0,0,3,0,1,1,2086,13,0
"3911","월평1동","월평1동제1투","대통령선거","대전광역시","서구",2248,1268,485,289,331,61,94,0,0,0,0,1,0,0,1,1262,6,980
"3912","월평1동","월평1동제2투","대통령선거","대전광역시","서구",2472,1522,602,353,358,102,100,3,0,0,0,0,0,0,0,1518,4,950
"3913","월평1동","월평1동제3투","대통령선거","대전광역시","서구",2345,1244,498,262,299,88,85,0,0,1,0,2,1,0,3,1239,5,1101
"3914","월평2동","관내사전투표","대통령선거","대전광역시","서구",2898,2898,1261,585,653,185,196,2,1,1,0,1,0,0,2,2887,11,0
"3915","월평2동","월평2동제1투","대통령선거","대전광역시","서구",1972,1128,414,272,307,58,64,2,0,2,0,1,1,0,3,1124,4,844
"3916","월평2동","월평2동제2투","대통령선거","대전광역시","서구",2622,2076,870,453,487,145,109,6,0,0,0,2,0,0,1,2073,3,546
"3917","월평2동","월평2동제3투","대통령선거","대전광역시","서구",2283,1455,503,376,413,65,76,2,0,0,3,1,1,1,2,1443,12,828
"3918","월평2동","월평2동제4투","대통령선거","대전광역시","서구",2798,2108,722,580,513,168,110,1,1,1,1,1,2,1,2,2103,5,690
"3919","월평3동","관내사전투표","대통령선거","대전광역시","서구",4879,4879,2475,762,958,347,314,0,0,3,0,5,3,2,3,4872,7,0
"3920","월평3동","월평3동제1투","대통령선거","대전광역시","서구",2155,1639,670,359,405,99,97,1,0,1,0,1,0,0,0,1633,6,516
"3921","월평3동","월평3동제2투","대통령선거","대전광역시","서구",2182,1708,750,304,429,102,113,2,0,1,1,1,0,1,0,1704,4,474
"3922","월평3동","월평3동제3투","대통령선거","대전광역시","서구",2893,2269,1031,385,546,165,129,0,2,2,1,1,0,1,3,2266,3,624
"3923","월평3동","월평3동제4투","대통령선거","대전광역시","서구",2679,2126,775,501,536,186,118,1,0,4,0,0,0,1,1,2123,3,553
"3924","월평3동","월평3동제5투","대통령선거","대전광역시","서구",2330,1808,745,363,448,129,115,0,0,1,1,1,0,1,1,1805,3,522
"3925","만년동","관내사전투표","대통령선거","대전광역시","서구",2964,2964,1528,409,591,205,222,3,0,0,0,1,0,2,0,2961,3,0
"3926","만년동","만년동제1투","대통령선거","대전광역시","서구",3105,2137,959,334,536,144,149,3,1,2,0,0,1,0,1,2130,7,968
"3927","만년동","만년동제2투","대통령선거","대전광역시","서구",1712,1394,653,202,319,115,95,2,0,0,0,0,1,1,1,1389,5,318
"3928","만년동","만년동제3투","대통령선거","대전광역시","서구",2289,1845,788,379,441,120,109,2,0,1,0,1,1,1,0,1843,2,444
"3929","가수원동","관내사전투표","대통령선거","대전광역시","서구",3926,3926,1915,675,776,258,275,7,1,0,0,2,0,2,0,3911,15,0
"3930","가수원동","가수원동제1투","대통령선거","대전광역시","서구",2154,1418,509,316,381,89,111,1,0,3,0,2,1,1,1,1415,3,736
"3931","가수원동","가수원동제2투","대통령선거","대전광역시","서구",2498,1709,605,483,413,105,93,0,1,2,0,0,1,2,1,1706,3,789
"3932","가수원동","가수원동제3투","대통령선거","대전광역시","서구",2762,1791,699,424,450,84,121,2,0,2,0,0,0,3,2,1787,4,971
"3933","가수원동","가수원동제4투","대통령선거","대전광역시","서구",2420,1918,1021,243,411,130,107,4,0,0,0,0,0,0,0,1916,2,502
"3934","가수원동","가수원동제5투","대통령선거","대전광역시","서구",2931,2358,1133,378,515,167,154,3,1,0,0,1,0,0,0,2352,6,573
"3935","가수원동","가수원동제6투","대통령선거","대전광역시","서구",2032,1628,912,170,342,100,96,1,0,0,1,1,0,0,2,1625,3,404
"3936","가수원동","가수원동제7투","대통령선거","대전광역시","서구",2024,1666,813,217,405,124,101,1,0,0,0,0,0,0,1,1662,4,358
"3937","가수원동","가수원동제8투","대통령선거","대전광역시","서구",1659,1402,686,183,340,112,71,0,0,1,0,1,0,0,3,1397,5,257
"3938","가수원동","가수원동제9투","대통령선거","대전광역시","서구",3608,2838,1405,367,700,185,167,6,1,2,0,0,0,0,0,2833,5,770
"3939","관저1동","관내사전투표","대통령선거","대전광역시","서구",3337,3337,1723,512,604,212,258,4,1,1,0,3,1,3,2,3324,13,0
"3940","관저1동","관저1동제1투","대통령선거","대전광역시","서구",2954,1988,883,310,449,152,178,1,0,3,0,1,1,2,1,1981,7,966
"3941","관저1동","관저1동제2투","대통령선거","대전광역시","서구",2059,1546,592,336,394,126,88,0,1,0,2,0,0,1,1,1541,5,513
"3942","관저1동","관저1동제3투","대통령선거","대전광역시","서구",3620,2607,1164,454,618,157,196,1,1,0,0,1,1,0,3,2596,11,1013
"3943","관저2동","관내사전투표","대통령선거","대전광역시","서구",6187,6187,3215,779,1320,375,456,8,0,2,1,9,1,0,4,6170,17,0
"3944","관저2동","관저2동제1투","대통령선거","대전광역시","서구",3194,2218,933,395,576,151,143,3,0,1,1,0,0,1,1,2205,13,976
"3945","관저2동","관저2동제2투","대통령선거","대전광역시","서구",3526,2670,1185,416,671,198,176,1,0,1,1,0,0,2,4,2655,15,856
"3946","관저2동","관저2동제3투","대통령선거","대전광역시","서구",2996,2091,972,279,499,140,190,0,0,2,0,2,0,0,3,2087,4,905
"3947","관저2동","관저2동제4투","대통령선거","대전광역시","서구",3491,2524,1157,431,574,164,189,1,0,0,0,1,2,0,1,2520,4,967
"3948","관저2동","관저2동제5투","대통령선거","대전광역시","서구",3738,2717,1206,540,583,197,177,2,0,1,1,0,0,3,1,2711,6,1021
"3949","관저2동","관저2동제6투","대통령선거","대전광역시","서구",3252,2314,1156,285,509,159,188,5,0,0,1,3,1,0,3,2310,4,938
"3950","기성동","관내사전투표","대통령선거","대전광역시","서구",776,776,268,261,148,23,41,5,0,0,2,3,0,5,3,759,17,0
"3951","기성동","기성동제1투","대통령선거","대전광역시","서구",678,398,97,166,104,12,14,0,0,0,0,0,0,1,3,397,1,280
"3952","기성동","기성동제2투","대통령선거","대전광역시","서구",1102,650,217,188,159,29,28,3,3,0,1,1,1,2,2,634,16,452
"3953","기성동","기성동제3투","대통령선거","대전광역시","서구",1106,732,206,248,188,22,24,4,4,4,1,1,1,3,7,713,19,374
"3954","잘못 투입·구분된 투표지","잘못 투입·구분된 투표지","대통령선거","대전광역시","서구",0,1,0,0,1,0,0,0,0,0,0,0,0,0,0,1,0,-1
"3955","거소·선상투표","거소·선상투표","대통령선거","대전광역시","유성구",478,449,169,76,123,38,12,1,0,3,1,1,1,0,5,430,19,29
"3956","관외사전투표","관외사전투표","대통령선거","대전광역시","유성구",29188,29187,14366,3810,5969,2491,2299,11,4,15,3,16,14,7,31,29036,151,1
"3957","재외투표","재외투표","대통령선거","대전광역시","유성구",2123,1712,984,120,293,68,232,4,0,1,0,1,1,0,0,1704,8,411
"3958","진잠동","관내사전투표","대통령선거","대전광역시","유성구",3667,3667,1728,628,797,236,249,2,1,3,0,6,1,1,0,3652,15,0
"3959","진잠동","진잠동제1투","대통령선거","대전광역시","유성구",3258,1839,683,440,477,88,130,2,0,6,0,0,1,0,0,1827,12,1419
"3960","진잠동","진잠동제2투","대통령선거","대전광역시","유성구",2452,1805,755,346,445,112,137,3,0,0,0,1,1,0,1,1801,4,647
"3961","진잠동","진잠동제3투","대통령선거","대전광역시","유성구",2410,1774,724,346,433,127,126,4,0,0,0,1,1,0,5,1767,7,636
"3962","진잠동","진잠동제4투","대통령선거","대전광역시","유성구",2272,1143,414,310,274,72,57,1,3,0,1,2,0,0,4,1138,5,1129
"3963","진잠동","진잠동제5투","대통령선거","대전광역시","유성구",385,266,61,97,77,14,16,0,0,0,0,0,0,1,0,266,0,119
"3964","진잠동","진잠동제6투","대통령선거","대전광역시","유성구",551,354,110,117,102,10,12,0,0,0,1,0,1,0,0,353,1,197
"3965","진잠동","진잠동제7투","대통령선거","대전광역시","유성구",2877,2133,1003,398,478,104,141,1,0,3,0,3,0,1,0,2132,1,744
"3966","진잠동","진잠동제8투","대통령선거","대전광역시","유성구",2643,1968,881,368,479,117,117,1,0,0,0,1,0,0,1,1965,3,675
"3967","진잠동","진잠동제9투","대통령선거","대전광역시","유성구",2953,2296,1027,467,523,156,113,5,0,0,1,0,0,0,1,2293,3,657
"3968","온천1동","관내사전투표","대통령선거","대전광역시","유성구",6037,6037,2902,1010,1242,391,447,5,1,6,1,6,1,1,2,6015,22,0
"3969","온천1동","온천1동제1투","대통령선거","대전광역시","유성구",3406,2007,729,470,545,113,124,1,0,5,2,5,0,1,3,1998,9,1399
"3970","온천1동","온천1동제2투","대통령선거","대전광역시","유성구",3693,2262,784,592,577,147,148,1,1,2,0,1,0,2,4,2259,3,1431
"3971","온천1동","온천1동제3투","대통령선거","대전광역시","유성구",3860,2720,1037,606,683,191,180,5,0,3,0,4,0,2,0,2711,9,1140
"3972","온천1동","온천1동제4투","대통령선거","대전광역시","유성구",3369,1941,722,447,465,141,141,3,0,0,0,4,1,2,0,1926,15,1428
"3973","온천1동","온천1동제5투","대통령선거","대전광역시","유성구",2668,1678,846,198,332,158,138,0,0,0,0,0,0,0,1,1673,5,990
"3974","온천1동","온천1동제6투","대통령선거","대전광역시","유성구",2577,1585,683,279,349,144,113,4,0,0,1,0,0,2,2,1577,8,992
"3975","온천2동","관내사전투표","대통령선거","대전광역시","유성구",5027,5027,2623,578,930,471,394,1,0,1,0,3,2,4,2,5009,18,0
"3976","온천2동","온천2동제1투","대통령선거","대전광역시","유성구",3317,2000,695,529,525,96,141,4,1,2,0,0,0,0,0,1993,7,1317
"3977","온천2동","온천2동제2투","대통령선거","대전광역시","유성구",2885,1918,727,504,459,110,109,1,0,0,1,0,0,2,0,1913,5,967
"3978","온천2동","온천2동제3투","대통령선거","대전광역시","유성구",2116,1449,632,269,265,159,115,0,0,1,1,1,0,0,2,1445,4,667
"3979","온천2동","온천2동제4투","대통령선거","대전광역시","유성구",1851,1432,617,276,338,110,81,4,0,1,0,0,0,0,0,1427,5,419
"3980","온천2동","온천2동제5투","대통령선거","대전광역시","유성구",1885,1543,713,265,357,111,89,3,0,1,2,0,0,0,1,1542,1,342
"3981","온천2동","온천2동제6투","대통령선거","대전광역시","유성구",1969,1538,752,239,303,144,91,2,0,0,1,0,0,2,0,1534,4,431
"3982","온천2동","온천2동제7투","대통령선거","대전광역시","유성구",2911,2202,860,542,512,171,110,0,0,1,0,0,0,0,0,2196,6,709
"3983","온천2동","온천2동제8투","대통령선거","대전광역시","유성구",2391,1886,887,281,417,154,141,0,0,0,0,0,0,1,0,1881,5,505
"3984","온천2동","온천2동제9투","대통령선거","대전광역시","유성구",2238,1835,776,297,468,180,102,6,0,0,0,0,0,0,1,1830,5,403
"3985","노은1동","관내사전투표","대통령선거","대전광역시","유성구",5937,5937,3168,816,1125,383,411,3,0,2,1,3,3,3,3,5921,16,0
"3986","노은1동","노은1동제1투","대통령선거","대전광역시","유성구",2375,1758,929,223,329,141,124,1,0,1,0,0,1,2,1,1752,6,617
"3987","노은1동","노은1동제2투","대통령선거","대전광역시","유성구",2598,2074,975,394,433,151,115,1,0,0,2,1,0,0,0,2072,2,524
"3988","노은1동","노은1동제3투","대통령선거","대전광역시","유성구",3300,2463,1152,395,571,175,160,4,0,1,0,0,0,0,0,2458,5,837
"3989","노은1동","노은1동제4투","대통령선거","대전광역시","유성구",2858,1993,787,494,466,148,86,3,0,1,1,2,1,1,1,1991,2,865
"3990","노은2동","관내사전투표","대통령선거","대전광역시","유성구",3366,3366,1748,464,628,247,258,2,0,3,1,5,0,2,3,3361,5,0
"3991","노은2동","노은2동제1투","대통령선거","대전광역시","유성구",3162,2559,1249,503,504,171,121,4,0,0,0,0,0,2,1,2555,4,603
"3992","노은2동","노은2동제2투","대통령선거","대전광역시","유성구",3264,2566,1294,409,562,185,107,4,0,0,0,0,0,0,1,2562,4,698
"3993","노은2동","노은2동제3투","대통령선거","대전광역시","유성구",2481,1847,908,336,384,113,92,4,0,0,0,2,0,1,0,1840,7,634
"3994","노은2동","노은2동제4투","대통령선거","대전광역시","유성구",2624,1893,861,372,434,100,112,3,0,0,0,1,0,1,0,1884,9,731
"3995","노은2동","노은2동제5투","대통령선거","대전광역시","유성구",1458,1218,683,149,237,87,56,2,0,0,0,0,0,1,0,1215,3,240
"3996","신성동","관내사전투표","대통령선거","대전광역시","유성구",4375,4375,2029,681,950,420,273,5,0,1,0,2,0,0,2,4363,12,0
"3997","신성동","신성동제1투","대통령선거","대전광역시","유성구",1691,1133,474,224,253,100,73,0,0,1,1,0,0,1,1,1128,5,558
"3998","신성동","신성동제2투","대통령선거","대전광역시","유성구",1848,1512,728,254,309,118,98,3,0,0,0,0,0,1,0,1511,1,336
"3999","신성동","신성동제3투","대통령선거","대전광역시","유성구",2468,1883,917,272,422,116,142,2,0,0,0,0,1,2,0,1874,9,585
"4000","신성동","신성동제4투","대통령선거","대전광역시","유성구",2097,1640,732,323,335,158,84,2,0,0,0,0,0,1,1,1636,4,457
"4001","신성동","신성동제5투","대통령선거","대전광역시","유성구",2219,1679,416,374,534,272,74,0,0,0,1,1,0,0,1,1673,6,540
"4002","신성동","신성동제6투","대통령선거","대전광역시","유성구",1651,1282,400,377,354,93,50,4,0,0,0,0,0,1,0,1279,3,369
"4003","전민동","관내사전투표","대통령선거","대전광역시","유성구",5052,5052,2706,627,899,422,375,4,1,2,1,3,0,0,1,5041,11,0
"4004","전민동","전민동제1투","대통령선거","대전광역시","유성구",2205,1655,841,237,341,120,110,3,0,0,0,1,0,1,0,1654,1,550
"4005","전민동","전민동제2투","대통령선거","대전광역시","유성구",2741,1941,895,345,400,168,125,0,0,0,0,0,0,2,1,1936,5,800
"4006","전민동","전민동제3투","대통령선거","대전광역시","유성구",2092,1681,836,275,361,108,93,3,0,0,0,1,1,0,1,1679,2,411
"4007","전민동","전민동제4투","대통령선거","대전광역시","유성구",2235,1796,821,353,389,122,105,1,0,0,0,0,0,0,2,1793,3,439
"4008","전민동","전민동제5투","대통령선거","대전광역시","유성구",2564,2075,988,369,431,172,106,6,0,0,0,0,0,2,0,2074,1,489
"4009","구즉동","관내사전투표","대통령선거","대전광역시","유성구",4796,4796,2684,493,876,298,420,4,0,6,0,3,0,0,3,4787,9,0
"4010","구즉동","구즉동제1투","대통령선거","대전광역시","유성구",1434,880,381,137,220,60,64,2,1,0,0,2,1,5,1,874,6,554
"4011","구즉동","구즉동제2투","대통령선거","대전광역시","유성구",274,170,55,69,33,1,9,0,0,0,0,0,2,0,0,169,1,104
"4012","구즉동","구즉동제3투","대통령선거","대전광역시","유성구",2156,1279,517,283,301,71,86,4,1,1,1,4,2,0,5,1276,3,877
"4013","구즉동","구즉동제4투","대통령선거","대전광역시","유성구",2790,2037,964,269,502,107,183,0,0,1,0,0,0,2,1,2029,8,753
"4014","구즉동","구즉동제5투","대통령선거","대전광역시","유성구",2813,2033,971,296,466,130,156,1,0,0,0,0,2,0,1,2023,10,780
"4015","구즉동","구즉동제6투","대통령선거","대전광역시","유성구",2578,1906,943,229,402,139,179,2,2,2,0,2,1,0,1,1902,4,672
"4016","구즉동","구즉동제7투","대통령선거","대전광역시","유성구",3290,2365,1090,373,568,134,184,1,0,1,0,1,0,1,2,2355,10,925
"4017","관평동","관내사전투표","대통령선거","대전광역시","유성구",5847,5847,3214,657,1039,463,454,5,2,1,0,1,0,0,0,5836,11,0
"4018","관평동","관평동제1투","대통령선거","대전광역시","유성구",2281,1905,959,245,423,138,133,5,0,0,0,1,0,0,0,1904,1,376
"4019","관평동","관평동제2투","대통령선거","대전광역시","유성구",2658,2212,1151,304,453,159,131,1,0,0,0,2,0,0,2,2203,9,446
"4020","관평동","관평동제3투","대통령선거","대전광역시","유성구",2804,2281,1182,261,511,173,148,2,0,1,0,0,0,1,0,2279,2,523
"4021","관평동","관평동제4투","대통령선거","대전광역시","유성구",2715,2068,793,462,522,185,93,3,0,3,1,0,1,2,1,2066,2,647
"4022","관평동","관평동제5투","대통령선거","대전광역시","유성구",2845,2054,1003,312,458,143,131,1,0,0,0,2,0,0,1,2051,3,791
"4023","원신흥동","관내사전투표","대통령선거","대전광역시","유성구",6746,6746,3488,971,1306,445,501,6,0,0,1,4,0,2,2,6726,20,0
"4024","원신흥동","원신흥동제1투","대통령선거","대전광역시","유성구",3328,2378,1048,443,567,163,146,2,0,1,0,2,1,1,0,2374,4,950
"4025","원신흥동","원신흥동제2투","대통령선거","대전광역시","유성구",3268,2241,934,410,583,138,158,6,0,1,3,0,1,2,1,2237,4,1027
"4026","원신흥동","원신흥동제3투","대통령선거","대전광역시","유성구",3390,2744,1307,439,620,201,167,2,0,0,0,1,0,2,0,2739,5,646
"4027","원신흥동","원신흥동제4투","대통령선거","대전광역시","유성구",3194,2588,1046,540,641,220,130,1,0,0,0,2,1,0,1,2582,6,606
"4028","원신흥동","원신흥동제5투","대통령선거","대전광역시","유성구",3334,2080,884,332,544,136,170,2,1,3,0,1,0,1,1,2075,5,1254
"4029","원신흥동","원신흥동제6투","대통령선거","대전광역시","유성구",2731,2058,1063,252,437,166,129,1,0,2,0,1,1,0,1,2053,5,673
"4030","원신흥동","원신흥동제7투","대통령선거","대전광역시","유성구",2943,2400,1074,452,552,178,133,0,0,1,0,2,1,0,0,2393,7,543
"4031","원신흥동","원신흥동제8투","대통령선거","대전광역시","유성구",2054,1482,607,269,389,112,94,3,0,1,1,0,1,0,1,1478,4,572
"4032","노은3동","관내사전투표","대통령선거","대전광역시","유성구",5434,5434,2949,759,971,373,359,3,0,2,0,3,0,2,1,5422,12,0
"4033","노은3동","노은3동제1투","대통령선거","대전광역시","유성구",2184,1793,899,283,395,125,78,2,1,2,1,0,0,1,1,1788,5,391
"4034","노은3동","노은3동제2투","대통령선거","대전광역시","유성구",2553,1844,811,351,431,114,120,2,0,2,0,1,0,1,2,1835,9,709
"4035","노은3동","노은3동제3투","대통령선거","대전광역시","유성구",2115,1712,889,250,361,131,70,4,0,0,1,0,0,2,1,1709,3,403
"4036","노은3동","노은3동제4투","대통령선거","대전광역시","유성구",2376,1861,881,350,411,128,86,2,0,0,0,0,0,0,0,1858,3,515
"4037","노은3동","노은3동제5투","대통령선거","대전광역시","유성구",2755,2315,1291,303,449,161,108,1,0,0,0,0,0,0,0,2313,2,440
"4038","노은3동","노은3동제6투","대통령선거","대전광역시","유성구",2764,2066,1069,267,433,145,147,0,0,1,0,0,0,0,1,2063,3,698
"4039","노은3동","노은3동제7투","대통령선거","대전광역시","유성구",2064,1480,739,213,328,94,101,2,0,0,0,1,0,0,1,1479,1,584
"4040","잘못 투입·구분된 투표지","잘못 투입·구분된 투표지","대통령선거","대전광역시","유성구",0,1,0,0,1,0,0,0,0,0,0,0,0,0,0,1,0,-1
"4041","거소·선상투표","거소·선상투표","대통령선거","대전광역시","대덕구",392,368,133,54,125,22,10,2,1,2,1,1,0,2,0,353,15,24
"4042","관외사전투표","관외사전투표","대통령선거","대전광역시","대덕구",13888,13871,6541,1827,2940,1111,1239,14,4,10,5,11,5,2,33,13742,129,17
"4043","재외투표","재외투표","대통령선거","대전광역시","대덕구",647,504,313,36,78,11,64,1,0,0,0,0,0,0,0,503,1,143
"4044","오정동","관내사전투표","대통령선거","대전광역시","대덕구",1832,1832,825,427,360,96,111,1,0,4,0,1,1,0,1,1827,5,0
"4045","오정동","오정동제1투","대통령선거","대전광역시","대덕구",2027,1334,464,365,349,81,57,3,0,1,1,1,2,0,1,1325,9,693
"4046","오정동","오정동제2투","대통령선거","대전광역시","대덕구",1283,781,262,208,214,34,48,0,1,3,1,2,0,0,1,774,7,502
"4047","오정동","오정동제3투","대통령선거","대전광역시","대덕구",1660,1003,371,224,253,63,85,0,0,1,0,2,0,0,0,999,4,657
"4048","오정동","오정동제4투","대통령선거","대전광역시","대덕구",1851,1141,340,343,304,65,84,0,0,0,0,0,0,1,0,1137,4,710
"4049","오정동","오정동제5투","대통령선거","대전광역시","대덕구",2402,1755,644,491,426,94,92,1,0,0,0,2,0,0,1,1751,4,647
"4050","오정동","오정동제6투","대통령선거","대전광역시","대덕구",1813,1141,358,330,306,62,74,4,0,2,0,1,0,1,1,1139,2,672
"4051","대화동","관내사전투표","대통령선거","대전광역시","대덕구",1058,1058,409,222,259,55,76,1,0,0,3,1,5,1,5,1037,21,0
"4052","대화동","대화동제1투","대통령선거","대전광역시","대덕구",1887,1122,385,269,300,47,47,6,3,3,2,4,5,2,6,1079,43,765
"4053","대화동","대화동제2투","대통령선거","대전광역시","대덕구",1503,959,308,288,243,47,63,0,0,4,0,1,0,0,1,955,4,544
"4054","대화동","대화동제3투","대통령선거","대전광역시","대덕구",2304,1510,489,404,424,77,106,0,1,1,0,2,0,1,0,1505,5,794
"4055","회덕동","관내사전투표","대통령선거","대전광역시","대덕구",1509,1509,639,355,316,72,116,1,0,3,2,0,1,0,1,1506,3,0
"4056","회덕동","회덕동제1투","대통령선거","대전광역시","대덕구",2771,2041,762,495,512,130,129,0,0,2,1,3,1,1,0,2036,5,730
"4057","회덕동","회덕동제2투","대통령선거","대전광역시","대덕구",2185,1417,476,415,361,70,86,2,0,1,1,0,0,0,0,1412,5,768
"4058","회덕동","회덕동제3투","대통령선거","대전광역시","대덕구",2239,1366,473,387,335,78,79,2,0,1,2,0,1,2,2,1362,4,873
"4059","회덕동","회덕동제4투","대통령선거","대전광역시","대덕구",2806,2061,731,550,539,125,101,2,0,2,0,1,0,1,2,2054,7,745
"4060","회덕동","회덕동제5투","대통령선거","대전광역시","대덕구",566,360,89,132,98,16,18,1,0,4,0,0,0,0,0,358,2,206
"4061","비래동","관내사전투표","대통령선거","대전광역시","대덕구",2042,2042,947,441,432,81,126,2,0,0,0,0,0,1,3,2033,9,0
"4062","비래동","비래동제1투","대통령선거","대전광역시","대덕구",2423,1626,560,470,392,76,121,0,0,0,0,1,2,1,1,1624,2,797
"4063","비래동","비래동제2투","대통령선거","대전광역시","대덕구",2152,1451,567,379,334,65,100,1,0,0,0,0,1,0,2,1449,2,701
"4064","비래동","비래동제3투","대통령선거","대전광역시","대덕구",2218,1428,526,354,386,67,85,3,0,2,1,0,0,0,3,1427,1,790
"4065","비래동","비래동제4투","대통령선거","대전광역시","대덕구",2506,1689,651,458,398,89,87,3,0,1,1,0,0,0,0,1688,1,817
"4066","비래동","비래동제5투","대통령선거","대전광역시","대덕구",2221,1617,626,377,389,106,107,2,0,0,0,0,0,0,1,1608,9,604
"4067","송촌동","관내사전투표","대통령선거","대전광역시","대덕구",4615,4615,2290,674,951,286,376,5,0,6,1,3,0,2,2,4596,19,0
"4068","송촌동","송촌동제1투","대통령선거","대전광역시","대덕구",2667,2066,848,402,513,143,152,1,0,2,1,0,1,0,1,2064,2,601
"4069","송촌동","송촌동제2투","대통령선거","대전광역시","대덕구",2693,1901,800,347,492,121,135,1,0,2,0,0,1,0,1,1900,1,792
"4070","송촌동","송촌동제3투","대통령선거","대전광역시","대덕구",2647,2017,898,324,495,139,149,1,0,1,1,1,0,1,0,2010,7,630
"4071","송촌동","송촌동제4투","대통령선거","대전광역시","대덕구",2975,2303,1033,352,564,165,174,5,0,0,0,2,0,2,2,2299,4,672
"4072","송촌동","송촌동제5투","대통령선거","대전광역시","대덕구",1557,975,361,237,241,60,70,1,0,1,0,0,0,1,1,973,2,582
"4073","송촌동","송촌동제6투","대통령선거","대전광역시","대덕구",1886,1198,416,308,315,61,91,3,0,1,0,0,0,1,1,1197,1,688
"4074","송촌동","송촌동제7투","대통령선거","대전광역시","대덕구",2033,1351,511,314,364,78,76,0,0,2,0,0,1,0,2,1348,3,682
"4075","중리동","관내사전투표","대통령선거","대전광역시","대덕구",2237,2237,1054,427,488,104,143,4,0,2,0,5,2,1,2,2232,5,0
"4076","중리동","중리동제1투","대통령선거","대전광역시","대덕구",2111,1292,452,363,342,54,70,0,0,2,0,0,0,4,2,1289,3,819
"4077","중리동","중리동제2투","대통령선거","대전광역시","대덕구",1560,982,375,232,254,43,69,2,0,3,0,0,0,0,0,978,4,578
"4078","중리동","중리동제3투","대통령선거","대전광역시","대덕구",2065,1279,509,286,284,91,96,2,0,1,2,1,0,0,1,1273,6,786
"4079","중리동","중리동제4투","대통령선거","대전광역시","대덕구",2284,1605,583,404,417,86,99,2,1,1,0,0,1,1,1,1596,9,679
"4080","중리동","중리동제5투","대통령선거","대전광역시","대덕구",2122,1195,435,301,303,60,83,3,1,0,1,1,0,0,1,1189,6,927
"4081","중리동","중리동제6투","대통령선거","대전광역시","대덕구",2075,1284,464,370,335,48,61,0,0,0,0,1,0,0,3,1282,2,791
"4082","중리동","중리동제7투","대통령선거","대전광역시","대덕구",1924,1191,457,260,310,72,83,2,0,0,0,2,0,0,2,1188,3,733
"4083","법1동","관내사전투표","대통령선거","대전광역시","대덕구",1800,1800,791,346,411,98,132,1,0,2,1,4,0,2,2,1790,10,0
"4084","법1동","법1동제1투","대통령선거","대전광역시","대덕구",1237,722,274,166,170,48,53,2,0,1,3,1,2,0,0,720,2,515
"4085","법1동","법1동제2투","대통령선거","대전광역시","대덕구",2018,1397,578,274,357,82,92,3,0,2,0,0,0,0,1,1389,8,621
"4086","법1동","법1동제3투","대통령선거","대전광역시","대덕구",2715,2016,782,479,490,99,152,0,1,1,0,2,0,3,0,2009,7,699
"4087","법1동","법1동제4투","대통령선거","대전광역시","대덕구",1903,1160,362,348,339,45,49,2,2,3,0,0,0,0,1,1151,9,743
"4088","법2동","관내사전투표","대통령선거","대전광역시","대덕구",2789,2789,1191,571,616,198,186,2,0,2,1,2,1,3,3,2776,13,0
"4089","법2동","법2동제1투","대통령선거","대전광역시","대덕구",2065,1336,392,416,403,45,57,3,1,3,1,0,1,1,5,1328,8,729
"4090","법2동","법2동제2투","대통령선거","대전광역시","대덕구",2947,2265,804,572,567,152,156,1,0,0,0,4,1,0,3,2260,5,682
"4091","법2동","법2동제3투","대통령선거","대전광역시","대덕구",3158,2363,950,463,617,155,158,8,0,1,0,0,0,1,1,2354,9,795
"4092","법2동","법2동제4투","대통령선거","대전광역시","대덕구",663,374,120,115,91,20,24,1,0,0,0,0,0,2,0,373,1,289
"4093","법2동","법2동제5투","대통령선거","대전광역시","대덕구",2066,1658,723,290,404,105,118,4,1,1,0,2,0,1,2,1651,7,408
"4094","신탄진동","관내사전투표","대통령선거","대전광역시","대덕구",2037,2037,856,441,460,123,138,1,2,0,1,3,1,0,2,2028,9,0
"4095","신탄진동","신탄진동제1투","대통령선거","대전광역시","대덕구",2209,1301,426,315,378,67,102,1,0,0,3,5,0,1,1,1299,2,908
"4096","신탄진동","신탄진동제2투","대통령선거","대전광역시","대덕구",2516,1840,680,455,455,105,123,7,0,1,2,4,0,2,3,1837,3,676
"4097","신탄진동","신탄진동제3투","대통령선거","대전광역시","대덕구",2675,1737,614,448,467,85,110,1,0,0,1,1,2,0,1,1730,7,938
"4098","신탄진동","신탄진동제4투","대통령선거","대전광역시","대덕구",411,256,92,80,56,11,14,0,0,1,0,0,0,0,1,255,1,155
"4099","석봉동","관내사전투표","대통령선거","대전광역시","대덕구",1686,1686,817,276,359,93,133,3,1,1,0,0,0,0,0,1683,3,0
"4100","석봉동","석봉동제1투","대통령선거","대전광역시","대덕구",2288,1484,559,347,382,80,110,0,0,0,0,1,1,0,0,1480,4,804
"4101","석봉동","석봉동제2투","대통령선거","대전광역시","대덕구",1464,942,265,306,256,37,64,4,0,0,1,2,1,0,0,936,6,522
"4102","석봉동","석봉동제3투","대통령선거","대전광역시","대덕구",3634,2758,1175,496,707,183,186,3,0,0,0,1,1,0,3,2755,3,876
"4103","덕암동","관내사전투표","대통령선거","대전광역시","대덕구",2028,2028,948,407,417,92,150,1,0,1,0,2,0,0,3,2021,7,0
"4104","덕암동","덕암동제1투","대통령선거","대전광역시","대덕구",2598,1578,596,356,397,94,119,1,0,1,1,0,1,1,1,1568,10,1020
"4105","덕암동","덕암동제2투","대통령선거","대전광역시","대덕구",3279,2234,868,504,562,118,154,5,1,7,0,3,2,1,0,2225,9,1045
"4106","덕암동","덕암동제3투","대통령선거","대전광역시","대덕구",2993,1926,699,451,503,100,160,2,1,1,0,0,2,0,1,1920,6,1067
"4107","덕암동","덕암동제4투","대통령선거","대전광역시","대덕구",874,644,272,153,139,25,53,0,0,1,0,0,0,1,0,644,0,230
"4108","목상동","관내사전투표","대통령선거","대전광역시","대덕구",1152,1152,554,146,272,74,96,0,1,1,0,1,0,1,0,1146,6,0
"4109","목상동","목상동제1투","대통령선거","대전광역시","대덕구",2205,1333,531,271,327,81,116,2,0,0,0,1,0,1,0,1330,3,872
"4110","목상동","목상동제2투","대통령선거","대전광역시","대덕구",2179,1523,639,272,380,87,136,0,1,0,2,1,0,1,0,1519,4,656
"4111","잘못 투입·구분된 투표지","잘못 투입·구분된 투표지","대통령선거","대전광역시","대덕구",0,0,0,0,0,0,0,0,0,0,0,0,0,0,0,0,0,0
"4112","거소·선상투표","거소·선상투표","대통령선거","경상북도","포항시북구",623,582,156,166,161,55,24,3,1,0,0,2,0,0,4,572,10,41
"4113","관외사전투표","관외사전투표","대통령선거","경상북도","포항시북구",18455,18433,5742,4934,3367,2536,1567,40,4,13,9,21,5,3,25,18266,167,22
"4114","재외투표","재외투표","대통령선거","경상북도","포항시북구",1099,807,420,53,152,59,117,0,0,0,0,0,0,0,2,803,4,292
"4115","흥해읍","관내사전투표","대통령선거","경상북도","포항시북구",3771,3771,864,1728,539,363,228,4,2,1,4,2,1,3,5,3744,27,0
"4116","흥해읍","흥해읍제1투","대통령선거","경상북도","포항시북구",1918,1130,179,694,124,83,43,1,0,0,0,0,1,1,1,1127,3,788
"4117","흥해읍","흥해읍제2투","대통령선거","경상북도","포항시북구",1659,1135,189,581,179,108,67,1,1,2,0,1,0,2,1,1132,3,524
"4118","흥해읍","흥해읍제3투","대통령선거","경상북도","포항시북구",1262,914,100,639,100,46,19,0,0,0,0,2,0,2,0,908,6,348
"4119","흥해읍","흥해읍제4투","대통령선거","경상북도","포항시북구",1551,1040,112,726,121,41,21,2,0,0,1,0,4,7,2,1037,3,511
"4120","흥해읍","흥해읍제5투","대통령선거","경상북도","포항시북구",1344,953,169,504,123,89,46,3,0,2,3,3,1,2,0,945,8,391
"4121","흥해읍","흥해읍제6투","대통령선거","경상북도","포항시북구",1626,1071,167,594,162,90,45,1,0,3,0,1,0,1,2,1066,5,555
"4122","흥해읍","흥해읍제7투","대통령선거","경상북도","포항시북구",1890,1271,154,786,162,110,43,3,1,1,1,0,2,1,2,1266,5,619
"4123","흥해읍","흥해읍제8투","대통령선거","경상북도","포항시북구",909,538,47,408,35,32,9,0,0,0,1,0,2,1,1,536,2,371
"4124","흥해읍","흥해읍제9투","대통령선거","경상북도","포항시북구",1917,1286,229,655,188,140,67,2,0,2,1,0,0,0,0,1284,2,631
"4125","흥해읍","흥해읍제10투","대통령선거","경상북도","포항시북구",3999,2954,693,1184,525,329,195,3,0,2,1,0,2,4,5,2943,11,1045
"4126","흥해읍","흥해읍제11투","대통령선거","경상북도","포항시북구",2070,1400,211,790,193,123,68,3,0,3,0,1,0,1,4,1397,3,670
"4127","흥해읍","흥해읍제12투","대통령선거","경상북도","포항시북구",1708,1184,251,567,195,102,58,1,0,0,1,2,0,1,2,1180,4,524
"4128","신광면","관내사전투표","대통령선거","경상북도","포항시북구",694,694,111,436,72,50,15,1,1,0,0,2,0,0,0,688,6,0
"4129","신광면","신광면제1투","대통령선거","경상북도","포항시북구",863,553,59,379,72,26,6,0,0,0,0,1,0,3,3,549,4,310
"4130","신광면","신광면제2투","대통령선거","경상북도","포항시북구",442,296,38,210,23,15,6,0,0,0,0,1,0,1,0,294,2,146
"4131","신광면","신광면제3투","대통령선거","경상북도","포항시북구",611,421,46,288,52,19,6,0,0,0,0,0,2,2,2,417,4,190
"4132","청하면","관내사전투표","대통령선거","경상북도","포항시북구",1055,1054,161,635,121,85,38,0,1,0,0,0,2,4,1,1048,6,1
"4133","청하면","청하면제1투","대통령선거","경상북도","포항시북구",1762,1092,134,713,129,70,32,1,0,0,0,1,0,4,1,1085,7,670
"4134","청하면","청하면제2투","대통령선거","경상북도","포항시북구",1242,858,88,568,118,42,17,0,1,0,3,1,2,5,2,847,11,384
"4135","청하면","청하면제3투","대통령선거","경상북도","포항시북구",477,320,35,214,43,16,9,0,0,0,0,0,0,1,0,318,2,157
"4136","송라면","관내사전투표","대통령선거","경상북도","포항시북구",970,970,117,657,97,54,23,2,2,1,1,1,2,2,2,961,9,0
"4137","송라면","송라면투표소","대통령선거","경상북도","포항시북구",1449,909,97,620,94,60,21,2,0,1,1,1,1,2,1,901,8,540
"4138","기계면","관내사전투표","대통령선거","경상북도","포항시북구",1354,1354,202,820,158,96,46,2,0,3,1,1,3,6,2,1340,14,0
"4139","기계면","기계면제1투","대통령선거","경상북도","포항시북구",2055,1354,153,940,134,76,28,3,1,3,0,0,4,1,1,1344,10,701
"4140","기계면","기계면제2투","대통령선거","경상북도","포항시북구",679,451,50,301,49,19,11,2,0,0,1,2,1,4,1,441,10,228
"4141","기계면","기계면제3투","대통령선거","경상북도","포항시북구",561,385,36,274,42,16,7,0,0,0,0,0,3,1,1,380,5,176
"4142","죽장면","관내사전투표","대통령선거","경상북도","포항시북구",775,775,97,533,69,42,17,1,0,0,2,0,2,3,4,770,5,0
"4143","죽장면","죽장면제1투","대통령선거","경상북도","포항시북구",1181,737,82,521,65,42,10,1,0,1,0,0,2,6,2,732,5,444
"4144","죽장면","죽장면제2투","대통령선거","경상북도","포항시북구",491,363,55,243,34,20,7,0,0,0,0,0,0,2,1,362,1,128
"4145","기북면","관내사전투표","대통령선거","경상북도","포항시북구",600,600,81,383,70,27,22,0,3,1,1,0,1,5,1,595,5,0
"4146","기북면","기북면투표소","대통령선거","경상북도","포항시북구",627,418,53,253,64,22,15,2,1,0,0,0,1,2,1,414,4,209
"4147","중앙동","관내사전투표","대통령선거","경상북도","포항시북구",3104,3104,699,1527,391,282,179,4,0,3,1,1,0,1,2,3090,14,0
"4148","중앙동","중앙동제1투","대통령선거","경상북도","포항시북구",1351,756,102,484,90,52,23,3,0,0,0,0,0,0,1,755,1,595
"4149","중앙동","중앙동제2투","대통령선거","경상북도","포항시북구",943,578,77,397,63,32,5,0,0,0,1,0,1,0,1,577,1,365
"4150","중앙동","중앙동제3투","대통령선거","경상북도","포항시북구",1357,852,131,477,126,62,47,2,2,0,0,0,0,1,1,849,3,505
"4151","중앙동","중앙동제4투","대통령선거","경상북도","포항시북구",2158,1293,203,693,196,123,64,3,0,1,1,1,1,2,0,1288,5,865
"4152","중앙동","중앙동제5투","대통령선거","경상북도","포항시북구",2236,1411,184,900,190,78,43,3,0,1,1,0,0,2,0,1402,9,825
"4153","중앙동","중앙동제6투","대통령선거","경상북도","포항시북구",1240,734,100,442,97,67,25,0,0,0,0,0,0,1,0,732,2,506
"4154","중앙동","중앙동제7투","대통령선거","경상북도","포항시북구",2114,1559,306,833,219,123,68,0,0,0,0,0,0,1,2,1552,7,555
"4155","양학동","관내사전투표","대통령선거","경상북도","포항시북구",2877,2877,814,1076,446,318,209,1,0,1,1,4,0,2,0,2872,5,0
"4156","양학동","양학동제1투","대통령선거","경상북도","포항시북구",2523,1710,355,799,308,160,79,3,0,0,0,0,0,0,2,1706,4,813
"4157","양학동","양학동제2투","대통령선거","경상북도","포항시북구",2936,1994,411,962,323,180,108,2,0,0,0,0,2,0,1,1989,5,942
"4158","양학동","양학동제3투","대통령선거","경상북도","포항시북구",3090,2216,584,755,448,263,151,3,0,2,0,0,0,1,2,2209,7,874
"4159","양학동","양학동제4투","대통령선거","경상북도","포항시북구",2455,1900,383,882,314,184,118,4,2,2,2,1,0,1,2,1895,5,555
"4160","죽도동","관내사전투표","대통령선거","경상북도","포항시북구",2966,2966,649,1512,383,238,156,3,2,2,0,1,0,1,2,2949,17,0
"4161","죽도동","죽도동제1투","대통령선거","경상북도","포항시북구",2366,1561,188,1040,190,98,31,4,0,1,1,3,0,1,1,1558,3,805
"4162","죽도동","죽도동제2투","대통령선거","경상북도","포항시북구",3818,2123,333,1279,265,166,65,2,0,3,1,1,0,2,1,2118,5,1695
"4163","죽도동","죽도동제3투","대통령선거","경상북도","포항시북구",3124,2061,320,1195,265,182,86,5,0,0,1,1,0,0,0,2055,6,1063
"4164","죽도동","죽도동제4투","대통령선거","경상북도","포항시북구",2436,1627,283,887,231,140,72,2,1,4,0,0,0,2,0,1622,5,809
"4165","죽도동","죽도동제5투","대통령선거","경상북도","포항시북구",3275,2121,336,1173,306,193,98,1,0,0,0,1,0,1,2,2111,10,1154
"4166","용흥동","관내사전투표","대통령선거","경상북도","포항시북구",3365,3365,788,1624,446,317,162,6,0,0,1,0,0,2,3,3349,16,0
"4167","용흥동","용흥동제1투","대통령선거","경상북도","포항시북구",2287,1651,287,950,204,136,65,1,0,1,1,0,0,2,0,1647,4,636
"4168","용흥동","용흥동제2투","대통령선거","경상북도","포항시북구",2088,1364,252,686,201,144,72,3,0,1,0,0,0,0,1,1360,4,724
"4169","용흥동","용흥동제3투","대통령선거","경상북도","포항시북구",1878,1221,210,655,211,93,48,1,0,0,0,0,1,1,0,1220,1,657
"4170","용흥동","용흥동제4투","대통령선거","경상북도","포항시북구",1990,1575,314,759,292,133,69,3,0,1,0,1,0,1,0,1573,2,415
"4171","용흥동","용흥동제5투","대통령선거","경상북도","포항시북구",2422,1856,393,787,356,205,105,1,0,0,0,0,0,1,2,1850,6,566
"4172","용흥동","용흥동제6투","대통령선거","경상북도","포항시북구",2108,1517,322,670,226,180,103,4,0,3,0,2,0,0,3,1513,4,591
"4173","용흥동","용흥동제7투","대통령선거","경상북도","포항시북구",2299,1543,312,742,268,144,65,2,0,0,0,1,0,0,2,1536,7,756
"4174","우창동","관내사전투표","대통령선거","경상북도","포항시북구",4088,4088,1136,1512,634,471,295,5,0,2,1,1,2,3,5,4067,21,0
"4175","우창동","우창동제1투","대통령선거","경상북도","포항시북구",3394,2435,551,1038,413,308,103,3,0,1,1,1,0,4,2,2425,10,959
"4176","우창동","우창동제2투","대통령선거","경상북도","포항시북구",2187,1539,270,804,209,164,80,0,0,0,0,0,0,1,0,1528,11,648
"4177","우창동","우창동제3투","대통령선거","경상북도","포항시북구",2445,1834,455,730,324,178,135,2,0,0,0,0,0,3,0,1827,7,611
"4178","우창동","우창동제4투","대통령선거","경상북도","포항시북구",2008,1320,269,610,236,139,53,2,0,1,0,0,0,2,3,1315,5,688
"4179","우창동","우창동제5투","대통령선거","경상북도","포항시북구",1647,1136,204,625,148,86,65,3,0,0,0,0,1,1,0,1133,3,511
"4180","우창동","우창동제6투","대통령선거","경상북도","포항시북구",2069,1356,212,815,183,78,57,3,0,1,1,3,0,0,0,1353,3,713
"4181","우창동","우창동제7투","대통령선거","경상북도","포항시북구",2603,1777,382,775,326,184,94,3,1,0,1,0,0,1,2,1769,8,826
"4182","두호동","관내사전투표","대통령선거","경상북도","포항시북구",3170,3170,796,1286,466,379,209,6,0,2,3,1,4,2,3,3157,13,0
"4183","두호동","두호동제1투","대통령선거","경상북도","포항시북구",1338,782,112,487,92,59,29,2,0,0,0,0,0,0,1,782,0,556
"4184","두호동","두호동제2투","대통령선거","경상북도","포항시북구",2046,1358,263,722,176,128,65,0,1,0,0,1,0,0,0,1356,2,688
"4185","두호동","두호동제3투","대통령선거","경상북도","포항시북구",2505,1849,344,879,296,192,127,1,1,1,0,1,0,1,2,1845,4,656
"4186","두호동","두호동제4투","대통령선거","경상북도","포항시북구",3047,2359,520,998,417,274,140,2,0,1,0,0,0,0,2,2354,5,688
"4187","두호동","두호동제5투","대통령선거","경상북도","포항시북구",1758,1257,215,675,181,120,58,3,0,0,0,0,0,0,2,1254,3,501
"4188","두호동","두호동제6투","대통령선거","경상북도","포항시북구",2737,2071,466,865,356,251,127,2,0,0,0,0,0,1,1,2069,2,666
"4189","장량동","관내사전투표","대통령선거","경상북도","포항시북구",7703,7702,2293,2665,1240,907,532,17,1,1,1,4,1,1,8,7671,31,1
"4190","장량동","장량동제1투","대통령선거","경상북도","포항시북구",1935,1267,246,601,201,134,75,1,0,0,0,1,0,1,3,1263,4,668
"4191","장량동","장량동제2투","대통령선거","경상북도","포항시북구",2308,1570,317,749,278,126,84,5,0,0,0,1,1,0,0,1561,9,738
"4192","장량동","장량동제3투","대통령선거","경상북도","포항시북구",2279,1621,361,677,301,157,113,1,0,0,1,2,0,0,1,1614,7,658
"4193","장량동","장량동제4투","대통령선거","경상북도","포항시북구",2794,2094,513,887,363,207,112,5,0,1,0,1,0,0,1,2090,4,700
"4194","장량동","장량동제5투","대통령선거","경상북도","포항시북구",2994,1952,418,813,344,224,139,3,1,2,0,1,0,0,2,1947,5,1042
"4195","장량동","장량동제6투","대통령선거","경상북도","포항시북구",2837,2176,528,855,395,271,117,3,1,1,0,0,0,1,0,2172,4,661
"4196","장량동","장량동제7투","대통령선거","경상북도","포항시북구",4045,2587,669,982,446,312,168,1,0,2,1,0,0,0,0,2581,6,1458
"4197","장량동","장량동제8투","대통령선거","경상북도","포항시북구",3398,2565,782,846,477,291,156,1,0,1,0,0,1,2,3,2560,5,833
"4198","장량동","장량동제9투","대통령선거","경상북도","포항시북구",3307,2329,581,856,421,272,179,6,0,1,1,1,0,1,1,2320,9,978
"4199","장량동","장량동제10투","대통령선거","경상북도","포항시북구",2908,2357,668,755,473,300,142,7,0,1,2,0,1,0,0,2349,8,551
"4200","장량동","장량동제11투","대통령선거","경상북도","포항시북구",2874,1948,589,605,381,229,132,2,0,1,0,1,0,0,1,1941,7,926
"4201","장량동","장량동제12투","대통령선거","경상북도","포항시북구",3915,3054,960,915,596,393,177,4,0,1,1,0,0,1,2,3050,4,861
"4202","장량동","장량동제13투","대통령선거","경상북도","포항시북구",3863,2733,693,1089,456,321,157,3,1,2,1,0,0,1,0,2724,9,1130
"4203","환여동","관내사전투표","대통령선거","경상북도","포항시북구",2813,2813,957,807,442,376,217,4,0,0,0,1,1,3,2,2810,3,0
"4204","환여동","환여동제1투","대통령선거","경상북도","포항시북구",924,610,86,374,87,36,19,0,0,3,0,1,0,0,0,606,4,314
"4205","환여동","환여동제2투","대통령선거","경상북도","포항시북구",1210,767,131,411,119,66,30,3,0,0,0,0,0,1,0,761,6,443
"4206","환여동","환여동제3투","대통령선거","경상북도","포항시북구",3208,2502,685,945,398,290,167,7,0,2,0,0,0,1,0,2495,7,706
"4207","환여동","환여동제4투","대통령선거","경상북도","포항시북구",1073,842,238,297,136,100,59,3,0,0,0,3,0,0,2,838,4,231
"4208","잘못 투입·구분된 투표지","잘못 투입·구분된 투표지","대통령선거","경상북도","포항시북구",0,16,5,5,3,2,1,0,0,0,0,0,0,0,0,16,0,-16
"4209","거소·선상투표","거소·선상투표","대통령선거","경상북도","포항시남구",417,394,93,111,117,39,10,1,2,0,1,2,1,1,1,379,15,23
"4210","관외사전투표","관외사전투표","대통령선거","경상북도","포항시남구",15039,15031,4856,3960,2669,1944,1344,24,4,8,5,19,4,4,28,14869,162,8
"4211","재외투표","재외투표","대통령선거","경상북도","포항시남구",894,636,355,54,107,40,74,1,0,0,0,0,0,1,1,633,3,258
"4212","구룡포읍","관내사전투표","대통령선거","경상북도","포항시남구",1253,1253,184,777,128,87,44,2,0,1,0,2,2,5,2,1234,19,0
"4213","구룡포읍","구룡포읍제1투","대통령선거","경상북도","포항시남구",2793,1692,195,1120,234,83,36,1,0,0,0,0,1,2,1,1673,19,1101
"4214","구룡포읍","구룡포읍제2투","대통령선거","경상북도","포항시남구",1443,912,80,645,113,39,19,5,0,0,0,1,1,1,2,906,6,531
"4215","구룡포읍","구룡포읍제3투","대통령선거","경상북도","포항시남구",578,356,29,243,47,19,3,0,0,0,0,2,2,2,3,350,6,222
"4216","구룡포읍","구룡포읍제4투","대통령선거","경상북도","포항시남구",1490,809,100,510,113,58,10,4,1,0,1,0,0,5,0,802,7,681
"4217","연일읍","관내사전투표","대통령선거","경상북도","포항시남구",4310,4311,1184,1658,686,426,321,8,1,3,0,2,0,2,5,4296,15,-1
"4218","연일읍","연일읍제1투","대통령선거","경상북도","포항시남구",1934,1203,186,651,196,88,68,2,0,2,0,0,0,0,1,1194,9,731
"4219","연일읍","연일읍제2투","대통령선거","경상북도","포항시남구",2573,1744,340,854,295,151,98,0,0,0,1,0,2,0,0,1741,3,829
"4220","연일읍","연일읍제3투","대통령선거","경상북도","포항시남구",1704,1077,182,558,167,100,58,0,0,3,0,0,1,0,1,1070,7,627
"4221","연일읍","연일읍제4투","대통령선거","경상북도","포항시남구",3156,2115,473,930,360,187,143,5,1,3,1,0,0,2,2,2107,8,1041
"4222","연일읍","연일읍제5투","대통령선거","경상북도","포항시남구",2535,1815,394,744,323,189,152,3,0,2,0,1,0,2,2,1812,3,720
"4223","연일읍","연일읍제6투","대통령선거","경상북도","포항시남구",2873,2249,597,835,404,279,122,4,1,1,1,1,1,0,0,2246,3,624
"4224","연일읍","연일읍제7투","대통령선거","경상북도","포항시남구",2919,2248,644,744,412,261,170,7,0,1,1,0,0,0,1,2241,7,671
"4225","연일읍","연일읍제8투","대통령선거","경상북도","포항시남구",643,440,54,305,40,18,18,1,1,0,0,0,0,1,1,439,1,203
"4226","연일읍","연일읍제9투","대통령선거","경상북도","포항시남구",1105,755,97,453,126,49,24,0,0,0,0,0,1,3,0,753,2,350
"4227","오천읍","관내사전투표","대통령선거","경상북도","포항시남구",7000,7000,2044,2412,1178,724,538,6,1,6,1,12,6,6,14,6948,52,0
"4228","오천읍","오천읍제1투","대통령선거","경상북도","포항시남구",2271,1337,279,536,282,138,88,0,1,2,0,0,0,2,2,1330,7,934
"4229","오천읍","오천읍제2투","대통령선거","경상북도","포항시남구",1719,1137,165,647,139,104,68,3,0,0,0,0,0,2,3,1131,6,582
"4230","오천읍","오천읍제3투","대통령선거","경상북도","포항시남구",1342,924,147,531,133,62,41,3,0,0,1,0,0,0,2,920,4,418
"4231","오천읍","오천읍제4투","대통령선거","경상북도","포항시남구",1320,846,163,403,137,69,61,2,0,2,0,1,0,0,3,841,5,474
"4232","오천읍","오천읍제5투","대통령선거","경상북도","포항시남구",2210,1451,242,771,240,108,84,0,0,0,0,0,1,2,1,1449,2,759
"4233","오천읍","오천읍제6투","대통령선거","경상북도","포항시남구",1277,834,156,422,136,66,43,2,0,0,0,0,0,3,1,829,5,443
"4234","오천읍","오천읍제7투","대통령선거","경상북도","포항시남구",2352,1570,301,777,271,119,84,1,0,1,1,3,2,0,5,1565,5,782
"4235","오천읍","오천읍제8투","대통령선거","경상북도","포항시남구",1916,1288,255,608,227,110,80,1,0,1,0,0,0,2,0,1284,4,628
"4236","오천읍","오천읍제9투","대통령선거","경상북도","포항시남구",4714,2545,727,823,469,282,216,0,0,0,0,4,2,0,5,2528,17,2169
"4237","오천읍","오천읍제10투","대통령선거","경상북도","포항시남구",3197,2383,789,625,474,259,218,4,0,0,0,1,0,2,5,2377,6,814
"4238","오천읍","오천읍제11투","대통령선거","경상북도","포항시남구",1994,1183,332,415,206,122,91,1,0,2,1,4,0,0,5,1179,4,811
"4239","오천읍","오천읍제12투","대통령선거","경상북도","포항시남구",1957,1062,202,499,200,91,57,1,0,2,0,0,0,2,0,1054,8,895
"4240","오천읍","오천읍제13투","대통령선거","경상북도","포항시남구",1280,803,133,462,113,48,36,1,0,0,0,1,2,0,1,797,6,477
"4241","오천읍","오천읍제14투","대통령선거","경상북도","포항시남구",2547,1512,346,617,287,142,107,0,0,0,2,0,0,1,2,1504,8,1035
"4242","오천읍","오천읍제15투","대통령선거","경상북도","포항시남구",3010,2196,638,653,403,271,217,0,0,0,0,1,1,3,3,2190,6,814
"4243","대송면","관내사전투표","대통령선거","경상북도","포항시남구",831,831,150,496,99,46,24,0,0,0,0,0,2,2,0,819,12,0
"4244","대송면","대송면제1투","대통령선거","경상북도","포항시남구",1052,721,74,481,84,41,24,0,0,2,0,0,1,4,2,713,8,331
"4245","대송면","대송면제2투","대통령선거","경상북도","포항시남구",1012,658,82,397,102,38,32,0,0,0,0,0,0,0,0,651,7,354
"4246","대송면","대송면제3투","대통령선거","경상북도","포항시남구",721,471,68,284,69,32,15,0,0,1,0,1,0,0,0,470,1,250
"4247","동해면","관내사전투표","대통령선거","경상북도","포항시남구",1743,1743,355,875,236,158,89,4,2,0,1,7,0,0,5,1732,11,0
"4248","동해면","동해면제1투","대통령선거","경상북도","포항시남구",2094,1353,224,758,194,103,66,0,0,1,1,0,0,1,0,1348,5,741
"4249","동해면","동해면제2투","대통령선거","경상북도","포항시남구",476,325,23,249,29,17,3,0,0,0,0,0,0,1,1,323,2,151
"4250","동해면","동해면제3투","대통령선거","경상북도","포항시남구",665,448,89,236,68,31,18,0,0,2,0,1,0,1,1,447,1,217
"4251","동해면","동해면제4투","대통령선거","경상북도","포항시남구",1933,1187,185,646,192,82,72,0,0,1,0,2,0,1,0,1181,6,746
"4252","동해면","동해면제5투","대통령선거","경상북도","포항시남구",1107,679,100,422,87,37,24,0,0,0,0,0,2,2,2,676,3,428
"4253","장기면","관내사전투표","대통령선거","경상북도","포항시남구",725,725,82,503,78,29,15,0,2,1,1,0,1,3,1,716,9,0
"4254","장기면","장기면제1투","대통령선거","경상북도","포항시남구",1035,620,70,409,88,21,14,2,0,1,0,0,1,3,4,613,7,415
"4255","장기면","장기면제2투","대통령선거","경상북도","포항시남구",1235,790,54,571,96,44,13,2,0,1,0,0,0,4,0,785,5,445
"4256","장기면","장기면제3투","대통령선거","경상북도","포항시남구",924,610,56,436,60,24,13,0,2,1,0,1,2,4,1,600,10,314
"4257","호미곶면","관내사전투표","대통령선거","경상북도","포항시남구",526,526,54,365,53,25,13,2,0,0,0,0,2,2,1,517,9,0
"4258","호미곶면","호미곶면투표소","대통령선거","경상북도","포항시남구",1332,785,62,580,90,29,10,1,0,1,0,1,0,2,1,777,8,547
"4259","상대동","관내사전투표","대통령선거","경상북도","포항시남구",3612,3611,885,1602,526,341,219,5,1,3,1,7,1,0,2,3593,18,1
"4260","상대동","상대동제1투","대통령선거","경상북도","포항시남구",2590,1640,276,872,245,140,88,3,0,1,1,3,0,0,2,1631,9,950
"4261","상대동","상대동제2투","대통령선거","경상북도","포항시남구",2570,1611,269,882,225,140,78,1,0,0,0,1,0,3,2,1601,10,959
"4262","상대동","상대동제3투","대통령선거","경상북도","포항시남구",2177,1420,254,759,237,90,69,3,1,0,0,3,0,0,0,1416,4,757
"4263","상대동","상대동제4투","대통령선거","경상북도","포항시남구",2206,1424,280,669,231,159,67,1,1,1,3,0,0,2,2,1416,8,782
"4264","상대동","상대동제5투","대통령선거","경상북도","포항시남구",2103,1208,204,637,180,128,52,1,0,0,1,1,0,0,1,1205,3,895
"4265","상대동","상대동제6투","대통령선거","경상북도","포항시남구",2148,1403,234,809,199,99,53,0,0,2,0,1,0,0,1,1398,5,745
"4266","상대동","상대동제7투","대통령선거","경상북도","포항시남구",1964,1332,209,790,180,100,42,2,1,1,0,1,0,0,3,1329,3,632
"4267","상대동","상대동제8투","대통령선거","경상북도","포항시남구",2871,1863,281,1054,302,128,77,7,0,0,0,1,0,2,0,1852,11,1008
"4268","해도동","관내사전투표","대통령선거","경상북도","포항시남구",2730,2730,565,1491,312,212,116,10,1,1,0,3,0,1,1,2713,17,0
"4269","해도동","해도동제1투","대통령선거","경상북도","포항시남구",2377,1385,191,841,188,98,54,1,0,1,0,4,1,0,2,1381,4,992
"4270","해도동","해도동제2투","대통령선거","경상북도","포항시남구",1267,798,111,521,92,42,26,0,0,0,1,0,1,0,0,794,4,469
"4271","해도동","해도동제3투","대통령선거","경상북도","포항시남구",1948,1284,190,810,161,76,39,1,0,1,0,1,0,0,1,1280,4,664
"4272","해도동","해도동제4투","대통령선거","경상북도","포항시남구",1694,1148,138,744,155,76,29,2,0,0,0,0,1,0,1,1146,2,546
"4273","해도동","해도동제5투","대통령선거","경상북도","포항시남구",1092,632,84,408,73,44,19,2,0,0,0,0,0,0,0,630,2,460
"4274","해도동","해도동제6투","대통령선거","경상북도","포항시남구",2519,1599,244,939,200,114,82,0,1,1,0,3,3,0,1,1588,11,920
"4275","해도동","해도동제7투","대통령선거","경상북도","포항시남구",1538,972,188,504,143,80,45,3,0,0,0,2,0,1,0,966,6,566
"4276","해도동","해도동제8투","대통령선거","경상북도","포항시남구",1615,997,160,562,144,78,43,0,0,0,0,2,0,0,3,992,5,618
"4277","송도동","관내사전투표","대통령선거","경상북도","포항시남구",2076,2076,341,1181,291,159,90,3,0,1,0,0,1,1,2,2070,6,0
"4278","송도동","송도동제1투","대통령선거","경상북도","포항시남구",1766,1047,148,676,121,65,31,1,0,0,0,0,0,0,0,1042,5,719
"4279","송도동","송도동제2투","대통령선거","경상북도","포항시남구",1738,1106,133,673,152,91,42,4,1,0,0,1,1,3,1,1102,4,632
"4280","송도동","송도동제3투","대통령선거","경상북도","포항시남구",2134,1420,175,912,179,99,48,2,0,0,1,0,0,1,1,1418,2,714
"4281","송도동","송도동제4투","대통령선거","경상북도","포항시남구",2697,1811,226,1148,225,129,69,1,1,1,0,3,0,1,0,1804,7,886
"4282","송도동","송도동제5투","대통령선거","경상북도","포항시남구",1696,1079,115,690,151,66,44,2,1,1,1,1,0,0,1,1073,6,617
"4283","청림동","관내사전투표","대통령선거","경상북도","포항시남구",1141,1141,243,473,206,135,61,1,0,1,0,1,0,0,4,1125,16,0
"4284","청림동","청림동제1투","대통령선거","경상북도","포항시남구",961,581,131,255,101,64,25,0,0,0,0,0,0,0,0,576,5,380
"4285","청림동","청림동제2투","대통령선거","경상북도","포항시남구",1919,1210,221,630,197,91,58,1,0,1,0,2,2,1,0,1204,6,709
"4286","청림동","청림동제3투","대통령선거","경상북도","포항시남구",802,543,46,343,91,28,27,2,1,0,1,0,0,0,3,542,1,259
"4287","제철동","관내사전투표","대통령선거","경상북도","포항시남구",1091,1091,348,353,182,121,73,2,0,1,0,2,1,0,3,1086,5,0
"4288","제철동","제철동투표소","대통령선거","경상북도","포항시남구",1774,1218,296,463,218,157,76,1,0,0,1,2,0,0,1,1215,3,556
"4289","효곡동","관내사전투표","대통령선거","경상북도","포항시남구",5064,5064,1935,1169,971,621,350,2,0,2,1,2,0,0,1,5054,10,0
"4290","효곡동","효곡동제1투","대통령선거","경상북도","포항시남구",2116,1569,369,688,287,127,84,2,0,1,3,0,0,1,2,1564,5,547
"4291","효곡동","효곡동제2투","대통령선거","경상북도","포항시남구",2032,1591,538,451,308,187,93,5,0,0,0,0,0,1,2,1585,6,441
"4292","효곡동","효곡동제3투","대통령선거","경상북도","포항시남구",2379,1893,587,583,410,203,97,3,0,1,0,1,1,0,2,1888,5,486
"4293","효곡동","효곡동제4투","대통령선거","경상북도","포항시남구",2566,2032,563,650,459,242,110,2,0,1,0,0,0,0,2,2029,3,534
"4294","효곡동","효곡동제5투","대통령선거","경상북도","포항시남구",2186,1751,565,517,375,215,69,0,0,0,0,0,0,1,1,1743,8,435
"4295","효곡동","효곡동제6투","대통령선거","경상북도","포항시남구",2020,1665,471,506,351,213,115,2,0,1,0,0,0,2,2,1663,2,355
"4296","효곡동","효곡동제7투","대통령선거","경상북도","포항시남구",3102,2392,701,782,437,313,147,4,0,0,1,0,0,0,2,2387,5,710
"4297","대이동","관내사전투표","대통령선거","경상북도","포항시남구",3855,3855,1310,1070,663,471,307,7,0,1,0,0,2,1,6,3838,17,0
"4298","대이동","대이동제1투","대통령선거","경상북도","포항시남구",1240,866,251,328,138,98,49,0,0,0,0,0,0,0,0,864,2,374
"4299","대이동","대이동제2투","대통령선거","경상북도","포항시남구",2002,1437,331,577,267,177,70,4,0,3,0,1,0,0,1,1431,6,565
"4300","대이동","대이동제3투","대통령선거","경상북도","포항시남구",1448,1099,246,488,191,105,52,5,0,0,0,1,0,1,4,1093,6,349
"4301","대이동","대이동제4투","대통령선거","경상북도","포항시남구",1145,688,101,362,109,68,41,2,0,0,0,0,0,0,2,685,3,457
"4302","대이동","대이동제5투","대통령선거","경상북도","포항시남구",2608,1943,463,750,390,222,106,3,0,1,0,0,0,0,1,1936,7,665
"4303","대이동","대이동제6투","대통령선거","경상북도","포항시남구",2669,1932,501,646,408,241,125,5,0,1,1,0,0,0,1,1929,3,737
"4304","잘못 투입·구분된 투표지","잘못 투입·구분된 투표지","대통령선거","경상북도","포항시남구",0,0,0,0,0,0,0,0,0,0,0,0,0,0,0,0,0,0
"4305","거소·선상투표","거소·선상투표","대통령선거","경상북도","울릉군",37,37,13,10,5,3,2,0,0,0,0,0,0,0,1,34,3,0
"4306","관외사전투표","관외사전투표","대통령선거","경상북도","울릉군",1434,1434,436,492,226,168,96,1,0,0,2,1,1,1,1,1425,9,0
"4307","재외투표","재외투표","대통령선거","경상북도","울릉군",24,15,8,1,3,2,1,0,0,0,0,0,0,0,0,15,0,9
"4308","울릉읍","관내사전투표","대통령선거","경상북도","울릉군",979,979,232,473,138,89,35,0,0,0,0,0,0,0,3,970,9,0
"4309","울릉읍","울릉읍제1투","대통령선거","경상북도","울릉군",1739,1045,201,562,162,78,28,1,1,0,1,0,0,1,2,1037,8,694
"4310","울릉읍","울릉읍제2투","대통령선거","경상북도","울릉군",2068,1282,171,800,177,75,39,6,0,1,0,0,1,1,2,1273,9,786
"4311","울릉읍","울릉읍제3투","대통령선거","경상북도","울릉군",451,305,85,146,37,18,13,0,0,2,0,0,0,0,1,302,3,146
"4312","서면","관내사전투표","대통령선거","경상북도","울릉군",247,247,49,134,38,8,13,1,0,0,0,0,1,1,2,247,0,0
"4313","서면","서면제1투","대통령선거","경상북도","울릉군",570,392,64,244,54,19,9,1,0,0,0,0,0,0,0,391,1,178
"4314","서면","서면제2투","대통령선거","경상북도","울릉군",321,239,32,170,24,8,3,0,0,0,0,0,0,0,1,238,1,82
"4315","북면","관내사전투표","대통령선거","경상북도","울릉군",267,267,59,133,40,27,6,0,0,0,1,0,0,0,0,266,1,0
"4316","북면","북면제1투","대통령선거","경상북도","울릉군",508,332,57,200,42,19,12,0,0,0,1,0,0,0,0,331,1,176
"4317","북면","북면제2투","대통령선거","경상북도","울릉군",323,236,36,155,27,10,4,0,0,0,0,1,1,1,1,236,0,87
"4318","잘못 투입·구분된 투표지","잘못 투입·구분된 투표지","대통령선거","경상북도","울릉군",0,0,0,0,0,0,0,0,0,0,0,0,0,0,0,0,0,0
"4319","거소·선상투표","거소·선상투표","대통령선거","경상북도","경주시",752,687,134,255,165,33,22,8,4,9,4,1,3,6,4,648,39,65
"4320","관외사전투표","관외사전투표","대통령선거","경상북도","경주시",16241,16241,5402,4160,2930,2044,1456,22,3,15,9,10,6,5,42,16104,137,0
"4321","재외투표","재외투표","대통령선거","경상북도","경주시",1194,824,417,87,171,43,87,6,0,0,3,0,0,3,1,818,6,370
"4322","감포읍","관내사전투표","대통령선거","경상북도","경주시",864,864,113,553,110,49,23,0,1,0,0,5,1,2,1,858,6,0
"4323","감포읍","감포읍제1투","대통령선거","경상북도","경주시",1781,931,149,613,77,53,29,1,0,1,0,0,0,0,1,924,7,850
"4324","감포읍","감포읍제2투","대통령선거","경상북도","경주시",735,464,58,310,48,33,9,0,0,0,0,0,0,3,0,461,3,271
"4325","감포읍","감포읍제3투","대통령선거","경상북도","경주시",1488,902,104,637,91,32,17,2,0,0,0,4,0,7,2,896,6,586
"4326","안강읍","관내사전투표","대통령선거","경상북도","경주시",5080,5080,963,2788,615,379,263,9,2,2,2,2,2,14,3,5044,36,0
"4327","안강읍","안강읍제1투","대통령선거","경상북도","경주시",2276,1301,168,826,163,90,33,5,2,1,1,0,2,5,0,1296,5,975
"4328","안강읍","안강읍제2투","대통령선거","경상북도","경주시",1958,1320,151,861,154,99,32,6,0,1,2,0,2,1,0,1309,11,638
"4329","안강읍","안강읍제3투","대통령선거","경상북도","경주시",1114,706,93,458,93,31,17,0,0,1,0,0,0,1,1,695,11,408
"4330","안강읍","안강읍제4투","대통령선거","경상북도","경주시",2625,1624,260,924,228,115,81,4,0,1,0,0,0,0,2,1615,9,1001
"4331","안강읍","안강읍제5투","대통령선거","경상북도","경주시",2174,1448,214,797,232,130,62,1,0,0,0,2,1,2,0,1441,7,726
"4332","안강읍","안강읍제6투","대통령선거","경상북도","경주시",2778,1785,343,824,295,185,121,5,0,1,3,2,0,0,1,1780,5,993
"4333","안강읍","안강읍제7투","대통령선거","경상북도","경주시",2712,1877,435,830,274,207,112,2,1,1,0,2,1,3,2,1870,7,835
"4334","안강읍","안강읍제8투","대통령선거","경상북도","경주시",1110,754,129,466,78,48,23,0,1,2,0,0,0,1,1,749,5,356
"4335","건천읍","관내사전투표","대통령선거","경상북도","경주시",1885,1885,430,1013,211,137,72,5,1,0,2,1,0,4,2,1878,7,0
"4336","건천읍","건천읍제1투","대통령선거","경상북도","경주시",2957,1878,286,1184,209,106,63,3,2,2,2,3,1,2,2,1865,13,1079
"4337","건천읍","건천읍제2투","대통령선거","경상북도","경주시",2042,1248,184,801,136,81,27,3,0,0,1,0,1,4,2,1240,8,794
"4338","건천읍","건천읍제3투","대통령선거","경상북도","경주시",1762,1200,147,851,104,59,23,2,1,2,0,1,0,2,3,1195,5,562
"4339","외동읍","관내사전투표","대통령선거","경상북도","경주시",2205,2205,530,1069,303,153,124,5,0,1,0,1,2,7,4,2199,6,0
"4340","외동읍","외동읍제1투","대통령선거","경상북도","경주시",1585,991,190,544,151,60,33,2,0,0,1,0,0,1,5,987,4,594
"4341","외동읍","외동읍제2투","대통령선거","경상북도","경주시",2519,1715,426,768,271,117,116,4,1,0,2,2,0,4,2,1713,2,804
"4342","외동읍","외동읍제3투","대통령선거","경상북도","경주시",1097,718,120,425,96,41,24,1,1,0,0,0,0,4,2,714,4,379
"4343","외동읍","외동읍제4투","대통령선거","경상북도","경주시",1431,949,167,542,131,71,30,2,1,0,0,0,0,1,0,945,4,482
"4344","외동읍","외동읍제5투","대통령선거","경상북도","경주시",1839,1221,222,710,146,63,53,2,1,0,1,0,1,4,7,1210,11,618
"4345","외동읍","외동읍제6투","대통령선거","경상북도","경주시",2521,1591,343,804,241,104,79,3,0,0,1,0,0,1,4,1580,11,930
"4346","양북면","관내사전투표","대통령선거","경상북도","경주시",1144,1144,252,606,140,81,44,1,0,0,0,7,0,3,1,1135,9,0
"4347","양북면","양북면투표소","대통령선거","경상북도","경주시",2584,1577,300,931,191,71,46,3,0,2,2,12,1,5,2,1566,11,1007
"4348","양남면","관내사전투표","대통령선거","경상북도","경주시",1111,1111,376,446,143,75,59,0,0,0,0,6,0,1,2,1108,3,0
"4349","양남면","양남면제1투","대통령선거","경상북도","경주시",2164,1403,252,798,199,71,59,1,0,2,0,4,2,7,2,1397,6,761
"4350","양남면","양남면제2투","대통령선거","경상북도","경주시",1788,1221,366,529,160,81,51,4,1,2,0,10,2,3,4,1213,8,567
"4351","내남면","관내사전투표","대통령선거","경상북도","경주시",975,975,195,542,102,54,66,2,0,0,3,0,1,2,3,970,5,0
"4352","내남면","내남면제1투","대통령선거","경상북도","경주시",1813,1153,203,670,161,51,38,1,1,0,0,0,1,4,3,1133,20,660
"4353","내남면","내남면제2투","대통령선거","경상북도","경주시",1536,988,135,618,116,76,22,2,0,0,1,0,3,8,1,982,6,548
"4354","산내면","관내사전투표","대통령선거","경상북도","경주시",627,627,122,376,62,30,21,0,0,1,0,1,0,5,3,621,6,0
"4355","산내면","산내면투표소","대통령선거","경상북도","경주시",2178,1307,158,875,161,65,14,3,0,1,1,1,4,8,2,1293,14,871
"4356","서면","관내사전투표","대통령선거","경상북도","경주시",724,724,144,439,74,22,28,2,0,0,0,0,0,5,1,715,9,0
"4357","서면","서면투표소","대통령선거","경상북도","경주시",2333,1583,207,1061,175,80,33,6,1,1,2,0,2,5,2,1575,8,750
"4358","현곡면","관내사전투표","대통령선거","경상북도","경주시",2855,2855,895,1000,413,296,216,7,1,1,2,4,4,1,2,2842,13,0
"4359","현곡면","현곡면제1투","대통령선거","경상북도","경주시",1946,1337,270,685,213,82,70,3,0,0,0,1,2,2,1,1329,8,609
"4360","현곡면","현곡면제2투","대통령선거","경상북도","경주시",2107,1652,468,549,276,210,132,6,0,0,0,0,0,1,2,1644,8,455
"4361","현곡면","현곡면제3투","대통령선거","경상북도","경주시",2583,1895,493,764,321,190,111,7,0,0,0,1,1,1,2,1891,4,688
"4362","현곡면","현곡면제4투","대통령선거","경상북도","경주시",1811,1273,174,845,146,60,31,2,0,0,0,0,1,2,3,1264,9,538
"4363","강동면","관내사전투표","대통령선거","경상북도","경주시",1308,1308,245,718,176,72,48,3,1,1,4,0,3,2,2,1275,33,0
"4364","강동면","강동면제1투","대통령선거","경상북도","경주시",2082,1298,146,800,201,80,52,0,0,1,2,2,1,1,2,1288,10,784
"4365","강동면","강동면제2투","대통령선거","경상북도","경주시",2046,1327,258,704,197,107,50,3,1,3,0,1,2,0,1,1327,0,719
"4366","천북면","관내사전투표","대통령선거","경상북도","경주시",1125,1125,200,629,121,88,68,1,1,0,0,0,0,2,3,1113,12,0
"4367","천북면","천북면제1투","대통령선거","경상북도","경주시",2191,1423,192,927,168,83,35,0,1,2,0,2,1,0,4,1415,8,768
"4368","천북면","천북면제2투","대통령선거","경상북도","경주시",954,648,94,395,88,41,22,3,0,0,0,0,0,1,2,646,2,306
"4369","중부동","관내사전투표","대통령선거","경상북도","경주시",1562,1562,318,852,159,130,80,2,0,1,1,4,1,1,2,1551,11,0
"4370","중부동","중부동제1투","대통령선거","경상북도","경주시",2166,1289,222,765,161,86,47,3,1,0,0,1,0,0,2,1288,1,877
"4371","중부동","중부동제2투","대통령선거","경상북도","경주시",1921,1288,183,784,173,90,46,2,0,1,0,0,0,1,2,1282,6,633
"4372","황오동","관내사전투표","대통령선거","경상북도","경주시",2010,2010,411,1109,235,143,94,5,1,0,0,2,0,0,1,2001,9,0
"4373","황오동","황오동제1투","대통령선거","경상북도","경주시",2708,1777,278,1089,232,109,58,0,1,0,0,1,0,3,1,1772,5,931
"4374","황오동","황오동제2투","대통령선거","경상북도","경주시",2267,1455,182,941,198,82,39,3,0,0,0,1,0,0,1,1447,8,812
"4375","성건동","관내사전투표","대통령선거","경상북도","경주시",3385,3385,830,1617,397,298,203,9,1,2,1,2,0,3,3,3366,19,0
"4376","성건동","성건동제1투","대통령선거","경상북도","경주시",2502,1637,290,959,221,95,57,1,0,1,0,1,0,1,3,1629,8,865
"4377","성건동","성건동제2투","대통령선거","경상북도","경주시",2824,1892,314,1126,245,115,69,5,2,6,0,1,0,2,2,1887,5,932
"4378","성건동","성건동제3투","대통령선거","경상북도","경주시",2670,1719,303,955,241,119,82,7,1,1,1,0,0,0,2,1712,7,951
"4379","성건동","성건동제4투","대통령선거","경상북도","경주시",2699,1733,360,868,250,133,108,3,0,2,1,1,0,1,1,1728,5,966
"4380","황남동","관내사전투표","대통령선거","경상북도","경주시",1366,1366,249,815,149,80,59,2,0,0,1,0,0,2,1,1358,8,0
"4381","황남동","황남동제1투","대통령선거","경상북도","경주시",1938,1225,148,791,171,70,34,0,0,2,0,0,0,1,3,1220,5,713
"4382","황남동","황남동제2투","대통령선거","경상북도","경주시",2190,1469,202,926,180,96,47,3,0,0,1,1,0,3,1,1460,9,721
"4383","월성동","관내사전투표","대통령선거","경상북도","경주시",1218,1218,309,607,143,86,59,4,0,0,0,1,0,3,0,1212,6,0
"4384","월성동","월성동제1투","대통령선거","경상북도","경주시",1818,1196,161,749,164,60,43,6,0,0,3,0,0,1,2,1189,7,622
"4385","월성동","월성동제2투","대통령선거","경상북도","경주시",2515,1802,396,939,243,124,83,2,0,3,1,3,0,0,5,1799,3,713
"4386","선도동","관내사전투표","대통령선거","경상북도","경주시",2752,2752,889,1048,342,260,180,8,0,1,1,1,0,1,7,2738,14,0
"4387","선도동","선도동제1투","대통령선거","경상북도","경주시",2678,1802,409,834,271,171,105,1,0,1,0,1,0,0,1,1794,8,876
"4388","선도동","선도동제2투","대통령선거","경상북도","경주시",3599,2572,648,1147,383,229,145,3,0,1,1,2,0,3,4,2566,6,1027
"4389","선도동","선도동제3투","대통령선거","경상북도","경주시",2139,1447,379,577,241,154,83,4,0,0,0,1,0,0,1,1440,7,692
"4390","용강동","관내사전투표","대통령선거","경상북도","경주시",2468,2468,769,847,360,254,206,6,1,2,1,3,1,1,3,2454,14,0
"4391","용강동","용강동제1투","대통령선거","경상북도","경주시",2877,1980,469,849,307,187,148,5,0,1,0,6,0,0,2,1974,6,897
"4392","용강동","용강동제2투","대통령선거","경상북도","경주시",1455,992,301,337,163,103,82,0,0,0,1,0,0,2,0,989,3,463
"4393","용강동","용강동제3투","대통령선거","경상북도","경주시",2653,1877,362,896,329,160,99,7,0,3,3,3,2,0,4,1868,9,776
"4394","용강동","용강동제4투","대통령선거","경상북도","경주시",3059,2324,618,896,380,245,163,7,0,1,1,1,3,0,1,2316,8,735
"4395","황성동","관내사전투표","대통령선거","경상북도","경주시",5370,5370,1974,1569,801,517,470,13,0,1,1,3,0,0,4,5353,17,0
"4396","황성동","황성동제1투","대통령선거","경상북도","경주시",2822,2021,547,780,349,195,134,8,1,0,1,0,2,0,0,2017,4,801
"4397","황성동","황성동제2투","대통령선거","경상북도","경주시",2439,1813,396,858,278,183,84,1,0,0,0,5,0,0,1,1806,7,626
"4398","황성동","황성동제3투","대통령선거","경상북도","경주시",2643,1998,628,646,346,204,151,9,1,1,0,4,1,1,1,1993,5,645
"4399","황성동","황성동제4투","대통령선거","경상북도","경주시",2543,1908,512,693,317,215,155,1,0,0,0,4,0,1,0,1898,10,635
"4400","황성동","황성동제5투","대통령선거","경상북도","경주시",2875,2122,571,747,403,245,142,3,1,1,0,0,1,0,1,2115,7,753
"4401","황성동","황성동제6투","대통령선거","경상북도","경주시",2187,1519,315,697,251,126,120,1,1,0,0,2,3,0,0,1516,3,668
"4402","동천동","관내사전투표","대통령선거","경상북도","경주시",4090,4090,1137,1760,528,363,260,8,0,2,2,4,1,2,2,4069,21,0
"4403","동천동","동천동제1투","대통령선거","경상북도","경주시",2315,1499,260,864,187,105,64,5,0,2,0,1,1,0,1,1490,9,816
"4404","동천동","동천동제2투","대통령선거","경상북도","경주시",2404,1781,400,824,276,168,101,4,0,0,0,1,0,2,1,1777,4,623
"4405","동천동","동천동제3투","대통령선거","경상북도","경주시",2876,1866,421,890,252,164,124,4,1,0,0,1,0,1,1,1859,7,1010
"4406","동천동","동천동제4투","대통령선거","경상북도","경주시",2471,1635,367,776,237,125,112,2,0,3,0,0,0,0,2,1624,11,836
"4407","동천동","동천동제5투","대통령선거","경상북도","경주시",2796,1950,402,938,292,173,127,1,2,1,0,4,1,2,1,1944,6,846
"4408","동천동","동천동제6투","대통령선거","경상북도","경주시",2594,1887,414,901,266,164,128,3,0,0,0,2,1,0,2,1881,6,707
"4409","불국동","관내사전투표","대통령선거","경상북도","경주시",2169,2169,493,1071,296,165,115,0,0,1,1,5,2,6,6,2161,8,0
"4410","불국동","불국동제1투","대통령선거","경상북도","경주시",2834,1752,336,902,308,108,81,4,0,1,1,1,0,1,1,1744,8,1082
"4411","불국동","불국동제2투","대통령선거","경상북도","경주시",2703,1805,297,1039,258,131,66,2,0,0,0,0,1,2,2,1798,7,898
"4412","보덕동","관내사전투표","대통령선거","경상북도","경주시",715,715,187,326,88,53,53,0,0,0,1,3,0,1,0,712,3,0
"4413","보덕동","보덕동투표소","대통령선거","경상북도","경주시",1159,796,112,479,100,67,21,1,0,0,0,1,1,2,4,788,8,363
"4414","잘못 투입·구분된 투표지","잘못 투입·구분된 투표지","대통령선거","경상북도","경주시",0,0,0,0,0,0,0,0,0,0,0,0,0,0,0,0,0,0
"4415","거소·선상투표","거소·선상투표","대통령선거","경상북도","김천시",450,405,80,162,87,13,10,4,3,1,3,2,1,3,1,370,35,45
"4416","관외사전투표","관외사전투표","대통령선거","경상북도","김천시",9731,9729,3456,2438,1603,1194,875,16,2,5,4,7,4,10,26,9640,89,2
"4417","재외투표","재외투표","대통령선거","경상북도","김천시",773,454,207,65,108,20,50,3,0,0,1,0,0,0,0,454,0,319
"4418","아포읍","관내사전투표","대통령선거","경상북도","김천시",1409,1408,280,769,169,89,77,8,1,0,2,1,0,2,3,1401,7,1
"4419","아포읍","아포읍제1투","대통령선거","경상북도","김천시",1326,865,102,598,100,32,19,3,0,0,2,0,1,2,0,859,6,461
"4420","아포읍","아포읍제2투","대통령선거","경상북도","김천시",1124,751,70,520,100,31,20,2,0,0,0,0,1,2,1,747,4,373
"4421","아포읍","아포읍제3투","대통령선거","경상북도","김천시",2350,1382,205,805,184,99,69,6,0,0,1,0,1,2,1,1373,9,968
"4422","농소면","관내사전투표","대통령선거","경상북도","김천시",627,627,196,280,79,27,37,0,1,1,1,1,0,0,2,625,2,0
"4423","농소면","농소면제1투","대통령선거","경상북도","김천시",899,591,130,329,72,18,36,0,0,0,0,2,0,3,0,590,1,308
"4424","농소면","농소면제2투","대통령선거","경상북도","김천시",1219,829,241,365,104,44,62,0,0,0,0,1,0,3,5,825,4,390
"4425","남면","관내사전투표","대통령선거","경상북도","김천시",573,573,134,277,89,42,26,0,0,1,1,0,0,0,0,570,3,0
"4426","남면","남면제1투","대통령선거","경상북도","김천시",1200,739,112,449,96,33,19,3,2,2,0,0,0,4,3,723,16,461
"4427","남면","남면제2투","대통령선거","경상북도","김천시",1040,695,110,432,84,30,26,2,0,0,0,0,1,1,1,687,8,345
"4428","개령면","관내사전투표","대통령선거","경상북도","김천시",598,598,117,366,65,25,19,1,0,0,0,0,0,0,0,593,5,0
"4429","개령면","개령면투표소","대통령선거","경상북도","김천시",1683,1118,115,732,156,61,30,3,2,1,0,1,1,6,1,1109,9,565
"4430","감문면","관내사전투표","대통령선거","경상북도","김천시",798,798,88,579,68,33,20,1,0,1,0,0,1,2,5,798,0,0
"4431","감문면","감문면제1투","대통령선거","경상북도","김천시",1290,841,80,602,76,37,26,0,0,0,0,0,0,9,1,831,10,449
"4432","감문면","감문면제2투","대통령선거","경상북도","김천시",965,670,61,511,57,19,12,0,0,0,0,0,1,4,0,665,5,295
"4433","어모면","관내사전투표","대통령선거","경상북도","김천시",999,999,185,532,138,50,71,4,1,4,1,1,1,2,0,990,9,0
"4434","어모면","어모면제1투","대통령선거","경상북도","김천시",1634,1045,125,691,121,55,33,0,0,2,0,0,2,7,1,1037,8,589
"4435","어모면","어모면제2투","대통령선거","경상북도","김천시",1209,730,60,505,106,25,18,0,0,2,1,1,2,4,0,724,6,479
"4436","봉산면","관내사전투표","대통령선거","경상북도","김천시",579,579,115,301,83,41,27,3,0,1,0,0,0,0,0,571,8,0
"4437","봉산면","봉산면제1투","대통령선거","경상북도","김천시",1322,912,129,580,125,38,27,1,0,0,0,0,1,3,4,908,4,410
"4438","봉산면","봉산면제2투","대통령선거","경상북도","김천시",1042,765,70,531,100,35,19,1,0,2,0,0,0,0,2,760,5,277
"4439","대항면","관내사전투표","대통령선거","경상북도","김천시",575,575,132,294,75,32,36,0,1,0,0,0,0,1,0,571,4,0
"4440","대항면","대항면제1투","대통령선거","경상북도","김천시",1526,1012,125,658,136,44,33,1,0,1,0,0,2,2,2,1004,8,514
"4441","대항면","대항면제2투","대통령선거","경상북도","김천시",1077,756,104,484,106,32,25,1,0,0,0,0,0,0,1,753,3,321
"4442","감천면","관내사전투표","대통령선거","경상북도","김천시",411,411,76,221,63,15,26,0,0,1,0,0,0,1,5,408,3,0
"4443","감천면","감천면투표소","대통령선거","경상북도","김천시",1431,1021,105,702,125,46,29,0,0,1,0,0,1,3,1,1013,8,410
"4444","조마면","관내사전투표","대통령선거","경상북도","김천시",406,406,67,246,55,10,21,1,0,0,0,0,0,3,0,403,3,0
"4445","조마면","조마면투표소","대통령선거","경상북도","김천시",1550,1047,131,665,145,46,33,2,1,0,1,0,5,7,1,1037,10,503
"4446","구성면","관내사전투표","대통령선거","경상북도","김천시",384,384,66,248,29,13,14,5,0,0,0,0,1,2,1,379,5,0
"4447","구성면","구성면제1투","대통령선거","경상북도","김천시",1133,743,92,521,84,27,12,0,1,1,0,0,0,1,1,740,3,390
"4448","구성면","구성면제2투","대통령선거","경상북도","김천시",1008,625,83,426,70,19,17,1,0,0,1,1,1,1,1,621,4,383
"4449","지례면","관내사전투표","대통령선거","경상북도","김천시",421,421,96,230,46,28,14,0,0,0,0,0,0,2,0,416,5,0
"4450","지례면","지례면제1투","대통령선거","경상북도","김천시",917,639,97,418,68,33,9,1,0,0,0,0,1,4,3,634,5,278
"4451","지례면","지례면제2투","대통령선거","경상북도","김천시",272,207,18,136,31,7,4,0,0,0,0,0,0,5,2,203,4,65
"4452","부항면","관내사전투표","대통령선거","경상북도","김천시",303,303,44,187,43,10,11,0,0,1,0,0,0,1,5,302,1,0
"4453","부항면","부항면투표소","대통령선거","경상북도","김천시",805,504,70,314,79,18,10,0,1,0,0,1,2,3,4,502,2,301
"4454","대덕면","관내사전투표","대통령선거","경상북도","김천시",490,490,103,291,53,14,16,1,0,2,1,0,0,3,1,485,5,0
"4455","대덕면","대덕면투표소","대통령선거","경상북도","김천시",1406,860,102,553,117,35,28,2,0,2,0,0,5,6,1,851,9,546
"4456","증산면","관내사전투표","대통령선거","경상북도","김천시",251,251,50,141,25,9,16,2,0,1,0,1,0,1,2,248,3,0
"4457","증산면","증산면투표소","대통령선거","경상북도","김천시",743,512,60,343,64,12,16,7,0,2,0,0,1,3,1,509,3,231
"4458","자산동","관내사전투표","대통령선거","경상북도","김천시",1456,1456,332,779,146,78,97,2,0,5,1,0,0,0,1,1441,15,0
"4459","자산동","자산동제1투","대통령선거","경상북도","김천시",1470,979,117,654,116,53,26,2,0,1,1,0,0,0,1,971,8,491
"4460","자산동","자산동제2투","대통령선거","경상북도","김천시",1927,1261,213,735,169,85,47,2,0,1,0,0,0,1,2,1255,6,666
"4461","자산동","자산동제3투","대통령선거","경상북도","김천시",1976,1363,195,841,181,76,61,2,0,0,0,0,0,1,0,1357,6,613
"4462","평화남산동","관내사전투표","대통령선거","경상북도","김천시",1568,1568,380,748,189,124,101,2,1,4,1,4,0,2,2,1558,10,0
"4463","평화남산동","평화남산동제1투","대통령선거","경상북도","김천시",1385,924,117,618,105,42,26,3,1,0,0,0,1,2,0,915,9,461
"4464","평화남산동","평화남산동제2투","대통령선거","경상북도","김천시",1792,1137,174,731,130,57,35,0,0,1,0,2,0,1,1,1132,5,655
"4465","평화남산동","평화남산동제3투","대통령선거","경상북도","김천시",1540,1018,195,588,122,44,52,1,1,3,0,2,2,2,1,1013,5,522
"4466","평화남산동","평화남산동제4투","대통령선거","경상북도","김천시",1591,1051,154,661,128,59,32,5,1,0,0,0,0,1,2,1043,8,540
"4467","양금동","관내사전투표","대통령선거","경상북도","김천시",902,902,186,494,105,51,53,3,0,1,1,0,0,0,0,894,8,0
"4468","양금동","양금동제1투","대통령선거","경상북도","김천시",1285,937,108,661,90,39,28,0,0,1,0,0,0,2,3,932,5,348
"4469","양금동","양금동제2투","대통령선거","경상북도","김천시",1691,1202,181,750,139,67,41,3,0,2,1,1,1,3,0,1189,13,489
"4470","대신동","관내사전투표","대통령선거","경상북도","김천시",3713,3713,1257,1159,550,357,345,8,3,2,1,1,3,4,8,3698,15,0
"4471","대신동","대신동제1투","대통령선거","경상북도","김천시",2969,1857,437,847,286,139,134,4,0,1,1,2,1,0,1,1853,4,1112
"4472","대신동","대신동제2투","대통령선거","경상북도","김천시",1928,1416,378,550,236,117,126,1,0,0,0,1,0,0,0,1409,7,512
"4473","대신동","대신동제3투","대통령선거","경상북도","김천시",1940,1357,328,591,220,96,105,0,0,0,2,0,0,3,2,1347,10,583
"4474","대신동","대신동제4투","대통령선거","경상북도","김천시",2088,1597,376,694,260,124,130,1,0,1,2,1,0,1,1,1591,6,491
"4475","대신동","대신동제5투","대통령선거","경상북도","김천시",1624,1067,183,560,191,72,46,2,0,2,0,0,0,3,2,1061,6,557
"4476","대신동","대신동제6투","대통령선거","경상북도","김천시",3186,2107,479,969,327,164,148,4,0,2,0,0,2,2,2,2099,8,1079
"4477","대곡동","관내사전투표","대통령선거","경상북도","김천시",3693,3693,932,1644,510,325,249,3,1,2,2,3,2,0,3,3676,17,0
"4478","대곡동","대곡동제1투","대통령선거","경상북도","김천시",2208,1506,292,784,220,110,71,7,0,1,0,0,1,1,3,1490,16,702
"4479","대곡동","대곡동제2투","대통령선거","경상북도","김천시",1569,994,156,579,150,62,36,0,0,0,0,0,0,1,3,987,7,575
"4480","대곡동","대곡동제3투","대통령선거","경상북도","김천시",2425,1778,424,806,285,152,101,1,1,0,1,2,0,0,1,1774,4,647
"4481","대곡동","대곡동제4투","대통령선거","경상북도","김천시",1988,1254,200,723,172,83,68,0,0,0,0,0,0,0,2,1248,6,734
"4482","대곡동","대곡동제5투","대통령선거","경상북도","김천시",1489,934,230,434,141,62,52,3,0,1,0,0,1,1,2,927,7,555
"4483","대곡동","대곡동제6투","대통령선거","경상북도","김천시",1842,1148,234,635,136,84,52,2,0,1,0,0,0,1,1,1146,2,694
"4484","지좌동","관내사전투표","대통령선거","경상북도","김천시",1872,1872,465,908,238,114,126,0,0,0,0,0,0,4,4,1859,13,0
"4485","지좌동","지좌동제1투","대통령선거","경상북도","김천시",3191,1902,423,917,280,123,135,2,0,4,0,3,0,3,2,1892,10,1289
"4486","지좌동","지좌동제2투","대통령선거","경상북도","김천시",2232,1460,266,822,187,77,80,3,0,5,3,0,3,3,1,1450,10,772
"4487","율곡동","관내사전투표","대통령선거","경상북도","김천시",4066,4066,2128,627,547,335,402,3,0,1,1,4,1,0,6,4055,11,0
"4488","율곡동","율곡동제1투","대통령선거","경상북도","김천시",2212,1584,751,307,253,126,139,4,0,0,0,0,0,0,1,1581,3,628
"4489","율곡동","율곡동제2투","대통령선거","경상북도","김천시",2509,1996,1058,317,307,149,156,0,0,1,0,2,0,1,1,1992,4,513
"4490","율곡동","율곡동제3투","대통령선거","경상북도","김천시",2549,1815,817,368,303,149,160,3,1,0,0,0,1,3,3,1808,7,734
"4491","잘못 투입·구분된 투표지","잘못 투입·구분된 투표지","대통령선거","경상북도","김천시",0,0,0,0,0,0,0,0,0,0,0,0,0,0,0,0,0,0
"4492","거소·선상투표","거소·선상투표","대통령선거","경상북도","안동시",637,590,115,243,120,41,18,5,3,3,2,2,3,1,2,558,32,47
"4493","관외사전투표","관외사전투표","대통령선거","경상북도","안동시",9794,9794,3377,2462,1708,1307,788,13,2,4,3,6,0,7,29,9706,88,0
"4494","재외투표","재외투표","대통령선거","경상북도","안동시",630,404,231,37,54,13,62,2,0,0,0,0,0,1,0,400,4,226
"4495","풍산읍","관내사전투표","대통령선거","경상북도","안동시",1358,1358,272,736,172,102,51,3,0,0,2,1,3,1,2,1345,13,0
"4496","풍산읍","풍산읍제1투","대통령선거","경상북도","안동시",1615,993,158,581,146,67,22,3,0,0,0,2,1,2,2,984,9,622
"4497","풍산읍","풍산읍제2투","대통령선거","경상북도","안동시",743,545,65,377,67,17,9,2,0,0,0,0,0,3,1,541,4,198
"4498","풍산읍","풍산읍제3투","대통령선거","경상북도","안동시",985,636,82,420,79,26,11,2,1,0,0,0,1,2,1,625,11,349
"4499","풍산읍","풍산읍제4투","대통령선거","경상북도","안동시",1383,889,115,565,118,62,15,3,0,0,0,1,0,6,1,886,3,494
"4500","와룡면","관내사전투표","대통령선거","경상북도","안동시",758,758,169,404,101,48,23,0,0,0,0,0,1,1,2,749,9,0
"4501","와룡면","와룡면제1투","대통령선거","경상북도","안동시",1889,1219,139,847,138,43,28,2,0,1,1,1,0,8,2,1210,9,670
"4502","와룡면","와룡면제2투","대통령선거","경상북도","안동시",1064,716,88,450,100,40,16,1,0,1,0,2,1,3,3,705,11,348
"4503","북후면","관내사전투표","대통령선거","경상북도","안동시",565,565,102,264,87,40,7,3,2,1,0,3,2,5,3,519,46,0
"4504","북후면","북후면제1투","대통령선거","경상북도","안동시",1457,992,118,640,121,69,17,0,0,2,0,1,2,10,2,982,10,465
"4505","북후면","북후면제2투","대통령선거","경상북도","안동시",917,579,68,338,64,47,17,0,1,1,4,2,2,4,1,549,30,338
"4506","서후면","관내사전투표","대통령선거","경상북도","안동시",476,476,100,254,65,28,23,0,1,0,0,0,1,2,0,474,2,0
"4507","서후면","서후면제1투","대통령선거","경상북도","안동시",1559,934,126,615,97,60,19,1,1,1,1,1,3,4,2,931,3,625
"4508","서후면","서후면제2투","대통령선거","경상북도","안동시",969,676,92,426,80,49,16,1,1,0,0,0,2,3,0,670,6,293
"4509","풍천면","관내사전투표","대통령선거","경상북도","안동시",764,764,157,409,95,56,36,1,0,0,0,1,0,1,1,757,7,0
"4510","풍천면","풍천면제1투","대통령선거","경상북도","안동시",1625,1040,150,642,147,67,18,2,0,0,1,0,1,3,1,1032,8,585
"4511","풍천면","풍천면제2투","대통령선거","경상북도","안동시",930,612,65,437,61,21,13,2,0,0,0,0,2,6,3,610,2,318
"4512","풍천면","풍천면제3투","대통령선거","경상북도","안동시",413,292,22,225,29,8,3,1,0,0,0,0,0,2,1,291,1,121
"4513","일직면","관내사전투표","대통령선거","경상북도","안동시",725,725,83,480,98,35,16,1,1,1,0,0,2,5,0,722,3,0
"4514","일직면","일직면제1투","대통령선거","경상북도","안동시",970,663,64,478,71,21,12,0,0,0,1,0,1,7,1,656,7,307
"4515","일직면","일직면제2투","대통령선거","경상북도","안동시",979,620,75,408,83,28,15,0,0,0,2,0,0,4,1,616,4,359
"4516","남후면","관내사전투표","대통령선거","경상북도","안동시",465,465,99,253,60,26,17,2,0,0,1,0,0,1,0,459,6,0
"4517","남후면","남후면투표소","대통령선거","경상북도","안동시",1361,924,87,649,100,41,21,5,0,2,1,0,1,10,2,919,5,437
"4518","남선면","관내사전투표","대통령선거","경상북도","안동시",305,305,74,154,38,26,10,0,0,0,0,0,1,0,1,304,1,0
"4519","남선면","남선면제1투","대통령선거","경상북도","안동시",888,612,78,394,78,40,13,1,0,0,0,1,0,2,1,608,4,276
"4520","남선면","남선면제2투","대통령선거","경상북도","안동시",698,507,76,340,54,15,12,0,0,0,1,1,1,4,0,504,3,191
"4521","임하면","관내사전투표","대통령선거","경상북도","안동시",804,804,181,371,128,51,33,8,2,3,3,3,2,5,5,795,9,0
"4522","임하면","임하면제1투","대통령선거","경상북도","안동시",1455,818,84,562,90,38,35,2,0,0,1,0,0,3,2,817,1,637
"4523","임하면","임하면제2투","대통령선거","경상북도","안동시",512,370,43,258,38,13,11,1,0,0,0,0,0,3,1,368,2,142
"4524","길안면","관내사전투표","대통령선거","경상북도","안동시",649,649,119,380,87,34,18,1,0,0,0,0,2,1,3,645,4,0
"4525","길안면","길안면제1투","대통령선거","경상북도","안동시",1293,821,105,529,100,47,13,2,2,0,2,0,1,4,3,808,13,472
"4526","길안면","길안면제2투","대통령선거","경상북도","안동시",429,288,27,204,23,19,10,0,0,0,0,0,1,0,0,284,4,141
"4527","길안면","길안면제3투","대통령선거","경상북도","안동시",335,243,24,185,18,8,1,2,0,0,0,0,1,2,0,241,2,92
"4528","임동면","관내사전투표","대통령선거","경상북도","안동시",541,541,74,366,53,32,9,0,1,1,0,0,1,3,0,540,1,0
"4529","임동면","임동면투표소","대통령선거","경상북도","안동시",1099,634,67,425,87,28,16,0,0,0,1,0,3,2,0,629,5,465
"4530","예안면","관내사전투표","대통령선거","경상북도","안동시",342,342,74,196,35,23,12,0,0,0,0,0,0,1,1,342,0,0
"4531","예안면","예안면제1투","대통령선거","경상북도","안동시",891,577,86,362,72,33,12,1,0,1,0,1,0,0,1,569,8,314
"4532","예안면","예안면제2투","대통령선거","경상북도","안동시",491,350,59,190,61,28,3,0,0,0,0,0,2,4,2,349,1,141
"4533","도산면","관내사전투표","대통령선거","경상북도","안동시",323,323,51,176,46,26,18,1,1,0,0,0,0,2,1,322,1,0
"4534","도산면","도산면투표소","대통령선거","경상북도","안동시",1251,829,108,523,111,44,19,1,1,1,1,0,2,7,2,820,9,422
"4535","녹전면","관내사전투표","대통령선거","경상북도","안동시",192,192,43,101,29,10,6,3,0,0,0,0,0,0,0,192,0,0
"4536","녹전면","녹전면제1투","대통령선거","경상북도","안동시",930,653,67,437,96,27,8,2,0,2,0,1,2,2,2,646,7,277
"4537","녹전면","녹전면제2투","대통령선거","경상북도","안동시",503,360,35,240,55,16,6,3,0,0,0,0,1,2,0,358,2,143
"4538","중구동","관내사전투표","대통령선거","경상북도","안동시",1387,1387,322,666,166,141,79,0,0,0,1,1,0,1,1,1378,9,0
"4539","중구동","중구동제1투","대통령선거","경상북도","안동시",1282,825,134,479,105,74,26,3,0,1,1,0,0,2,0,825,0,457
"4540","중구동","중구동제2투","대통령선거","경상북도","안동시",862,590,62,420,58,30,11,2,0,0,1,0,0,1,1,586,4,272
"4541","중구동","중구동제3투","대통령선거","경상북도","안동시",1096,654,77,429,78,40,20,2,0,0,0,1,0,3,0,650,4,442
"4542","명륜동","관내사전투표","대통령선거","경상북도","안동시",1293,1292,330,581,173,120,71,3,1,1,1,1,1,2,2,1287,5,1
"4543","명륜동","명륜동제1투","대통령선거","경상북도","안동시",2005,1424,282,720,225,119,69,0,0,2,0,0,0,2,0,1419,5,581
"4544","명륜동","명륜동제2투","대통령선거","경상북도","안동시",1426,960,151,548,150,73,36,0,0,0,0,0,0,0,0,958,2,466
"4545","용상동","관내사전투표","대통령선거","경상북도","안동시",3833,3832,1024,1626,521,379,236,9,1,2,1,1,0,5,4,3809,23,1
"4546","용상동","용상동제1투","대통령선거","경상북도","안동시",1969,1356,305,602,227,145,64,0,0,2,1,0,2,1,0,1349,7,613
"4547","용상동","용상동제2투","대통령선거","경상북도","안동시",1159,668,109,388,84,55,28,1,0,0,0,0,0,0,2,667,1,491
"4548","용상동","용상동제3투","대통령선거","경상북도","안동시",1854,1233,228,681,153,103,50,1,0,0,1,0,2,1,1,1221,12,621
"4549","용상동","용상동제4투","대통령선거","경상북도","안동시",1119,725,129,405,98,36,46,1,0,1,0,0,0,0,1,717,8,394
"4550","용상동","용상동제5투","대통령선거","경상북도","안동시",1431,878,143,489,130,63,42,1,0,2,0,1,0,2,1,874,4,553
"4551","용상동","용상동제6투","대통령선거","경상북도","안동시",2253,1711,442,656,335,170,99,0,0,0,2,1,1,1,1,1708,3,542
"4552","용상동","용상동제7투","대통령선거","경상북도","안동시",1934,1397,340,610,223,117,88,1,1,2,2,0,1,1,0,1386,11,537
"4553","용상동","용상동제8투","대통령선거","경상북도","안동시",1090,691,121,389,82,58,32,1,0,1,1,0,1,1,1,688,3,399
"4554","서구동","관내사전투표","대통령선거","경상북도","안동시",1711,1711,463,732,252,147,105,3,0,1,2,0,0,1,0,1706,5,0
"4555","서구동","서구동제1투","대통령선거","경상북도","안동시",2147,1525,369,678,248,165,57,2,1,0,1,0,0,0,1,1522,3,622
"4556","서구동","서구동제2투","대통령선거","경상북도","안동시",1885,1274,156,848,161,70,25,0,0,1,2,0,0,2,2,1267,7,611
"4557","서구동","서구동제3투","대통령선거","경상북도","안동시",1165,798,125,489,88,58,32,1,0,0,0,0,0,2,0,795,3,367
"4558","서구동","서구동제4투","대통령선거","경상북도","안동시",1156,856,132,512,119,58,31,1,0,1,0,1,0,0,0,855,1,300
"4559","태화동","관내사전투표","대통령선거","경상북도","안동시",1994,1994,413,1086,240,171,68,2,0,2,1,1,0,1,3,1988,6,0
"4560","태화동","태화동제1투","대통령선거","경상북도","안동시",1342,885,121,578,100,53,21,4,0,0,0,1,0,1,0,879,6,457
"4561","태화동","태화동제2투","대통령선거","경상북도","안동시",1665,1089,175,623,157,86,37,5,0,0,0,1,0,1,1,1086,3,576
"4562","태화동","태화동제3투","대통령선거","경상북도","안동시",1822,1168,167,736,142,80,31,2,1,2,0,0,2,1,0,1164,4,654
"4563","태화동","태화동제4투","대통령선거","경상북도","안동시",1672,1117,191,601,164,100,46,1,0,0,1,0,0,2,1,1107,10,555
"4564","태화동","태화동제5투","대통령선거","경상북도","안동시",2432,1652,372,801,245,154,72,0,0,1,1,1,1,1,0,1649,3,780
"4565","평화동","관내사전투표","대통령선거","경상북도","안동시",1182,1182,257,593,181,88,51,2,0,1,0,1,0,0,2,1176,6,0
"4566","평화동","평화동제1투","대통령선거","경상북도","안동시",1419,950,155,521,145,78,37,4,0,1,2,0,1,1,2,947,3,469
"4567","평화동","평화동제2투","대통령선거","경상북도","안동시",1117,747,138,415,103,61,26,0,0,0,0,0,0,0,0,743,4,370
"4568","평화동","평화동제3투","대통령선거","경상북도","안동시",1764,1249,228,699,151,110,42,3,0,3,0,1,1,2,1,1241,8,515
"4569","안기동","관내사전투표","대통령선거","경상북도","안동시",1347,1347,362,604,152,119,95,1,0,1,3,1,0,1,2,1341,6,0
"4570","안기동","안기동제1투","대통령선거","경상북도","안동시",998,721,147,369,109,55,38,0,0,1,0,1,0,0,0,720,1,277
"4571","안기동","안기동제2투","대통령선거","경상북도","안동시",1375,906,138,557,96,77,26,0,0,0,1,0,1,3,1,900,6,469
"4572","안기동","안기동제3투","대통령선거","경상북도","안동시",1849,1348,236,720,219,92,64,2,2,2,1,0,1,3,0,1342,6,501
"4573","옥동","관내사전투표","대통령선거","경상북도","안동시",3679,3679,1166,1182,551,444,304,6,0,2,5,0,0,1,3,3664,15,0
"4574","옥동","옥동제1투","대통령선거","경상북도","안동시",2885,1907,421,848,303,201,119,0,1,0,0,1,0,3,1,1898,9,978
"4575","옥동","옥동제2투","대통령선거","경상북도","안동시",2376,1760,560,570,288,210,118,2,0,2,0,0,0,3,1,1754,6,616
"4576","옥동","옥동제3투","대통령선거","경상북도","안동시",1953,1486,307,741,206,129,89,0,1,1,0,1,1,0,1,1477,9,467
"4577","옥동","옥동제4투","대통령선거","경상북도","안동시",1447,877,136,532,122,38,22,1,1,2,0,0,2,10,1,867,10,570
"4578","옥동","옥동제5투","대통령선거","경상북도","안동시",1750,1214,267,539,213,121,61,0,0,0,2,0,1,1,1,1206,8,536
"4579","옥동","옥동제6투","대통령선거","경상북도","안동시",1609,1109,228,468,203,123,77,0,0,2,0,1,2,0,1,1105,4,500
"4580","옥동","옥동제7투","대통령선거","경상북도","안동시",1311,875,199,430,124,77,40,1,0,0,1,0,0,1,1,874,1,436
"4581","송하동","관내사전투표","대통령선거","경상북도","안동시",2677,2677,857,946,380,269,194,0,0,0,3,4,1,1,1,2656,21,0
"4582","송하동","송하동제1투","대통령선거","경상북도","안동시",1839,1266,268,616,200,111,57,2,0,2,0,1,2,1,2,1262,4,573
"4583","송하동","송하동제2투","대통령선거","경상북도","안동시",1499,979,228,452,147,104,43,2,0,0,0,1,0,0,0,977,2,520
"4584","송하동","송하동제3투","대통령선거","경상북도","안동시",1488,981,179,501,156,90,46,3,0,0,0,0,0,0,1,976,5,507
"4585","송하동","송하동제4투","대통령선거","경상북도","안동시",1626,1197,280,528,205,125,49,4,0,0,0,0,2,2,0,1195,2,429
"4586","송하동","송하동제5투","대통령선거","경상북도","안동시",1923,1358,280,617,242,139,72,0,1,0,0,0,0,0,2,1353,5,565
"4587","강남동","관내사전투표","대통령선거","경상북도","안동시",1830,1830,641,572,269,206,124,2,0,0,3,1,0,1,2,1821,9,0
"4588","강남동","강남동제1투","대통령선거","경상북도","안동시",998,639,80,401,98,39,14,1,0,1,0,0,1,0,1,636,3,359
"4589","강남동","강남동제2투","대통령선거","경상북도","안동시",2299,1632,399,698,280,161,91,0,0,0,1,0,0,1,1,1632,0,667
"4590","강남동","강남동제3투","대통령선거","경상북도","안동시",1751,1301,387,452,234,134,79,5,1,0,0,1,0,2,1,1296,5,450
"4591","잘못 투입·구분된 투표지","잘못 투입·구분된 투표지","대통령선거","경상북도","안동시",0,1,0,1,0,0,0,0,0,0,0,0,0,0,0,1,0,-1
"4592","거소·선상투표","거소·선상투표","대통령선거","경상북도","구미시",668,643,160,171,180,59,28,5,2,3,2,0,1,1,5,617,26,25
"4593","관외사전투표","관외사전투표","대통령선거","경상북도","구미시",24211,24209,8051,5580,4669,3284,2173,43,8,6,6,17,14,14,72,23937,272,2
"4594","재외투표","재외투표","대통령선거","경상북도","구미시",1209,834,422,71,175,67,87,4,0,0,0,0,0,1,2,829,5,375
"4595","선산읍","관내사전투표","대통령선거","경상북도","구미시",3124,3124,540,1787,356,243,160,7,1,0,1,1,1,3,6,3106,18,0
"4596","선산읍","선산읍제1투","대통령선거","경상북도","구미시",1844,1142,116,790,139,50,36,3,1,1,0,0,0,1,1,1138,4,702
"4597","선산읍","선산읍제2투","대통령선거","경상북도","구미시",1518,963,142,575,135,62,35,3,0,2,2,0,0,0,1,957,6,555
"4598","선산읍","선산읍제3투","대통령선거","경상북도","구미시",2160,1435,118,1013,176,80,35,1,0,1,0,0,2,5,2,1433,2,725
"4599","선산읍","선산읍제4투","대통령선거","경상북도","구미시",718,518,39,378,54,29,12,1,0,0,1,1,1,2,0,518,0,200
"4600","선산읍","선산읍제5투","대통령선거","경상북도","구미시",3239,2079,335,1232,280,133,77,2,0,0,3,1,0,2,4,2069,10,1160
"4601","고아읍","관내사전투표","대통령선거","경상북도","구미시",1889,1889,446,859,290,172,103,6,1,0,1,0,0,1,0,1879,10,0
"4602","고아읍","고아읍제1투","대통령선거","경상북도","구미시",1838,1211,140,801,138,75,33,5,0,0,1,0,1,5,2,1201,10,627
"4603","고아읍","고아읍제2투","대통령선거","경상북도","구미시",2235,1454,198,884,208,94,54,3,0,1,0,0,2,1,1,1446,8,781
"4604","고아읍","고아읍제3투","대통령선거","경상북도","구미시",3536,2608,541,1191,454,276,123,3,1,1,0,0,0,1,4,2595,13,928
"4605","고아읍","고아읍제4투","대통령선거","경상북도","구미시",3182,2353,477,1089,404,223,144,3,0,1,1,1,0,3,1,2347,6,829
"4606","고아읍","고아읍제5투","대통령선거","경상북도","구미시",2741,1926,299,1131,234,150,87,6,3,1,0,0,0,4,4,1919,7,815
"4607","고아읍","고아읍제6투","대통령선거","경상북도","구미시",2453,1725,217,1062,251,106,66,4,0,0,0,0,1,3,1,1711,14,728
"4608","고아읍","고아읍제7투","대통령선거","경상북도","구미시",3619,2779,639,1185,474,322,140,0,0,1,2,0,2,2,1,2768,11,840
"4609","무을면","관내사전투표","대통령선거","경상북도","구미시",488,488,68,310,55,29,13,2,0,1,0,0,1,1,0,480,8,0
"4610","무을면","무을면투표소","대통령선거","경상북도","구미시",1326,868,82,632,85,31,20,3,1,0,1,0,2,4,0,861,7,458
"4611","옥성면","관내사전투표","대통령선거","경상북도","구미시",355,355,59,213,44,15,11,1,0,0,0,1,1,3,3,351,4,0
"4612","옥성면","옥성면투표소","대통령선거","경상북도","구미시",1267,870,77,634,80,38,18,2,0,3,0,0,1,4,5,862,8,397
"4613","도개면","관내사전투표","대통령선거","경상북도","구미시",603,603,84,400,55,33,14,1,2,0,1,1,1,0,1,593,10,0
"4614","도개면","도개면투표소","대통령선거","경상북도","구미시",1461,943,85,702,100,26,13,2,0,0,0,2,1,1,1,933,10,518
"4615","해평면","관내사전투표","대통령선거","경상북도","구미시",747,747,98,503,74,42,21,2,0,0,1,0,0,3,0,744,3,0
"4616","해평면","해평면제1투","대통령선거","경상북도","구미시",1605,1019,86,762,92,39,18,5,2,0,0,1,3,2,0,1010,9,586
"4617","해평면","해평면제2투","대통령선거","경상북도","구미시",1600,1070,94,796,93,45,24,3,0,3,1,1,1,4,0,1065,5,530
"4618","산동면","관내사전투표","대통령선거","경상북도","구미시",1251,1251,342,514,181,130,74,2,0,0,0,0,1,2,1,1247,4,0
"4619","산동면","산동면투표소","대통령선거","경상북도","구미시",3508,2203,562,920,362,224,110,2,1,0,2,3,0,3,3,2192,11,1305
"4620","장천면","관내사전투표","대통령선거","경상북도","구미시",829,829,125,519,96,55,27,0,1,0,0,0,1,1,0,825,4,0
"4621","장천면","장천면투표소","대통령선거","경상북도","구미시",2083,1376,145,933,164,70,40,6,0,0,2,0,0,3,4,1367,9,707
"4622","송정동","관내사전투표","대통령선거","경상북도","구미시",3620,3620,1021,1382,537,386,248,14,2,0,0,1,0,1,4,3596,24,0
"4623","송정동","송정동제1투","대통령선거","경상북도","구미시",2124,1291,274,587,194,135,87,3,0,0,0,2,0,1,2,1285,6,833
"4624","송정동","송정동제2투","대통령선거","경상북도","구미시",2235,1484,227,830,238,110,64,2,1,2,1,0,0,0,2,1477,7,751
"4625","송정동","송정동제3투","대통령선거","경상북도","구미시",3138,2329,471,1103,381,226,125,5,1,0,1,0,0,2,4,2319,10,809
"4626","송정동","송정동제4투","대통령선거","경상북도","구미시",3384,2238,410,1178,347,173,104,5,0,3,1,1,0,3,2,2227,11,1146
"4627","원평1동","관내사전투표","대통령선거","경상북도","구미시",1402,1402,314,676,200,115,77,2,0,0,0,0,1,1,3,1389,13,0
"4628","원평1동","원평1동제1투","대통령선거","경상북도","구미시",2771,1224,221,689,175,89,36,3,0,0,1,0,0,2,4,1220,4,1547
"4629","원평1동","원평1동제2투","대통령선거","경상북도","구미시",781,455,48,300,56,28,15,3,0,0,1,1,0,0,0,452,3,326
"4630","원평2동","관내사전투표","대통령선거","경상북도","구미시",1859,1859,431,681,289,238,191,3,0,4,0,0,0,2,3,1842,17,0
"4631","원평2동","원평2동제1투","대통령선거","경상북도","구미시",1854,1138,153,794,101,44,33,5,0,0,2,0,0,0,0,1132,6,716
"4632","원평2동","원평2동제2투","대통령선거","경상북도","구미시",1206,765,91,500,89,53,24,1,1,2,0,0,0,2,0,763,2,441
"4633","지산동","관내사전투표","대통령선거","경상북도","구미시",955,955,224,479,126,69,49,1,0,1,0,0,1,1,0,951,4,0
"4634","지산동","지산동투표소","대통령선거","경상북도","구미시",1805,1251,133,834,142,81,49,0,0,3,0,1,0,1,1,1245,6,554
"4635","도량동","관내사전투표","대통령선거","경상북도","구미시",4080,4080,1074,1568,658,438,294,7,1,3,0,0,0,1,9,4053,27,0
"4636","도량동","도량동제1투","대통령선거","경상북도","구미시",1782,1228,181,748,167,77,45,2,0,1,1,0,0,1,0,1223,5,554
"4637","도량동","도량동제2투","대통령선거","경상북도","구미시",1576,1061,186,555,179,77,55,1,0,0,1,1,0,2,1,1058,3,515
"4638","도량동","도량동제3투","대통령선거","경상북도","구미시",1663,1189,218,630,190,83,50,5,0,1,0,1,1,2,1,1182,7,474
"4639","도량동","도량동제4투","대통령선거","경상북도","구미시",3047,2067,408,992,354,183,105,5,0,0,0,1,0,0,8,2056,11,980
"4640","도량동","도량동제5투","대통령선거","경상북도","구미시",2955,1942,430,852,353,168,117,2,2,2,0,1,1,6,1,1935,7,1013
"4641","도량동","도량동제6투","대통령선거","경상북도","구미시",3342,2394,509,1058,429,259,121,5,0,0,0,0,1,1,4,2387,7,948
"4642","도량동","도량동제7투","대통령선거","경상북도","구미시",3748,2872,785,1045,537,303,182,3,0,1,0,4,0,2,1,2863,9,876
"4643","선주원남동","관내사전투표","대통령선거","경상북도","구미시",6079,6079,2013,1891,990,721,416,9,0,1,1,0,2,3,4,6051,28,0
"4644","선주원남동","선주원남동제1투","대통령선거","경상북도","구미시",2843,2177,656,665,449,252,138,2,1,2,0,1,1,0,6,2173,4,666
"4645","선주원남동","선주원남동제2투","대통령선거","경상북도","구미시",2627,1850,426,779,338,190,107,0,0,2,1,0,0,0,2,1845,5,777
"4646","선주원남동","선주원남동제3투","대통령선거","경상북도","구미시",3318,1750,332,865,273,169,97,2,0,0,0,0,0,2,0,1740,10,1568
"4647","선주원남동","선주원남동제4투","대통령선거","경상북도","구미시",3306,2502,611,1016,473,263,119,1,0,1,1,0,0,0,2,2487,15,804
"4648","선주원남동","선주원남동제5투","대통령선거","경상북도","구미시",3565,2539,454,1362,359,214,126,5,0,1,2,0,0,0,1,2524,15,1026
"4649","선주원남동","선주원남동제6투","대통령선거","경상북도","구미시",2368,1729,265,995,251,139,63,0,1,3,0,0,1,1,0,1719,10,639
"4650","선주원남동","선주원남동제7투","대통령선거","경상북도","구미시",3482,2861,752,1084,546,315,154,2,0,2,2,0,0,1,1,2859,2,621
"4651","선주원남동","선주원남동제8투","대통령선거","경상북도","구미시",2405,1823,482,640,359,214,110,4,0,0,0,2,1,0,3,1815,8,582
"4652","선주원남동","선주원남동제9투","대통령선거","경상북도","구미시",3240,2106,667,683,391,203,146,4,1,2,1,0,0,0,1,2099,7,1134
"4653","형곡1동","관내사전투표","대통령선거","경상북도","구미시",3850,3850,1068,1406,614,461,273,3,0,0,0,0,0,2,1,3828,22,0
"4654","형곡1동","형곡1동제1투","대통령선거","경상북도","구미시",1781,1290,272,573,233,142,63,0,0,1,0,0,0,2,1,1287,3,491
"4655","형곡1동","형곡1동제2투","대통령선거","경상북도","구미시",2526,1784,340,878,319,136,102,1,0,2,0,0,0,0,1,1779,5,742
"4656","형곡1동","형곡1동제3투","대통령선거","경상북도","구미시",2102,1536,322,718,274,120,91,3,0,3,0,1,0,0,0,1532,4,566
"4657","형곡1동","형곡1동제4투","대통령선거","경상북도","구미시",1620,1122,235,552,181,98,49,2,0,0,1,1,0,0,2,1121,1,498
"4658","형곡2동","관내사전투표","대통령선거","경상북도","구미시",3167,3167,784,1274,527,312,235,13,0,1,1,1,3,0,3,3154,13,0
"4659","형곡2동","형곡2동제1투","대통령선거","경상북도","구미시",2345,1619,281,824,239,167,95,2,0,0,1,0,0,1,1,1611,8,726
"4660","형곡2동","형곡2동제2투","대통령선거","경상북도","구미시",2448,1748,354,819,310,154,99,3,0,1,0,1,1,0,1,1743,5,700
"4661","형곡2동","형곡2동제3투","대통령선거","경상북도","구미시",1957,1359,268,620,248,134,80,2,0,0,0,0,1,1,2,1356,3,598
"4662","형곡2동","형곡2동제4투","대통령선거","경상북도","구미시",2309,1525,298,758,236,145,75,2,0,2,0,1,0,0,1,1518,7,784
"4663","형곡2동","형곡2동제5투","대통령선거","경상북도","구미시",2341,1591,264,804,258,149,97,4,0,2,1,1,0,2,4,1586,5,750
"4664","신평1동","관내사전투표","대통령선거","경상북도","구미시",948,948,256,366,151,87,78,0,0,0,1,0,0,1,3,943,5,0
"4665","신평1동","신평1동제1투","대통령선거","경상북도","구미시",1085,790,142,411,112,82,32,0,0,0,1,1,0,1,2,784,6,295
"4666","신평1동","신평1동제2투","대통령선거","경상북도","구미시",1381,828,151,420,145,68,38,1,0,2,0,1,0,1,0,827,1,553
"4667","신평2동","관내사전투표","대통령선거","경상북도","구미시",555,555,114,288,76,47,26,0,0,0,0,0,0,1,2,554,1,0
"4668","신평2동","신평2동투표소","대통령선거","경상북도","구미시",1472,889,138,500,118,65,47,2,0,3,0,1,1,1,4,880,9,583
"4669","비산동","관내사전투표","대통령선거","경상북도","구미시",989,989,272,390,154,103,59,1,0,0,1,0,0,3,3,986,3,0
"4670","비산동","비산동투표소","대통령선거","경상북도","구미시",2713,1755,366,771,308,187,104,3,0,4,1,2,0,0,2,1748,7,958
"4671","공단1동","관내사전투표","대통령선거","경상북도","구미시",1324,1324,357,491,223,146,96,0,0,0,1,0,0,1,2,1317,7,0
"4672","공단1동","공단1동투표소","대통령선거","경상북도","구미시",2500,1641,341,669,316,179,116,5,1,1,0,1,0,0,3,1632,9,859
"4673","공단2동","관내사전투표","대통령선거","경상북도","구미시",1502,1502,504,474,241,165,108,1,1,1,0,1,0,0,1,1497,5,0
"4674","공단2동","공단2동투표소","대통령선거","경상북도","구미시",2831,1825,520,541,354,258,132,3,0,0,0,3,0,0,3,1814,11,1006
"4675","광평동","관내사전투표","대통령선거","경상북도","구미시",1269,1269,355,504,209,125,62,3,0,1,0,1,1,0,0,1261,8,0
"4676","광평동","광평동투표소","대통령선거","경상북도","구미시",2828,1815,391,865,298,164,85,4,0,1,1,0,0,0,2,1811,4,1013
"4677","상모사곡동","관내사전투표","대통령선거","경상북도","구미시",3179,3179,933,1055,506,385,273,7,1,2,0,2,0,0,3,3167,12,0
"4678","상모사곡동","상모사곡동제1투","대통령선거","경상북도","구미시",4099,2380,539,1020,391,250,149,9,0,2,0,4,0,1,2,2367,13,1719
"4679","상모사곡동","상모사곡동제2투","대통령선거","경상북도","구미시",1631,1082,240,479,184,98,67,2,1,3,0,0,0,0,1,1075,7,549
"4680","상모사곡동","상모사곡동제3투","대통령선거","경상북도","구미시",4740,2847,655,1174,502,291,192,10,0,2,0,2,2,1,6,2837,10,1893
"4681","상모사곡동","상모사곡동제4투","대통령선거","경상북도","구미시",3332,2420,591,930,451,270,158,4,2,0,0,2,0,0,6,2414,6,912
"4682","상모사곡동","상모사곡동제5투","대통령선거","경상북도","구미시",2622,1896,441,729,346,226,143,1,1,0,1,1,1,0,2,1892,4,726
"4683","상모사곡동","상모사곡동제6투","대통령선거","경상북도","구미시",2353,1930,418,773,381,217,125,2,0,0,0,0,1,1,3,1921,9,423
"4684","임오동","관내사전투표","대통령선거","경상북도","구미시",2512,2512,825,715,453,314,183,3,2,0,1,0,1,2,2,2501,11,0
"4685","임오동","임오동제1투","대통령선거","경상북도","구미시",2206,1237,254,583,192,121,71,3,0,0,0,1,0,1,2,1228,9,969
"4686","임오동","임오동제2투","대통령선거","경상북도","구미시",2839,1923,406,799,354,214,134,2,0,1,0,0,0,4,1,1915,8,916
"4687","임오동","임오동제3투","대통령선거","경상북도","구미시",2653,1846,420,742,313,216,135,4,1,1,2,0,0,0,2,1836,10,807
"4688","임오동","임오동제4투","대통령선거","경상북도","구미시",1272,798,194,321,139,90,45,1,0,0,1,1,1,1,0,794,4,474
"4689","임오동","임오동제5투","대통령선거","경상북도","구미시",2611,1984,630,518,404,264,153,6,0,1,0,1,0,0,0,1977,7,627
"4690","인동동","관내사전투표","대통령선거","경상북도","구미시",4978,4978,1722,1373,865,551,420,11,1,2,1,0,0,2,11,4959,19,0
"4691","인동동","인동동제1투","대통령선거","경상북도","구미시",2978,1780,327,869,267,176,120,6,0,1,0,0,0,1,1,1768,12,1198
"4692","인동동","인동동제2투","대통령선거","경상북도","구미시",2774,1859,577,614,303,213,141,0,0,0,2,0,1,0,1,1852,7,915
"4693","인동동","인동동제3투","대통령선거","경상북도","구미시",3657,2035,572,789,294,204,153,3,1,0,0,0,1,3,5,2025,10,1622
"4694","인동동","인동동제4투","대통령선거","경상북도","구미시",2241,1364,285,613,236,130,84,1,0,2,0,0,1,1,2,1355,9,877
"4695","인동동","인동동제5투","대통령선거","경상북도","구미시",2604,1603,356,704,222,165,130,5,0,0,0,1,2,1,5,1591,12,1001
"4696","인동동","인동동제6투","대통령선거","경상북도","구미시",2782,1839,413,806,356,152,97,1,1,1,0,1,1,3,3,1835,4,943
"4697","인동동","인동동제7투","대통령선거","경상북도","구미시",3576,1898,533,643,333,235,137,4,1,2,0,1,0,0,3,1892,6,1678
"4698","인동동","인동동제8투","대통령선거","경상북도","구미시",1780,939,213,355,194,102,68,3,0,0,0,0,1,0,0,936,3,841
"4699","인동동","인동동제9투","대통령선거","경상북도","구미시",2979,2241,712,628,402,299,187,2,0,1,0,0,1,1,1,2234,7,738
"4700","인동동","인동동제10투","대통령선거","경상북도","구미시",4375,2847,928,823,534,307,232,4,0,0,0,5,0,1,2,2836,11,1528
"4701","인동동","인동동제11투","대통령선거","경상북도","구미시",2778,1664,512,524,317,190,111,1,0,0,0,1,0,0,2,1658,6,1114
"4702","진미동","관내사전투표","대통령선거","경상북도","구미시",3971,3971,1486,858,609,510,447,2,2,3,2,2,1,3,10,3935,36,0
"4703","진미동","진미동제1투","대통령선거","경상북도","구미시",1441,977,328,193,130,175,130,1,0,0,0,1,0,1,4,963,14,464
"4704","진미동","진미동제2투","대통령선거","경상북도","구미시",3227,1430,379,533,232,162,115,1,0,0,0,0,0,0,1,1423,7,1797
"4705","진미동","진미동제3투","대통령선거","경상북도","구미시",3808,1616,494,516,283,185,128,0,0,0,0,2,0,0,4,1612,4,2192
"4706","진미동","진미동제4투","대통령선거","경상북도","구미시",3973,2002,618,597,387,232,148,4,0,0,3,0,0,0,3,1992,10,1971
"4707","양포동","관내사전투표","대통령선거","경상북도","구미시",5050,5051,2035,1079,844,599,452,3,1,3,1,2,1,0,6,5026,25,-1
"4708","양포동","양포동제1투","대통령선거","경상북도","구미시",2794,1632,509,500,318,183,111,2,0,1,0,2,0,0,1,1627,5,1162
"4709","양포동","양포동제2투","대통령선거","경상북도","구미시",3681,2826,1097,688,559,319,151,1,1,1,0,2,0,0,1,2820,6,855
"4710","양포동","양포동제3투","대통령선거","경상북도","구미시",1619,1163,304,450,196,113,87,2,0,1,1,0,0,0,2,1156,7,456
"4711","양포동","양포동제4투","대통령선거","경상북도","구미시",2935,1992,589,664,359,195,169,2,0,1,1,1,1,0,4,1986,6,943
"4712","양포동","양포동제5투","대통령선거","경상북도","구미시",3206,2288,596,770,431,273,198,1,1,0,1,1,0,1,3,2276,12,918
"4713","양포동","양포동제6투","대통령선거","경상북도","구미시",2534,1701,460,630,282,189,122,2,1,0,0,2,0,2,1,1691,10,833
"4714","양포동","양포동제7투","대통령선거","경상북도","구미시",2663,1884,488,667,323,233,155,5,1,1,0,1,0,0,3,1877,7,779
"4715","양포동","양포동제8투","대통령선거","경상북도","구미시",1935,1259,398,413,221,131,88,3,0,0,0,0,0,0,1,1255,4,676
"4716","양포동","양포동제9투","대통령선거","경상북도","구미시",4076,3270,1449,581,615,378,233,1,1,0,1,2,0,0,1,3262,8,806
"4717","잘못 투입·구분된 투표지","잘못 투입·구분된 투표지","대통령선거","경상북도","구미시",0,0,0,0,0,0,0,0,0,0,0,0,0,0,0,0,0,0
"4718","거소·선상투표","거소·선상투표","대통령선거","경상북도","영주시",339,319,64,128,75,25,8,0,3,2,2,1,1,1,4,314,5,20
"4719","관외사전투표","관외사전투표","대통령선거","경상북도","영주시",6186,6183,2221,1405,1062,814,564,14,0,4,2,6,2,3,19,6116,67,3
"4720","재외투표","재외투표","대통령선거","경상북도","영주시",305,231,132,17,34,11,34,1,0,0,0,1,0,0,0,230,1,74
"4721","풍기읍","관내사전투표","대통령선거","경상북도","영주시",1805,1805,401,942,232,125,80,3,2,1,0,0,1,1,3,1791,14,0
"4722","풍기읍","풍기읍제1투","대통령선거","경상북도","영주시",1728,1158,181,713,157,71,32,0,0,0,0,0,0,2,0,1156,2,570
"4723","풍기읍","풍기읍제2투","대통령선거","경상북도","영주시",1690,1068,157,659,159,61,24,0,0,0,2,0,0,2,0,1064,4,622
"4724","풍기읍","풍기읍제3투","대통령선거","경상북도","영주시",1612,1052,156,624,172,60,30,0,0,0,1,0,0,3,1,1047,5,560
"4725","풍기읍","풍기읍제4투","대통령선거","경상북도","영주시",1521,948,152,521,184,56,24,1,0,1,0,1,1,0,1,942,6,573
"4726","풍기읍","풍기읍제5투","대통령선거","경상북도","영주시",1031,730,101,466,71,57,11,0,0,0,1,4,2,5,2,720,10,301
"4727","이산면","관내사전투표","대통령선거","경상북도","영주시",343,343,64,154,54,53,12,1,0,0,0,2,0,0,0,340,3,0
"4728","이산면","이산면제1투","대통령선거","경상북도","영주시",994,645,89,373,84,60,24,2,0,0,0,0,0,4,2,638,7,349
"4729","이산면","이산면제2투","대통령선거","경상북도","영주시",836,550,65,278,64,116,12,0,0,0,0,0,2,4,4,545,5,286
"4730","평은면","관내사전투표","대통령선거","경상북도","영주시",266,266,60,148,28,16,7,3,0,0,0,0,1,1,1,265,1,0
"4731","평은면","평은면투표소","대통령선거","경상북도","영주시",1019,691,66,484,60,53,13,3,0,0,1,0,1,4,2,687,4,328
"4732","문수면","관내사전투표","대통령선거","경상북도","영주시",440,440,91,221,45,33,16,0,0,0,0,1,4,3,2,416,24,0
"4733","문수면","문수면투표소","대통령선거","경상북도","영주시",1378,948,149,576,102,68,29,0,0,0,0,0,2,7,1,934,14,430
"4734","장수면","관내사전투표","대통령선거","경상북도","영주시",555,555,79,345,61,34,22,1,0,1,0,0,2,2,2,549,6,0
"4735","장수면","장수면제1투","대통령선거","경상북도","영주시",1103,705,103,427,95,42,19,1,0,0,0,1,2,5,2,697,8,398
"4736","장수면","장수면제2투","대통령선거","경상북도","영주시",429,317,31,214,45,15,6,0,0,1,0,0,2,1,0,315,2,112
"4737","안정면","관내사전투표","대통령선거","경상북도","영주시",528,528,113,263,94,34,19,1,0,0,0,0,0,0,2,526,2,0
"4738","안정면","안정면제1투","대통령선거","경상북도","영주시",1588,1076,122,644,189,78,25,0,2,2,0,1,0,5,0,1068,8,512
"4739","안정면","안정면제2투","대통령선거","경상북도","영주시",698,501,48,319,73,41,9,0,0,0,0,0,0,6,0,496,5,197
"4740","봉현면","관내사전투표","대통령선거","경상북도","영주시",381,381,81,199,55,21,17,0,1,0,0,2,1,2,0,379,2,0
"4741","봉현면","봉현면제1투","대통령선거","경상북도","영주시",1399,960,106,638,142,47,15,0,0,1,1,0,1,1,2,954,6,439
"4742","봉현면","봉현면제2투","대통령선거","경상북도","영주시",735,539,60,365,68,30,10,2,0,0,0,0,0,2,0,537,2,196
"4743","순흥면","관내사전투표","대통령선거","경상북도","영주시",467,467,87,254,66,37,19,1,0,1,0,0,1,0,0,466,1,0
"4744","순흥면","순흥면투표소","대통령선거","경상북도","영주시",1498,1106,141,725,152,51,17,0,1,0,0,0,0,3,4,1094,12,392
"4745","단산면","관내사전투표","대통령선거","경상북도","영주시",314,314,48,190,43,14,15,0,0,1,0,0,0,1,0,312,2,0
"4746","단산면","단산면제1투","대통령선거","경상북도","영주시",830,579,77,345,98,33,10,0,0,0,3,1,0,6,3,576,3,251
"4747","단산면","단산면제2투","대통령선거","경상북도","영주시",656,476,64,320,49,24,9,2,0,0,1,1,2,1,2,475,1,180
"4748","부석면","관내사전투표","대통령선거","경상북도","영주시",582,582,93,321,88,48,20,0,0,3,2,0,1,2,0,578,4,0
"4749","부석면","부석면제1투","대통령선거","경상북도","영주시",1704,1169,146,723,163,79,30,0,0,2,1,2,1,7,5,1159,10,535
"4750","부석면","부석면제2투","대통령선거","경상북도","영주시",577,406,69,227,78,17,5,0,0,0,1,1,1,4,0,403,3,171
"4751","상망동","관내사전투표","대통령선거","경상북도","영주시",1250,1250,337,516,174,130,80,3,1,0,0,0,0,1,0,1242,8,0
"4752","상망동","상망동제1투","대통령선거","경상북도","영주시",1012,644,84,403,85,46,18,1,0,0,0,0,1,0,1,639,5,368
"4753","상망동","상망동제2투","대통령선거","경상북도","영주시",2330,1666,348,761,285,164,87,5,0,1,0,2,1,2,1,1657,9,664
"4754","상망동","상망동제3투","대통령선거","경상북도","영주시",1545,1050,179,535,176,92,37,2,1,0,1,2,3,5,4,1037,13,495
"4755","하망동","관내사전투표","대통령선거","경상북도","영주시",1107,1107,283,511,138,112,47,2,0,0,0,0,1,3,0,1097,10,0
"4756","하망동","하망동제1투","대통령선거","경상북도","영주시",1590,1082,169,614,154,91,38,3,0,1,2,0,0,2,1,1075,7,508
"4757","하망동","하망동제2투","대통령선거","경상북도","영주시",949,724,175,303,124,83,32,0,0,0,0,0,2,1,0,720,4,225
"4758","하망동","하망동제3투","대통령선거","경상북도","영주시",1504,1089,152,695,106,92,25,7,1,1,1,2,2,0,0,1084,5,415
"4759","영주1동","관내사전투표","대통령선거","경상북도","영주시",1128,1128,246,598,133,92,45,1,0,1,0,0,1,2,1,1120,8,0
"4760","영주1동","영주1동제1투","대통령선거","경상북도","영주시",1466,993,126,616,138,85,17,1,0,0,0,1,0,3,0,987,6,473
"4761","영주1동","영주1동제2투","대통령선거","경상북도","영주시",1488,945,125,567,154,55,22,3,0,1,1,0,4,2,1,935,10,543
"4762","영주2동","관내사전투표","대통령선거","경상북도","영주시",1491,1491,386,706,198,125,64,3,1,0,1,0,0,0,0,1484,7,0
"4763","영주2동","영주2동제1투","대통령선거","경상북도","영주시",1334,908,175,475,137,79,35,1,0,1,1,0,0,0,0,904,4,426
"4764","영주2동","영주2동제2투","대통령선거","경상북도","영주시",1090,755,109,451,113,48,22,2,0,0,0,1,0,4,1,751,4,335
"4765","휴천1동","관내사전투표","대통령선거","경상북도","영주시",1111,1111,323,435,157,124,61,2,1,1,0,1,1,2,0,1108,3,0
"4766","휴천1동","휴천1동제1투","대통령선거","경상북도","영주시",1594,1073,173,596,154,100,35,2,1,1,0,2,0,2,1,1067,6,521
"4767","휴천1동","휴천1동제2투","대통령선거","경상북도","영주시",2030,1444,360,644,214,129,85,2,0,0,0,2,0,0,2,1438,6,586
"4768","휴천2동","관내사전투표","대통령선거","경상북도","영주시",1889,1889,625,651,251,223,121,0,0,2,2,2,0,0,1,1878,11,0
"4769","휴천2동","휴천2동제1투","대통령선거","경상북도","영주시",1174,775,129,445,111,58,25,0,0,0,1,0,0,1,2,772,3,399
"4770","휴천2동","휴천2동제2투","대통령선거","경상북도","영주시",1426,936,166,515,109,101,36,0,0,1,0,0,0,2,1,931,5,490
"4771","휴천2동","휴천2동제3투","대통령선거","경상북도","영주시",1002,696,98,433,88,52,18,2,0,0,0,0,0,3,0,694,2,306
"4772","휴천2동","휴천2동제4투","대통령선거","경상북도","영주시",1278,1019,246,444,166,108,50,0,0,1,0,1,0,0,1,1017,2,259
"4773","휴천2동","휴천2동제5투","대통령선거","경상북도","영주시",824,587,108,289,89,66,31,0,0,0,0,0,0,1,0,584,3,237
"4774","휴천3동","관내사전투표","대통령선거","경상북도","영주시",1325,1325,393,554,174,131,59,2,2,0,0,1,1,1,2,1320,5,0
"4775","휴천3동","휴천3동제1투","대통령선거","경상북도","영주시",1689,1182,210,659,151,111,38,0,1,1,0,2,1,3,0,1177,5,507
"4776","휴천3동","휴천3동제2투","대통령선거","경상북도","영주시",1770,1234,252,633,162,134,45,1,0,0,0,0,0,2,0,1229,5,536
"4777","휴천3동","휴천3동제3투","대통령선거","경상북도","영주시",1700,1242,315,538,162,145,74,3,0,1,1,1,0,0,0,1240,2,458
"4778","가흥1동","관내사전투표","대통령선거","경상북도","영주시",2364,2364,919,639,384,245,154,0,0,0,0,1,1,2,6,2351,13,0
"4779","가흥1동","가흥1동제1투","대통령선거","경상북도","영주시",1332,923,127,558,128,65,36,3,0,0,0,0,0,0,0,917,6,409
"4780","가흥1동","가흥1동제2투","대통령선거","경상북도","영주시",1462,1004,133,638,130,66,31,2,0,1,0,0,0,2,0,1003,1,458
"4781","가흥1동","가흥1동제3투","대통령선거","경상북도","영주시",2787,1721,396,736,299,176,99,1,0,0,0,1,1,2,1,1712,9,1066
"4782","가흥1동","가흥1동제4투","대통령선거","경상북도","영주시",2500,1614,381,680,245,175,112,1,0,1,1,1,0,3,7,1607,7,886
"4783","가흥1동","가흥1동제5투","대통령선거","경상북도","영주시",2178,1639,513,477,334,192,115,1,0,0,0,0,1,1,0,1634,5,539
"4784","가흥2동","관내사전투표","대통령선거","경상북도","영주시",1179,1179,320,491,146,151,63,1,0,1,1,0,0,1,0,1175,4,0
"4785","가흥2동","가흥2동제1투","대통령선거","경상북도","영주시",2496,1590,289,798,272,141,73,1,0,3,0,0,0,1,0,1578,12,906
"4786","가흥2동","가흥2동제2투","대통령선거","경상북도","영주시",2186,1444,293,672,261,140,65,1,0,1,1,1,0,1,1,1437,7,742
"4787","잘못 투입·구분된 투표지","잘못 투입·구분된 투표지","대통령선거","경상북도","영주시",0,0,0,0,0,0,0,0,0,0,0,0,0,0,0,0,0,0
"4788","거소·선상투표","거소·선상투표","대통령선거","경상북도","영천시",412,389,105,106,89,20,13,6,3,7,4,3,1,0,3,360,29,23
"4789","관외사전투표","관외사전투표","대통령선거","경상북도","영천시",7099,7096,2082,2280,1125,985,522,18,0,2,3,2,4,0,13,7036,60,3
"4790","재외투표","재외투표","대통령선거","경상북도","영천시",460,234,104,10,79,11,24,1,1,0,0,0,0,0,0,230,4,226
"4791","금호읍","관내사전투표","대통령선거","경상북도","영천시",1163,1163,251,585,159,103,50,3,0,1,0,1,0,0,2,1155,8,0
"4792","금호읍","금호읍제1투","대통령선거","경상북도","영천시",1678,1081,129,685,134,92,32,0,0,0,0,0,0,2,0,1074,7,597
"4793","금호읍","금호읍제2투","대통령선거","경상북도","영천시",2219,1470,211,846,226,116,56,1,0,1,1,2,2,2,1,1465,5,749
"4794","금호읍","금호읍제3투","대통령선거","경상북도","영천시",941,676,79,431,88,48,14,2,1,0,0,0,2,2,1,668,8,265
"4795","금호읍","금호읍제4투","대통령선거","경상북도","영천시",1295,907,111,611,94,51,21,2,2,0,0,0,2,3,3,900,7,388
"4796","금호읍","금호읍제5투","대통령선거","경상북도","영천시",698,501,54,338,56,29,9,1,0,3,1,0,2,4,0,497,4,197
"4797","금호읍","금호읍제6투","대통령선거","경상북도","영천시",1367,750,117,462,114,39,10,1,1,1,0,0,1,1,1,748,2,617
"4798","청통면","관내사전투표","대통령선거","경상북도","영천시",728,728,136,409,90,53,23,2,0,2,0,1,2,1,2,721,7,0
"4799","청통면","청통면제1투","대통령선거","경상북도","영천시",1715,1100,130,706,140,75,30,1,0,0,1,1,3,1,2,1090,10,615
"4800","청통면","청통면제2투","대통령선거","경상북도","영천시",1007,747,81,512,68,54,17,4,1,0,0,0,1,6,1,745,2,260
"4801","신녕면","관내사전투표","대통령선거","경상북도","영천시",743,743,93,459,105,55,18,1,0,0,1,0,1,5,1,739,4,0
"4802","신녕면","신녕면제1투","대통령선거","경상북도","영천시",1376,874,106,590,114,40,16,1,0,1,0,1,0,1,1,871,3,502
"4803","신녕면","신녕면제2투","대통령선거","경상북도","영천시",1273,860,80,605,96,44,14,1,0,0,1,0,4,7,2,854,6,413
"4804","화산면","관내사전투표","대통령선거","경상북도","영천시",683,683,123,355,86,36,24,4,3,3,6,5,6,4,5,660,23,0
"4805","화산면","화산면제1투","대통령선거","경상북도","영천시",1347,867,105,561,112,54,10,1,1,0,0,7,1,3,5,860,7,480
"4806","화산면","화산면제2투","대통령선거","경상북도","영천시",736,496,62,340,54,25,8,1,0,0,0,0,0,3,0,493,3,240
"4807","화북면","관내사전투표","대통령선거","경상북도","영천시",463,463,60,307,56,19,10,0,1,1,1,0,2,2,0,459,4,0
"4808","화북면","화북면투표소","대통령선거","경상북도","영천시",1314,857,116,543,106,48,13,2,0,1,0,2,3,4,2,840,17,457
"4809","화남면","관내사전투표","대통령선거","경상북도","영천시",521,521,91,309,63,37,15,0,0,1,0,0,2,1,1,520,1,0
"4810","화남면","화남면제1투","대통령선거","경상북도","영천시",1423,939,99,645,109,52,12,3,1,1,0,1,3,4,2,932,7,484
"4811","화남면","화남면제2투","대통령선거","경상북도","영천시",803,592,69,405,63,30,15,1,0,1,0,0,1,2,2,589,3,211
"4812","자양면","관내사전투표","대통령선거","경상북도","영천시",177,177,29,105,22,12,5,0,0,0,0,0,2,0,0,175,2,0
"4813","자양면","자양면투표소","대통령선거","경상북도","영천시",716,479,45,347,44,18,13,2,1,0,0,0,2,6,1,479,0,237
"4814","임고면","관내사전투표","대통령선거","경상북도","영천시",561,561,118,284,70,52,29,0,0,2,0,0,1,1,2,559,2,0
"4815","임고면","임고면제1투","대통령선거","경상북도","영천시",1093,762,107,476,111,37,17,1,0,2,0,0,2,0,3,756,6,331
"4816","임고면","임고면제2투","대통령선거","경상북도","영천시",1104,778,108,520,81,37,15,3,0,0,1,1,0,3,0,769,9,326
"4817","임고면","임고면제3투","대통령선거","경상북도","영천시",895,625,79,424,72,23,7,1,0,1,0,0,3,7,2,619,6,270
"4818","고경면","관내사전투표","대통령선거","경상북도","영천시",721,721,170,329,108,72,36,0,0,2,0,0,0,0,1,718,3,0
"4819","고경면","고경면제1투","대통령선거","경상북도","영천시",1145,796,93,531,102,35,20,1,0,0,0,1,2,3,1,789,7,349
"4820","고경면","고경면제2투","대통령선거","경상북도","영천시",1628,1120,171,686,138,82,24,2,0,0,0,1,1,4,4,1113,7,508
"4821","고경면","고경면제3투","대통령선거","경상북도","영천시",1083,753,81,526,85,30,13,4,1,0,2,2,3,2,1,750,3,330
"4822","북안면","관내사전투표","대통령선거","경상북도","영천시",939,939,190,544,107,47,30,1,0,2,0,1,3,4,1,930,9,0
"4823","북안면","북안면제1투","대통령선거","경상북도","영천시",1511,944,152,594,92,45,16,3,2,1,0,1,1,3,5,915,29,567
"4824","북안면","북안면제2투","대통령선거","경상북도","영천시",1305,836,114,531,106,52,21,1,0,0,0,0,1,3,2,831,5,469
"4825","대창면","관내사전투표","대통령선거","경상북도","영천시",509,509,74,314,66,33,15,1,1,0,0,1,0,0,1,506,3,0
"4826","대창면","대창면투표소","대통령선거","경상북도","영천시",2092,1361,168,903,160,75,25,4,0,1,3,1,4,5,2,1351,10,731
"4827","동부동","관내사전투표","대통령선거","경상북도","영천시",2535,2535,781,853,386,308,167,7,0,0,2,2,1,3,2,2512,23,0
"4828","동부동","동부동제1투","대통령선거","경상북도","영천시",2439,1653,279,899,245,146,58,10,1,2,0,4,0,1,0,1645,8,786
"4829","동부동","동부동제2투","대통령선거","경상북도","영천시",3503,2285,453,1075,389,238,95,7,0,2,2,3,5,3,3,2275,10,1218
"4830","동부동","동부동제3투","대통령선거","경상북도","영천시",2517,1706,270,923,243,165,89,5,0,1,2,1,1,2,0,1702,4,811
"4831","동부동","동부동제4투","대통령선거","경상북도","영천시",2034,1387,202,830,191,90,46,2,1,2,2,1,3,3,1,1374,13,647
"4832","동부동","동부동제5투","대통령선거","경상북도","영천시",2774,2015,390,936,353,223,93,0,0,0,0,1,0,4,4,2004,11,759
"4833","동부동","동부동제6투","대통령선거","경상북도","영천시",2557,1716,334,810,272,176,102,3,0,1,0,0,0,5,2,1705,11,841
"4834","동부동","동부동제7투","대통령선거","경상북도","영천시",2277,1648,442,591,303,185,116,0,0,0,0,3,0,2,2,1644,4,629
"4835","중앙동","관내사전투표","대통령선거","경상북도","영천시",2684,2684,752,997,403,323,159,7,3,3,1,5,2,4,6,2665,19,0
"4836","중앙동","중앙동제1투","대통령선거","경상북도","영천시",2649,1671,301,868,245,157,80,3,0,5,0,1,0,3,3,1666,5,978
"4837","중앙동","중앙동제2투","대통령선거","경상북도","영천시",1631,1139,197,602,168,116,51,1,0,0,1,0,0,0,0,1136,3,492
"4838","중앙동","중앙동제3투","대통령선거","경상북도","영천시",938,639,53,455,65,32,22,2,0,1,1,0,0,2,1,634,5,299
"4839","서부동","관내사전투표","대통령선거","경상북도","영천시",954,954,223,478,117,75,46,6,0,0,0,1,1,2,1,950,4,0
"4840","서부동","서부동제1투","대통령선거","경상북도","영천시",1808,1251,163,794,147,93,42,2,1,0,0,0,1,1,2,1246,5,557
"4841","서부동","서부동제2투","대통령선거","경상북도","영천시",1559,1022,151,650,119,59,28,3,0,0,2,0,0,1,2,1015,7,537
"4842","완산동","관내사전투표","대통령선거","경상북도","영천시",999,999,203,520,142,91,35,1,1,0,0,0,0,0,1,994,5,0
"4843","완산동","완산동제1투","대통령선거","경상북도","영천시",1741,1208,181,768,144,74,27,2,0,0,0,0,1,2,1,1200,8,533
"4844","완산동","완산동제2투","대통령선거","경상북도","영천시",1276,853,112,543,127,47,11,3,0,1,2,0,1,2,0,849,4,423
"4845","남부동","관내사전투표","대통령선거","경상북도","영천시",809,809,174,413,129,55,26,0,0,0,1,0,0,4,1,803,6,0
"4846","남부동","남부동제1투","대통령선거","경상북도","영천시",870,548,77,367,55,24,13,2,0,0,0,1,0,2,0,541,7,322
"4847","남부동","남부동제2투","대통령선거","경상북도","영천시",1962,1271,219,742,142,110,38,4,0,1,1,1,2,2,0,1262,9,691
"4848","잘못 투입·구분된 투표지","잘못 투입·구분된 투표지","대통령선거","경상북도","영천시",0,0,0,0,0,0,0,0,0,0,0,0,0,0,0,0,0,0
"4849","거소·선상투표","거소·선상투표","대통령선거","경상북도","상주시",633,546,115,206,100,30,11,7,3,3,3,4,6,2,7,497,49,87
"4850","관외사전투표","관외사전투표","대통령선거","경상북도","상주시",6501,6501,2113,1985,1061,732,520,8,2,2,4,11,2,3,11,6454,47,0
"4851","재외투표","재외투표","대통령선거","경상북도","상주시",477,275,121,39,69,11,29,4,0,0,0,0,0,0,1,274,1,202
"4852","함창읍","관내사전투표","대통령선거","경상북도","상주시",1571,1571,250,949,242,72,39,1,0,0,0,3,2,2,2,1562,9,0
"4853","함창읍","함창읍제1투","대통령선거","경상북도","상주시",1748,1149,169,748,131,49,37,3,0,1,0,0,2,4,1,1145,4,599
"4854","함창읍","함창읍제2투","대통령선거","경상북도","상주시",1272,878,119,561,127,34,22,0,0,2,0,0,0,6,2,873,5,394
"4855","함창읍","함창읍제3투","대통령선거","경상북도","상주시",1103,704,75,485,97,20,15,0,0,0,0,1,1,5,2,701,3,399
"4856","사벌면","관내사전투표","대통령선거","경상북도","상주시",920,920,120,596,139,30,22,1,0,0,0,0,2,6,2,918,2,0
"4857","사벌면","사벌면제1투","대통령선거","경상북도","상주시",1478,939,116,604,138,48,19,2,0,0,0,0,0,3,1,931,8,539
"4858","사벌면","사벌면제2투","대통령선거","경상북도","상주시",956,657,81,429,99,26,11,0,0,0,1,0,0,5,3,655,2,299
"4859","중동면","관내사전투표","대통령선거","경상북도","상주시",334,334,29,230,38,18,9,1,0,1,0,0,2,2,1,331,3,0
"4860","중동면","중동면투표소","대통령선거","경상북도","상주시",945,632,64,481,48,23,10,0,0,0,0,0,0,3,1,630,2,313
"4861","낙동면","관내사전투표","대통령선거","경상북도","상주시",761,761,85,546,73,31,15,2,0,0,0,0,0,5,2,759,2,0
"4862","낙동면","낙동면제1투","대통령선거","경상북도","상주시",1164,687,62,483,76,34,19,0,0,3,1,0,1,0,2,681,6,477
"4863","낙동면","낙동면제2투","대통령선거","경상북도","상주시",842,594,57,417,65,30,14,6,0,0,0,1,0,1,0,591,3,248
"4864","낙동면","낙동면제3투","대통령선거","경상북도","상주시",789,560,66,395,51,13,13,1,0,0,0,3,1,9,2,554,6,229
"4865","청리면","관내사전투표","대통령선거","경상북도","상주시",776,776,87,552,90,20,13,0,0,0,0,0,1,5,3,771,5,0
"4866","청리면","청리면제1투","대통령선거","경상북도","상주시",1066,645,55,474,76,17,8,0,1,0,0,1,1,5,1,639,6,421
"4867","청리면","청리면제2투","대통령선거","경상북도","상주시",627,408,40,294,44,13,5,1,0,0,1,1,0,1,2,402,6,219
"4868","공성면","관내사전투표","대통령선거","경상북도","상주시",995,995,103,686,126,41,23,2,0,0,1,0,1,6,1,990,5,0
"4869","공성면","공성면제1투","대통령선거","경상북도","상주시",1077,715,70,517,66,30,18,2,1,0,1,1,1,6,0,713,2,362
"4870","공성면","공성면제2투","대통령선거","경상북도","상주시",958,637,88,430,69,23,20,1,0,1,0,0,1,1,2,636,1,321
"4871","공성면","공성면제3투","대통령선거","경상북도","상주시",631,421,42,304,48,10,9,1,0,2,0,1,0,1,2,420,1,210
"4872","외남면","관내사전투표","대통령선거","경상북도","상주시",372,372,50,241,50,10,12,2,1,0,1,0,0,1,2,370,2,0
"4873","외남면","외남면투표소","대통령선거","경상북도","상주시",1142,794,79,531,105,40,19,0,0,2,2,0,3,5,3,789,5,348
"4874","내서면","관내사전투표","대통령선거","경상북도","상주시",319,319,77,166,40,15,16,2,0,0,2,0,1,0,0,319,0,0
"4875","내서면","내서면제1투","대통령선거","경상북도","상주시",576,393,40,261,57,16,6,0,0,0,0,1,0,5,2,388,5,183
"4876","내서면","내서면제2투","대통령선거","경상북도","상주시",766,545,58,364,80,20,7,0,0,0,0,4,2,5,1,541,4,221
"4877","모동면","관내사전투표","대통령선거","경상북도","상주시",482,482,92,248,79,31,22,4,0,0,1,0,0,0,1,478,4,0
"4878","모동면","모동면제1투","대통령선거","경상북도","상주시",928,665,119,364,121,17,26,0,0,3,2,0,0,4,2,658,7,263
"4879","모동면","모동면제2투","대통령선거","경상북도","상주시",833,619,114,342,99,37,21,1,0,0,0,0,1,2,1,618,1,214
"4880","모서면","관내사전투표","대통령선거","경상북도","상주시",461,461,97,242,70,30,14,2,0,3,0,0,0,0,0,458,3,0
"4881","모서면","모서면제1투","대통령선거","경상북도","상주시",1191,804,126,467,123,48,25,1,0,1,0,0,0,2,4,797,7,387
"4882","모서면","모서면제2투","대통령선거","경상북도","상주시",572,391,55,235,54,16,17,2,0,0,0,0,1,2,2,384,7,181
"4883","화동면","관내사전투표","대통령선거","경상북도","상주시",439,439,90,243,59,26,15,1,0,0,0,1,0,0,1,436,3,0
"4884","화동면","화동면투표소","대통령선거","경상북도","상주시",1383,951,124,586,162,43,24,1,0,2,1,0,0,2,1,946,5,432
"4885","화서면","관내사전투표","대통령선거","경상북도","상주시",579,579,110,338,73,27,18,2,0,0,0,2,1,4,1,576,3,0
"4886","화서면","화서면제1투","대통령선거","경상북도","상주시",886,604,62,434,72,15,13,3,0,0,0,0,0,1,0,600,4,282
"4887","화서면","화서면제2투","대통령선거","경상북도","상주시",958,687,90,458,90,20,10,4,0,3,1,2,1,5,1,685,2,271
"4888","화북면","관내사전투표","대통령선거","경상북도","상주시",343,342,57,202,49,12,17,1,0,0,0,0,1,2,0,341,1,1
"4889","화북면","화북면투표소","대통령선거","경상북도","상주시",1093,788,128,462,134,28,20,0,0,1,2,2,1,4,2,784,4,305
"4890","외서면","관내사전투표","대통령선거","경상북도","상주시",355,355,58,217,46,11,16,0,0,0,0,1,0,3,2,354,1,0
"4891","외서면","외서면제1투","대통령선거","경상북도","상주시",1045,649,104,414,70,30,19,1,1,0,0,1,1,3,0,644,5,396
"4892","외서면","외서면제2투","대통령선거","경상북도","상주시",493,308,31,204,44,15,4,0,0,1,0,2,1,5,0,307,1,185
"4893","은척면","관내사전투표","대통령선거","경상북도","상주시",308,308,50,204,27,13,7,1,0,0,0,1,0,0,0,303,5,0
"4894","은척면","은척면제1투","대통령선거","경상북도","상주시",755,537,53,353,90,17,8,1,0,1,1,0,4,4,3,535,2,218
"4895","은척면","은척면제2투","대통령선거","경상북도","상주시",312,245,20,167,35,8,5,2,0,0,0,0,1,5,1,244,1,67
"4896","공검면","관내사전투표","대통령선거","경상북도","상주시",595,595,91,355,79,28,20,2,0,1,1,1,1,3,1,583,12,0
"4897","공검면","공검면제1투","대통령선거","경상북도","상주시",862,607,54,437,73,22,9,0,0,0,2,0,0,3,1,601,6,255
"4898","공검면","공검면제2투","대통령선거","경상북도","상주시",697,497,47,360,54,8,5,0,0,0,0,1,2,7,2,486,11,200
"4899","이안면","관내사전투표","대통령선거","경상북도","상주시",463,463,69,312,48,18,7,0,1,0,0,1,0,4,1,461,2,0
"4900","이안면","이안면제1투","대통령선거","경상북도","상주시",851,592,67,407,62,18,13,6,0,0,0,2,4,5,3,587,5,259
"4901","이안면","이안면제2투","대통령선거","경상북도","상주시",471,376,50,257,40,13,4,0,0,0,0,2,1,5,0,372,4,95
"4902","화남면","관내사전투표","대통령선거","경상북도","상주시",151,151,34,92,9,8,6,0,0,0,0,0,0,0,0,149,2,0
"4903","화남면","화남면투표소","대통령선거","경상북도","상주시",551,346,37,226,57,10,6,0,0,1,0,0,1,7,1,346,0,205
"4904","남원동","관내사전투표","대통령선거","경상북도","상주시",2460,2459,672,1088,343,188,139,2,0,4,0,1,1,1,5,2444,15,1
"4905","남원동","남원동제1투","대통령선거","경상북도","상주시",1551,988,170,597,138,45,31,1,0,1,1,0,0,2,0,986,2,563
"4906","남원동","남원동제2투","대통령선거","경상북도","상주시",990,720,133,422,86,51,26,1,0,0,0,0,0,1,0,720,0,270
"4907","남원동","남원동제3투","대통령선거","경상북도","상주시",1122,746,149,380,119,53,30,3,0,0,0,5,1,0,1,741,5,376
"4908","남원동","남원동제4투","대통령선거","경상북도","상주시",1069,756,146,421,103,58,25,0,0,1,0,0,0,1,0,755,1,313
"4909","남원동","남원동제5투","대통령선거","경상북도","상주시",801,554,91,319,73,32,23,4,0,1,0,3,0,1,2,549,5,247
"4910","남원동","남원동제6투","대통령선거","경상북도","상주시",1386,935,199,501,129,63,34,1,0,0,0,1,0,1,1,930,5,451
"4911","북문동","관내사전투표","대통령선거","경상북도","상주시",1879,1879,525,783,280,149,116,5,2,1,0,3,2,3,2,1871,8,0
"4912","북문동","북문동제1투","대통령선거","경상북도","상주시",1104,742,90,503,64,49,26,0,0,1,0,1,0,2,2,738,4,362
"4913","북문동","북문동제2투","대통령선거","경상북도","상주시",1114,721,170,363,106,48,25,2,0,1,0,0,0,0,1,716,5,393
"4914","북문동","북문동제3투","대통령선거","경상북도","상주시",1298,826,144,494,92,48,34,5,1,1,0,1,1,1,0,822,4,472
"4915","북문동","북문동제4투","대통령선거","경상북도","상주시",588,424,40,303,40,19,10,1,0,0,0,0,1,5,0,419,5,164
"4916","북문동","북문동제5투","대통령선거","경상북도","상주시",1216,826,177,380,163,58,37,5,0,0,0,1,0,2,0,823,3,390
"4917","계림동","관내사전투표","대통령선거","경상북도","상주시",1668,1668,338,899,223,96,85,1,1,1,0,6,0,8,1,1659,9,0
"4918","계림동","계림동제1투","대통령선거","경상북도","상주시",1789,1136,187,650,172,61,45,2,0,0,0,0,0,10,3,1130,6,653
"4919","계림동","계림동제2투","대통령선거","경상북도","상주시",1419,945,186,487,159,69,37,0,0,0,0,1,0,1,1,941,4,474
"4920","계림동","계림동제3투","대통령선거","경상북도","상주시",1334,822,124,501,120,45,23,2,0,0,0,1,1,1,0,818,4,512
"4921","동문동","관내사전투표","대통령선거","경상북도","상주시",1570,1570,347,791,203,130,80,3,1,2,1,0,0,0,1,1559,11,0
"4922","동문동","동문동제1투","대통령선거","경상북도","상주시",1686,1045,207,517,173,88,52,3,0,0,1,1,0,1,0,1043,2,641
"4923","동문동","동문동제2투","대통령선거","경상북도","상주시",1156,711,82,506,66,27,20,1,0,0,0,1,1,4,0,708,3,445
"4924","동문동","동문동제3투","대통령선거","경상북도","상주시",1210,807,112,517,97,54,18,1,0,0,0,0,1,0,3,803,4,403
"4925","동문동","동문동제4투","대통령선거","경상북도","상주시",809,553,88,334,76,33,18,0,0,1,0,0,1,2,0,553,0,256
"4926","동성동","관내사전투표","대통령선거","경상북도","상주시",671,671,178,338,72,43,29,0,0,0,0,2,0,2,1,665,6,0
"4927","동성동","동성동제1투","대통령선거","경상북도","상주시",1087,722,123,418,104,48,18,1,0,1,0,1,0,2,0,716,6,365
"4928","동성동","동성동제2투","대통령선거","경상북도","상주시",705,471,60,316,50,20,16,0,0,0,0,1,0,2,3,468,3,234
"4929","동성동","동성동제3투","대통령선거","경상북도","상주시",837,602,87,392,73,28,14,0,0,0,0,1,0,4,1,600,2,235
"4930","신흥동","관내사전투표","대통령선거","경상북도","상주시",1766,1766,451,776,266,148,105,5,0,0,0,0,1,3,3,1758,8,0
"4931","신흥동","신흥동제1투","대통령선거","경상북도","상주시",1530,968,200,466,164,84,46,2,0,0,1,2,0,0,0,965,3,562
"4932","신흥동","신흥동제2투","대통령선거","경상북도","상주시",1126,730,106,478,81,39,19,0,0,0,0,0,0,3,0,726,4,396
"4933","신흥동","신흥동제3투","대통령선거","경상북도","상주시",2062,1383,312,631,233,122,76,0,0,0,1,0,0,4,1,1380,3,679
"4934","잘못 투입·구분된 투표지","잘못 투입·구분된 투표지","대통령선거","경상북도","상주시",0,2,2,0,0,0,0,0,0,0,0,0,0,0,0,2,0,-2
"4935","거소·선상투표","거소·선상투표","대통령선거","경상북도","문경시",455,418,70,190,68,21,11,1,7,4,3,5,4,5,4,393,25,37
"4936","관외사전투표","관외사전투표","대통령선거","경상북도","문경시",4709,4709,1530,1312,868,531,402,6,2,4,4,0,2,1,10,4672,37,0
"4937","재외투표","재외투표","대통령선거","경상북도","문경시",273,181,92,15,42,10,18,1,0,0,0,0,0,0,0,178,3,92
"4938","문경읍","관내사전투표","대통령선거","경상북도","문경시",1251,1251,204,750,162,61,54,4,0,1,0,0,1,2,2,1241,10,0
"4939","문경읍","문경읍제1투","대통령선거","경상북도","문경시",2169,1299,147,873,185,49,29,4,1,0,2,1,0,3,1,1295,4,870
"4940","문경읍","문경읍제2투","대통령선거","경상북도","문경시",1856,1245,140,864,167,30,28,6,1,1,0,0,0,2,4,1243,2,611
"4941","문경읍","문경읍제3투","대통령선거","경상북도","문경시",844,584,82,377,78,32,10,0,0,1,0,0,0,4,0,584,0,260
"4942","가은읍","관내사전투표","대통령선거","경상북도","문경시",1012,1012,143,669,112,40,31,2,0,1,1,0,1,3,3,1006,6,0
"4943","가은읍","가은읍제1투","대통령선거","경상북도","문경시",1899,1293,179,835,156,62,30,4,0,0,1,0,1,10,5,1283,10,606
"4944","가은읍","가은읍제2투","대통령선거","경상북도","문경시",547,371,61,228,46,10,13,1,1,0,3,0,3,1,2,369,2,176
"4945","영순면","관내사전투표","대통령선거","경상북도","문경시",627,627,78,426,78,23,16,0,0,0,1,0,0,2,1,625,2,0
"4946","영순면","영순면투표소","대통령선거","경상북도","문경시",1362,906,94,655,90,26,26,0,1,0,1,0,1,2,0,896,10,456
"4947","산양면","관내사전투표","대통령선거","경상북도","문경시",603,603,94,385,65,32,11,1,2,2,0,0,1,3,1,597,6,0
"4948","산양면","산양면제1투","대통령선거","경상북도","문경시",1047,708,64,504,74,36,15,0,0,1,0,0,3,4,2,703,5,339
"4949","산양면","산양면제2투","대통령선거","경상북도","문경시",1037,719,65,532,72,17,19,1,1,1,1,0,0,4,1,714,5,318
"4950","호계면","관내사전투표","대통령선거","경상북도","문경시",560,560,57,387,77,17,16,0,0,2,0,0,0,1,0,557,3,0
"4951","호계면","호계면투표소","대통령선거","경상북도","문경시",1466,949,83,617,140,56,28,5,1,0,0,1,4,5,1,941,8,517
"4952","산북면","관내사전투표","대통령선거","경상북도","문경시",883,883,110,563,101,48,30,1,0,2,0,2,4,6,4,871,12,0
"4953","산북면","산북면투표소","대통령선거","경상북도","문경시",1598,1089,153,684,148,45,25,3,0,0,2,1,1,16,3,1081,8,509
"4954","동로면","관내사전투표","대통령선거","경상북도","문경시",473,473,76,285,69,16,10,2,1,2,0,0,2,4,3,470,3,0
"4955","동로면","동로면투표소","대통령선거","경상북도","문경시",1147,810,116,534,93,34,17,1,0,0,1,1,1,4,1,803,7,337
"4956","마성면","관내사전투표","대통령선거","경상북도","문경시",861,861,130,504,135,36,35,3,2,0,0,0,1,4,2,852,9,0
"4957","마성면","마성면제1투","대통령선거","경상북도","문경시",1025,647,59,456,79,28,14,0,0,1,0,1,0,1,2,641,6,378
"4958","마성면","마성면제2투","대통령선거","경상북도","문경시",1326,933,130,621,101,27,26,2,1,0,1,1,2,4,1,917,16,393
"4959","농암면","관내사전투표","대통령선거","경상북도","문경시",665,665,101,442,71,19,17,1,0,1,0,0,0,3,3,658,7,0
"4960","농암면","농암면제1투","대통령선거","경상북도","문경시",1092,724,84,504,75,30,13,4,0,0,0,0,1,5,2,718,6,368
"4961","농암면","농암면제2투","대통령선거","경상북도","문경시",471,311,38,221,23,13,8,0,0,1,0,0,0,3,0,307,4,160
"4962","점촌1동","관내사전투표","대통령선거","경상북도","문경시",1858,1857,339,1136,209,83,63,5,0,2,1,1,2,2,3,1846,11,1
"4963","점촌1동","점촌1동제1투","대통령선거","경상북도","문경시",1380,905,128,595,111,42,20,2,0,4,0,0,1,0,0,903,2,475
"4964","점촌1동","점촌1동제2투","대통령선거","경상북도","문경시",1112,754,99,502,93,36,18,1,0,0,0,0,0,1,1,751,3,358
"4965","점촌1동","점촌1동제3투","대통령선거","경상북도","문경시",1049,702,91,452,88,41,18,0,1,0,1,0,0,2,2,696,6,347
"4966","점촌2동","관내사전투표","대통령선거","경상북도","문경시",1617,1617,328,891,210,98,74,3,0,1,1,0,0,3,2,1611,6,0
"4967","점촌2동","점촌2동제1투","대통령선거","경상북도","문경시",1724,1115,151,713,142,66,32,1,0,2,2,0,0,2,0,1111,4,609
"4968","점촌2동","점촌2동제2투","대통령선거","경상북도","문경시",1076,706,78,498,74,36,14,1,0,1,0,0,0,1,0,703,3,370
"4969","점촌2동","점촌2동제3투","대통령선거","경상북도","문경시",1776,1089,157,676,149,63,37,0,0,0,2,0,0,0,1,1085,4,687
"4970","점촌3동","관내사전투표","대통령선거","경상북도","문경시",1504,1504,330,796,201,100,60,5,0,1,1,1,0,1,3,1499,5,0
"4971","점촌3동","점촌3동제1투","대통령선거","경상북도","문경시",2518,1755,234,1034,285,109,62,7,0,0,2,2,0,3,5,1743,12,763
"4972","점촌3동","점촌3동제2투","대통령선거","경상북도","문경시",3035,1936,286,1120,310,120,77,7,1,1,0,1,1,3,3,1930,6,1099
"4973","점촌4동","관내사전투표","대통령선거","경상북도","문경시",671,671,105,402,82,41,34,1,1,0,0,0,0,0,1,667,4,0
"4974","점촌4동","점촌4동제1투","대통령선거","경상북도","문경시",1260,797,89,512,121,35,27,2,0,1,1,2,0,2,2,794,3,463
"4975","점촌4동","점촌4동제2투","대통령선거","경상북도","문경시",799,512,62,337,52,23,23,1,1,0,2,0,0,5,1,507,5,287
"4976","점촌5동","관내사전투표","대통령선거","경상북도","문경시",3162,3162,926,1204,480,344,188,6,0,0,0,1,0,3,2,3154,8,0
"4977","점촌5동","점촌5동제1투","대통령선거","경상북도","문경시",2845,1892,318,1000,325,127,100,5,0,1,1,2,0,2,3,1884,8,953
"4978","점촌5동","점촌5동제2투","대통령선거","경상북도","문경시",2376,1599,324,822,249,122,71,2,0,1,1,0,0,1,0,1593,6,777
"4979","점촌5동","점촌5동제3투","대통령선거","경상북도","문경시",2533,1709,391,709,349,146,103,4,0,0,0,0,0,2,0,1704,5,824
"4980","잘못 투입·구분된 투표지","잘못 투입·구분된 투표지","대통령선거","경상북도","문경시",0,0,0,0,0,0,0,0,0,0,0,0,0,0,0,0,0,0
"4981","거소·선상투표","거소·선상투표","대통령선거","경상북도","예천군",186,170,29,79,37,10,3,0,1,1,2,1,0,1,0,164,6,16
"4982","관외사전투표","관외사전투표","대통령선거","경상북도","예천군",3509,3509,1130,1132,540,395,265,6,0,3,0,2,1,6,9,3489,20,0
"4983","재외투표","재외투표","대통령선거","경상북도","예천군",221,133,60,17,37,4,11,2,1,1,0,0,0,0,0,133,0,88
"4984","예천읍","관내사전투표","대통령선거","경상북도","예천군",3357,3357,687,1771,461,255,137,8,1,1,2,3,2,3,4,3335,22,0
"4985","예천읍","예천읍제1투","대통령선거","경상북도","예천군",1423,900,140,542,140,46,18,5,0,0,0,2,1,0,1,895,5,523
"4986","예천읍","예천읍제2투","대통령선거","경상북도","예천군",1883,1345,189,833,189,83,41,0,0,1,0,0,0,0,3,1339,6,538
"4987","예천읍","예천읍제3투","대통령선거","경상북도","예천군",1962,1341,233,800,181,71,36,2,0,0,1,0,1,4,2,1331,10,621
"4988","예천읍","예천읍제4투","대통령선거","경상북도","예천군",1910,1316,170,859,169,63,32,0,1,1,0,0,1,5,4,1305,11,594
"4989","예천읍","예천읍제5투","대통령선거","경상북도","예천군",2513,1700,232,1008,269,104,59,4,1,1,0,1,3,3,1,1686,14,813
"4990","용문면","관내사전투표","대통령선거","경상북도","예천군",613,613,98,387,73,23,13,1,0,0,0,0,3,5,4,607,6,0
"4991","용문면","용문면투표소","대통령선거","경상북도","예천군",1499,1055,105,750,116,38,16,3,1,0,0,0,5,11,2,1047,8,444
"4992","감천면","관내사전투표","대통령선거","경상북도","예천군",703,703,103,438,87,31,24,0,1,1,0,3,2,5,3,698,5,0
"4993","감천면","감천면제1투","대통령선거","경상북도","예천군",1041,697,89,455,95,16,20,2,0,0,0,0,5,3,5,690,7,344
"4994","감천면","감천면제2투","대통령선거","경상북도","예천군",737,527,66,342,70,29,10,1,0,0,0,0,1,0,0,519,8,210
"4995","보문면","관내사전투표","대통령선거","경상북도","예천군",547,547,69,328,105,22,9,0,0,0,1,1,3,4,1,543,4,0
"4996","보문면","보문면제1투","대통령선거","경상북도","예천군",500,340,31,228,53,15,6,0,0,1,0,0,0,1,0,335,5,160
"4997","보문면","보문면제2투","대통령선거","경상북도","예천군",486,344,31,222,63,11,3,0,1,0,1,2,2,4,2,342,2,142
"4998","호명면","관내사전투표","대통령선거","경상북도","예천군",733,733,180,340,100,68,35,0,0,0,0,0,2,2,2,729,4,0
"4999","호명면","호명면제1투","대통령선거","경상북도","예천군",1825,1210,265,595,198,93,42,3,0,0,1,2,0,4,1,1204,6,615
"5000","호명면","호명면제2투","대통령선거","경상북도","예천군",841,600,61,421,67,20,13,1,1,2,0,0,2,8,0,596,4,241
"5001","유천면","관내사전투표","대통령선거","경상북도","예천군",719,719,112,419,95,45,26,1,0,2,0,3,2,6,2,713,6,0
"5002","유천면","유천면투표소","대통령선거","경상북도","예천군",1579,1108,156,708,137,54,20,1,0,0,1,1,2,7,5,1092,16,471
"5003","용궁면","관내사전투표","대통령선거","경상북도","예천군",758,758,79,497,105,19,18,1,2,0,0,1,2,6,5,735,23,0
"5004","용궁면","용궁면제1투","대통령선거","경상북도","예천군",979,643,47,448,107,17,9,0,0,0,3,1,2,3,2,639,4,336
"5005","용궁면","용궁면제2투","대통령선거","경상북도","예천군",666,474,52,321,56,17,11,0,0,0,2,0,1,7,0,467,7,192
"5006","개포면","관내사전투표","대통령선거","경상북도","예천군",315,315,38,190,57,11,12,0,0,1,0,0,1,0,0,310,5,0
"5007","개포면","개포면투표소","대통령선거","경상북도","예천군",1142,803,83,557,110,26,10,0,1,0,1,0,0,7,1,796,7,339
"5008","지보면","관내사전투표","대통령선거","경상북도","예천군",460,460,64,316,45,13,11,0,0,0,1,0,0,1,3,454,6,0
"5009","지보면","지보면제1투","대통령선거","경상북도","예천군",1443,960,114,666,110,36,16,0,0,1,1,1,2,9,1,957,3,483
"5010","지보면","지보면제2투","대통령선거","경상북도","예천군",678,479,49,339,50,17,8,0,1,1,0,0,3,7,1,476,3,199
"5011","풍양면","관내사전투표","대통령선거","경상북도","예천군",816,816,90,570,88,33,15,1,0,0,2,2,1,3,2,807,9,0
"5012","풍양면","풍양면제1투","대통령선거","경상북도","예천군",1303,907,89,626,95,37,20,2,1,1,3,4,2,6,3,889,18,396
"5013","풍양면","풍양면제2투","대통령선거","경상북도","예천군",945,666,71,469,63,33,12,2,0,0,0,2,1,5,0,658,8,279
"5014","효자면","관내사전투표","대통령선거","경상북도","예천군",230,230,34,132,37,16,4,0,0,0,0,0,2,5,0,230,0,0
"5015","효자면","효자면제1투","대통령선거","경상북도","예천군",373,269,37,164,32,14,6,2,0,1,0,0,0,6,1,263,6,104
"5016","효자면","효자면제2투","대통령선거","경상북도","예천군",370,294,30,210,34,8,2,0,0,0,0,0,2,3,1,290,4,76
"5017","은풍면","관내사전투표","대통령선거","경상북도","예천군",414,414,61,240,63,29,13,3,0,0,1,1,0,2,1,414,0,0
"5018","은풍면","은풍면투표소","대통령선거","경상북도","예천군",866,669,87,444,93,18,12,1,0,1,0,1,2,3,3,665,4,197
"5019","잘못 투입·구분된 투표지","잘못 투입·구분된 투표지","대통령선거","경상북도","예천군",0,0,0,0,0,0,0,0,0,0,0,0,0,0,0,0,0,0
"5020","거소·선상투표","거소·선상투표","대통령선거","경상북도","경산시",362,337,88,79,101,44,13,1,0,1,1,0,0,0,1,329,8,25
"5021","관외사전투표","관외사전투표","대통령선거","경상북도","경산시",16958,16944,5257,4978,2829,2386,1255,35,4,12,3,10,5,6,31,16811,133,14
"5022","재외투표","재외투표","대통령선거","경상북도","경산시",1014,729,400,52,120,54,97,4,0,0,0,0,0,0,0,727,2,285
"5023","하양읍","관내사전투표","대통령선거","경상북도","경산시",3590,3590,968,1291,494,518,272,7,1,2,0,4,3,3,4,3567,23,0
"5024","하양읍","하양읍제1투","대통령선거","경상북도","경산시",2258,1395,230,720,192,151,91,1,0,0,0,0,0,0,2,1387,8,863
"5025","하양읍","하양읍제2투","대통령선거","경상북도","경산시",2058,1385,225,713,229,143,60,1,0,0,1,1,0,1,0,1374,11,673
"5026","하양읍","하양읍제3투","대통령선거","경상북도","경산시",3865,2814,626,1159,464,363,185,1,0,1,1,1,0,0,1,2802,12,1051
"5027","하양읍","하양읍제4투","대통령선거","경상북도","경산시",779,555,71,344,82,45,9,0,0,0,0,0,1,0,0,552,3,224
"5028","하양읍","하양읍제5투","대통령선거","경상북도","경산시",1203,790,103,480,90,87,22,4,1,0,0,1,0,0,0,788,2,413
"5029","하양읍","하양읍제6투","대통령선거","경상북도","경산시",2237,1406,180,842,201,117,47,3,0,0,0,2,0,2,0,1394,12,831
"5030","하양읍","하양읍제7투","대통령선거","경상북도","경산시",2183,1508,249,779,241,150,68,2,0,1,0,1,2,1,2,1496,12,675
"5031","하양읍","하양읍제8투","대통령선거","경상북도","경산시",1752,1360,252,685,198,165,48,4,0,0,0,1,0,0,0,1353,7,392
"5032","진량읍","관내사전투표","대통령선거","경상북도","경산시",4073,4073,1106,1479,648,491,284,5,2,4,4,3,3,5,8,4042,31,0
"5033","진량읍","진량읍제1투","대통령선거","경상북도","경산시",3357,1823,369,812,325,194,108,3,0,0,0,1,1,0,2,1815,8,1534
"5034","진량읍","진량읍제2투","대통령선거","경상북도","경산시",2081,1419,295,658,226,145,73,4,1,1,0,1,1,2,1,1408,11,662
"5035","진량읍","진량읍제3투","대통령선거","경상북도","경산시",1487,943,95,663,94,65,13,2,0,1,0,0,2,2,3,940,3,544
"5036","진량읍","진량읍제4투","대통령선거","경상북도","경산시",2212,1397,206,731,239,122,81,0,0,0,1,1,0,2,3,1386,11,815
"5037","진량읍","진량읍제5투","대통령선거","경상북도","경산시",1916,1193,209,600,149,128,58,5,0,0,4,1,4,5,9,1172,21,723
"5038","진량읍","진량읍제6투","대통령선거","경상북도","경산시",2419,1826,329,910,279,193,99,1,0,0,2,0,1,0,2,1816,10,593
"5039","진량읍","진량읍제7투","대통령선거","경상북도","경산시",2128,1512,299,670,266,172,86,5,0,0,1,0,1,2,2,1504,8,616
"5040","진량읍","진량읍제8투","대통령선거","경상북도","경산시",1005,726,109,446,85,52,26,1,0,0,0,0,0,3,1,723,3,279
"5041","진량읍","진량읍제9투","대통령선거","경상북도","경산시",2750,1874,398,793,316,208,135,5,1,2,0,3,3,0,1,1865,9,876
"5042","진량읍","진량읍제10투","대통령선거","경상북도","경산시",1587,1078,173,552,173,110,54,2,0,0,0,0,1,1,1,1067,11,509
"5043","진량읍","진량읍제11투","대통령선거","경상북도","경산시",2406,1744,378,693,324,221,105,4,1,1,1,4,0,1,6,1739,5,662
"5044","와촌면","관내사전투표","대통령선거","경상북도","경산시",892,892,197,420,119,73,30,4,4,2,1,4,2,2,6,864,28,0
"5045","와촌면","와촌면제1투","대통령선거","경상북도","경산시",1651,989,125,598,147,66,38,1,1,0,0,1,0,1,1,979,10,662
"5046","와촌면","와촌면제2투","대통령선거","경상북도","경산시",1528,1051,114,731,100,64,31,3,0,0,0,0,3,2,0,1048,3,477
"5047","와촌면","와촌면제3투","대통령선거","경상북도","경산시",1338,925,113,619,102,54,21,1,0,1,0,1,3,3,1,919,6,413
"5048","자인면","관내사전투표","대통령선거","경상북도","경산시",1423,1423,253,781,201,124,40,1,0,0,0,3,1,0,3,1407,16,0
"5049","자인면","자인면제1투","대통령선거","경상북도","경산시",1238,818,86,552,79,65,24,2,0,0,0,0,0,1,3,812,6,420
"5050","자인면","자인면제2투","대통령선거","경상북도","경산시",1355,893,103,576,121,54,29,0,0,0,0,1,2,0,3,889,4,462
"5051","자인면","자인면제3투","대통령선거","경상북도","경산시",1377,832,104,513,118,59,29,0,0,0,1,3,0,2,0,829,3,545
"5052","용성면","관내사전투표","대통령선거","경상북도","경산시",879,879,126,533,110,59,23,4,0,1,1,5,1,3,4,870,9,0
"5053","용성면","용성면제1투","대통령선거","경상북도","경산시",942,553,55,361,83,31,11,0,0,0,0,5,0,1,0,547,6,389
"5054","용성면","용성면제2투","대통령선거","경상북도","경산시",885,596,72,391,75,34,6,0,0,1,0,2,1,3,1,586,10,289
"5055","용성면","용성면제3투","대통령선거","경상북도","경산시",295,210,30,136,28,5,3,2,0,1,0,0,0,2,2,209,1,85
"5056","남산면","관내사전투표","대통령선거","경상북도","경산시",608,608,91,354,70,52,20,5,0,1,2,0,0,3,1,599,9,0
"5057","남산면","남산면제1투","대통령선거","경상북도","경산시",1679,1125,124,739,160,70,17,5,0,0,3,0,0,2,0,1120,5,554
"5058","남산면","남산면제2투","대통령선거","경상북도","경산시",920,600,77,403,58,43,12,3,0,0,1,0,1,1,0,599,1,320
"5059","압량면","관내사전투표","대통령선거","경상북도","경산시",3078,3078,946,1023,477,424,181,7,0,2,1,1,1,2,4,3069,9,0
"5060","압량면","압량면제1투","대통령선거","경상북도","경산시",3332,1851,383,816,316,196,115,6,0,2,1,0,0,1,3,1839,12,1481
"5061","압량면","압량면제2투","대통령선거","경상북도","경산시",1764,1144,168,683,148,96,34,3,0,1,0,0,1,1,2,1137,7,620
"5062","압량면","압량면제3투","대통령선거","경상북도","경산시",3653,2208,494,927,372,280,118,3,0,0,0,2,0,3,3,2202,6,1445
"5063","압량면","압량면제4투","대통령선거","경상북도","경산시",805,592,70,384,59,41,15,5,0,0,0,1,1,2,2,580,12,213
"5064","압량면","압량면제5투","대통령선거","경상북도","경산시",3525,2677,727,908,479,385,167,2,0,0,0,1,0,0,0,2669,8,848
"5065","남천면","관내사전투표","대통령선거","경상북도","경산시",503,503,85,257,73,56,24,1,0,2,0,1,0,2,1,502,1,0
"5066","남천면","남천면제1투","대통령선거","경상북도","경산시",1435,1022,139,628,123,89,25,3,0,1,0,4,0,0,4,1016,6,413
"5067","남천면","남천면제2투","대통령선거","경상북도","경산시",909,678,65,476,77,32,14,1,1,2,0,2,1,4,1,676,2,231
"5068","중앙동","관내사전투표","대통령선거","경상북도","경산시",2449,2449,665,970,325,291,167,8,0,2,2,2,0,1,1,2434,15,0
"5069","중앙동","중앙동제1투","대통령선거","경상북도","경산시",3087,2037,343,1142,269,168,93,4,1,2,1,2,0,1,1,2027,10,1050
"5070","중앙동","중앙동제2투","대통령선거","경상북도","경산시",1931,1183,191,656,174,105,45,3,1,0,1,0,0,0,1,1177,6,748
"5071","동부동","관내사전투표","대통령선거","경상북도","경산시",3814,3814,1101,1424,565,447,239,10,2,1,0,2,1,2,1,3795,19,0
"5072","동부동","동부동제1투","대통령선거","경상북도","경산시",2398,1499,275,699,249,187,71,3,0,0,0,2,0,0,5,1491,8,899
"5073","동부동","동부동제2투","대통령선거","경상북도","경산시",1450,919,107,618,84,67,18,3,1,1,0,1,0,3,4,907,12,531
"5074","동부동","동부동제3투","대통령선거","경상북도","경산시",2730,1726,295,912,233,171,88,3,0,2,0,2,1,1,2,1710,16,1004
"5075","동부동","동부동제4투","대통령선거","경상북도","경산시",1615,1086,177,545,181,114,52,6,1,1,0,0,0,0,0,1077,9,529
"5076","동부동","동부동제5투","대통령선거","경상북도","경산시",1519,899,160,459,161,66,37,4,0,0,1,0,0,2,2,892,7,620
"5077","동부동","동부동제6투","대통령선거","경상북도","경산시",2592,1880,370,869,325,196,103,6,0,0,1,2,0,0,2,1874,6,712
"5078","동부동","동부동제7투","대통령선거","경상북도","경산시",3186,2167,551,881,343,233,145,2,0,1,0,2,0,0,1,2159,8,1019
"5079","동부동","동부동제8투","대통령선거","경상북도","경산시",1869,1406,340,579,219,179,79,0,1,0,1,1,0,2,2,1403,3,463
"5080","동부동","동부동제9투","대통령선거","경상북도","경산시",2678,1883,457,819,297,185,103,4,1,1,0,4,0,1,0,1872,11,795
"5081","동부동","동부동제10투","대통령선거","경상북도","경산시",3282,2527,658,930,445,344,128,3,0,2,0,6,0,0,2,2518,9,755
"5082","서부1동","관내사전투표","대통령선거","경상북도","경산시",2903,2903,795,1164,421,335,166,4,0,1,1,0,1,0,2,2890,13,0
"5083","서부1동","서부1동제1투","대통령선거","경상북도","경산시",3053,2198,430,1057,354,239,95,2,1,2,0,2,1,3,1,2187,11,855
"5084","서부1동","서부1동제2투","대통령선거","경상북도","경산시",2193,1376,228,743,205,126,58,3,0,1,1,1,1,1,0,1368,8,817
"5085","서부1동","서부1동제3투","대통령선거","경상북도","경산시",2100,1320,263,646,208,125,63,0,1,1,0,2,2,0,1,1312,8,780
"5086","서부1동","서부1동제4투","대통령선거","경상북도","경산시",1619,1001,212,452,174,99,50,3,0,1,0,0,0,1,1,993,8,618
"5087","서부1동","서부1동제5투","대통령선거","경상북도","경산시",2235,1474,261,734,199,170,92,4,0,0,1,2,0,0,2,1465,9,761
"5088","서부1동","서부1동제6투","대통령선거","경상북도","경산시",2341,1747,309,870,278,198,77,4,2,0,1,0,1,0,1,1741,6,594
"5089","서부1동","서부1동제7투","대통령선거","경상북도","경산시",2726,1852,371,893,272,207,93,5,0,0,0,1,1,1,0,1844,8,874
"5090","서부1동","서부1동제8투","대통령선거","경상북도","경산시",2723,1945,490,756,331,225,125,6,0,0,1,1,0,1,1,1937,8,778
"5091","서부1동","서부1동제9투","대통령선거","경상북도","경산시",3020,2284,641,789,387,293,161,3,0,1,0,1,0,3,0,2279,5,736
"5092","서부1동","서부1동제10투","대통령선거","경상북도","경산시",2205,1728,362,739,296,226,90,3,1,2,1,1,1,0,3,1725,3,477
"5093","서부2동","관내사전투표","대통령선거","경상북도","경산시",3819,3819,1036,1521,536,484,202,10,1,2,0,5,1,5,1,3804,15,0
"5094","서부2동","서부2동제1투","대통령선거","경상북도","경산시",2823,1986,455,852,309,273,84,6,0,0,0,0,0,0,1,1980,6,837
"5095","서부2동","서부2동제2투","대통령선거","경상북도","경산시",1783,1319,310,585,208,141,69,1,0,0,0,1,0,0,0,1315,4,464
"5096","서부2동","서부2동제3투","대통령선거","경상북도","경산시",2655,2083,405,1105,279,209,78,0,0,0,0,1,0,0,2,2079,4,572
"5097","서부2동","서부2동제4투","대통령선거","경상북도","경산시",2181,1787,366,812,281,224,94,2,0,2,1,0,0,1,0,1783,4,394
"5098","서부2동","서부2동제5투","대통령선거","경상북도","경산시",2305,1746,363,807,273,208,79,5,0,1,0,1,0,0,1,1738,8,559
"5099","서부2동","서부2동제6투","대통령선거","경상북도","경산시",1675,1121,263,519,147,137,43,2,1,0,0,1,0,0,2,1115,6,554
"5100","남부동","관내사전투표","대통령선거","경상북도","경산시",1976,1976,537,810,303,205,104,8,0,0,1,4,0,0,0,1972,4,0
"5101","남부동","남부동제1투","대통령선거","경상북도","경산시",2801,1891,316,987,307,160,99,5,0,2,1,1,0,1,0,1879,12,910
"5102","남부동","남부동제2투","대통령선거","경상북도","경산시",735,478,70,290,61,42,10,1,0,0,0,0,0,0,0,474,4,257
"5103","남부동","남부동제3투","대통령선거","경상북도","경산시",2116,1513,263,803,241,118,65,3,2,0,1,2,1,3,5,1507,6,603
"5104","남부동","남부동제4투","대통령선거","경상북도","경산시",2984,2247,499,968,380,273,111,2,1,0,0,1,0,1,0,2236,11,737
"5105","남부동","남부동제5투","대통령선거","경상북도","경산시",2532,1739,347,835,267,184,84,3,0,0,0,1,2,1,3,1727,12,793
"5106","북부동","관내사전투표","대통령선거","경상북도","경산시",1250,1250,405,384,176,193,85,1,0,1,0,0,0,0,0,1245,5,0
"5107","북부동","북부동제1투","대통령선거","경상북도","경산시",2835,2228,519,1022,311,271,86,3,0,0,1,2,0,0,3,2218,10,607
"5108","북부동","북부동제2투","대통령선거","경상북도","경산시",2476,1009,224,440,160,115,55,1,0,0,0,5,0,0,3,1003,6,1467
"5109","북부동","북부동제3투","대통령선거","경상북도","경산시",3499,1904,411,852,292,229,90,8,0,3,0,4,0,3,1,1893,11,1595
"5110","중방동","관내사전투표","대통령선거","경상북도","경산시",1682,1683,442,694,229,187,109,4,0,1,2,1,0,0,5,1674,9,-1
"5111","중방동","중방동제1투","대통령선거","경상북도","경산시",2092,1314,205,705,201,122,65,4,2,1,0,1,0,0,1,1307,7,778
"5112","중방동","중방동제2투","대통령선거","경상북도","경산시",1903,1242,218,676,173,104,56,4,1,1,0,0,1,0,2,1236,6,661
"5113","중방동","중방동제3투","대통령선거","경상북도","경산시",3291,2588,534,1178,417,311,129,3,0,3,0,2,0,1,3,2581,7,703
"5114","잘못 투입·구분된 투표지","잘못 투입·구분된 투표지","대통령선거","경상북도","경산시",0,0,0,0,0,0,0,0,0,0,0,0,0,0,0,0,0,0
"5115","거소·선상투표","거소·선상투표","대통령선거","경상북도","청도군",174,164,33,66,33,11,5,1,0,0,0,0,2,1,1,153,11,10
"5116","관외사전투표","관외사전투표","대통령선거","경상북도","청도군",3839,3839,1085,1463,578,413,245,7,1,1,1,2,2,5,3,3806,33,0
"5117","재외투표","재외투표","대통령선거","경상북도","청도군",380,197,82,23,61,10,20,1,0,0,0,0,0,0,0,197,0,183
"5118","청도읍","관내사전투표","대통령선거","경상북도","청도군",2219,2219,599,1069,222,192,108,4,0,1,0,4,1,4,8,2212,7,0
"5119","청도읍","청도읍제1투","대통령선거","경상북도","청도군",2493,1613,253,919,224,141,53,1,1,3,1,1,1,4,2,1604,9,880
"5120","청도읍","청도읍제2투","대통령선거","경상북도","청도군",2532,1549,242,908,192,120,60,4,0,0,0,1,1,4,3,1535,14,983
"5121","청도읍","청도읍제3투","대통령선거","경상북도","청도군",840,594,100,372,57,38,9,2,0,0,0,0,3,6,0,587,7,246
"5122","청도읍","청도읍제4투","대통령선거","경상북도","청도군",1282,926,128,594,104,60,18,1,0,1,0,2,2,7,2,919,7,356
"5123","청도읍","청도읍제5투","대통령선거","경상북도","청도군",1336,963,107,644,126,53,11,1,1,2,1,0,2,4,4,956,7,373
"5124","화양읍","관내사전투표","대통령선거","경상북도","청도군",670,670,150,355,75,57,25,0,0,1,0,1,0,1,1,666,4,0
"5125","화양읍","화양읍제1투","대통령선거","경상북도","청도군",1122,711,101,421,100,58,13,1,0,0,0,1,2,3,1,701,10,411
"5126","화양읍","화양읍제2투","대통령선거","경상북도","청도군",2234,1546,306,813,204,133,67,0,0,1,0,3,1,2,6,1536,10,688
"5127","화양읍","화양읍제3투","대통령선거","경상북도","청도군",655,504,66,315,63,34,14,3,0,0,0,0,1,4,2,502,2,151
"5128","화양읍","화양읍제4투","대통령선거","경상북도","청도군",914,663,94,443,75,32,12,0,1,0,0,2,0,0,0,659,4,251
"5129","각남면","관내사전투표","대통령선거","경상북도","청도군",518,518,85,327,46,23,11,1,0,0,0,1,1,11,2,508,10,0
"5130","각남면","각남면제1투","대통령선거","경상북도","청도군",839,593,106,374,58,32,19,0,0,0,0,0,1,2,0,592,1,246
"5131","각남면","각남면제2투","대통령선거","경상북도","청도군",481,357,34,245,30,18,12,0,0,0,0,0,2,6,6,353,4,124
"5132","풍각면","관내사전투표","대통령선거","경상북도","청도군",931,931,170,539,105,59,32,1,0,1,0,3,2,4,3,919,12,0
"5133","풍각면","풍각면제1투","대통령선거","경상북도","청도군",1521,998,121,655,105,71,26,1,0,3,1,0,5,2,0,990,8,523
"5134","풍각면","풍각면제2투","대통령선거","경상북도","청도군",634,420,44,288,56,20,3,1,0,1,0,0,1,5,1,420,0,214
"5135","풍각면","풍각면제3투","대통령선거","경상북도","청도군",470,332,36,236,33,9,5,1,1,1,0,1,1,5,0,329,3,138
"5136","각북면","관내사전투표","대통령선거","경상북도","청도군",551,551,82,355,56,34,11,0,1,1,0,0,0,3,4,547,4,0
"5137","각북면","각북면투표소","대통령선거","경상북도","청도군",1225,809,95,532,90,46,21,3,1,0,4,3,0,4,3,802,7,416
"5138","이서면","관내사전투표","대통령선거","경상북도","청도군",637,637,116,395,60,31,21,3,0,0,1,0,0,4,2,633,4,0
"5139","이서면","이서면제1투","대통령선거","경상북도","청도군",2004,1423,180,951,142,87,37,3,0,0,0,1,4,5,6,1416,7,581
"5140","이서면","이서면제2투","대통령선거","경상북도","청도군",1078,776,81,557,71,42,15,2,0,1,2,0,0,2,0,773,3,302
"5141","운문면","관내사전투표","대통령선거","경상북도","청도군",327,327,70,181,36,23,11,1,0,1,0,0,1,0,1,325,2,0
"5142","운문면","운문면제1투","대통령선거","경상북도","청도군",432,310,56,188,31,21,5,2,0,0,0,0,0,3,0,306,4,122
"5143","운문면","운문면제2투","대통령선거","경상북도","청도군",574,373,51,240,43,24,10,0,0,0,1,1,1,0,0,371,2,201
"5144","운문면","운문면제3투","대통령선거","경상북도","청도군",490,354,51,227,56,6,1,1,0,0,0,0,1,4,1,348,6,136
"5145","금천면","관내사전투표","대통령선거","경상북도","청도군",540,540,83,338,66,29,11,4,0,0,0,2,0,4,0,537,3,0
"5146","금천면","금천면제1투","대통령선거","경상북도","청도군",795,518,55,372,56,17,5,0,0,0,0,0,1,3,0,509,9,277
"5147","금천면","금천면제2투","대통령선거","경상북도","청도군",556,388,47,265,33,27,3,1,0,0,0,2,2,4,2,386,2,168
"5148","금천면","금천면제3투","대통령선거","경상북도","청도군",957,688,74,453,90,43,12,0,0,0,0,0,1,8,6,687,1,269
"5149","매전면","관내사전투표","대통령선거","경상북도","청도군",442,442,87,254,51,30,8,3,0,1,0,0,1,1,2,438,4,0
"5150","매전면","매전면제1투","대통령선거","경상북도","청도군",743,493,59,330,62,27,5,2,0,1,0,0,1,1,2,490,3,250
"5151","매전면","매전면제2투","대통령선거","경상북도","청도군",690,489,69,305,69,26,7,2,1,0,0,1,2,2,1,485,4,201
"5152","매전면","매전면제3투","대통령선거","경상북도","청도군",488,358,39,240,41,19,7,0,1,1,0,0,0,3,1,352,6,130
"5153","매전면","매전면제4투","대통령선거","경상북도","청도군",892,615,86,426,54,29,7,0,0,0,1,0,1,3,1,608,7,277
"5154","잘못 투입·구분된 투표지","잘못 투입·구분된 투표지","대통령선거","경상북도","청도군",0,0,0,0,0,0,0,0,0,0,0,0,0,0,0,0,0,0
"5155","거소·선상투표","거소·선상투표","대통령선거","경상북도","고령군",143,138,26,63,22,9,3,1,2,0,1,2,0,1,2,132,6,5
"5156","관외사전투표","관외사전투표","대통령선거","경상북도","고령군",2900,2900,732,1189,409,346,181,6,3,0,2,2,1,3,4,2878,22,0
"5157","재외투표","재외투표","대통령선거","경상북도","고령군",339,130,52,13,46,6,12,0,0,0,0,0,0,0,0,129,1,209
"5158","대가야읍","관내사전투표","대통령선거","경상북도","고령군",1627,1627,382,774,205,132,100,5,1,1,0,1,0,6,5,1612,15,0
"5159","대가야읍","대가야읍제1투","대통령선거","경상북도","고령군",1578,1009,135,670,113,49,27,0,0,0,2,1,0,3,3,1003,6,569
"5160","대가야읍","대가야읍제2투","대통령선거","경상북도","고령군",469,332,48,239,27,9,4,1,0,0,0,0,0,1,0,329,3,137
"5161","대가야읍","대가야읍제3투","대통령선거","경상북도","고령군",1967,1123,157,732,131,59,31,1,0,0,0,3,1,3,0,1118,5,844
"5162","대가야읍","대가야읍제4투","대통령선거","경상북도","고령군",361,253,20,189,22,13,7,0,0,0,0,0,0,1,1,253,0,108
"5163","대가야읍","대가야읍제5투","대통령선거","경상북도","고령군",2201,1492,251,857,185,105,68,6,0,1,2,0,2,4,1,1482,10,709
"5164","덕곡면","관내사전투표","대통령선거","경상북도","고령군",159,159,25,82,19,13,15,0,0,0,0,1,0,1,0,156,3,0
"5165","덕곡면","덕곡면제1투","대통령선거","경상북도","고령군",696,501,52,350,51,32,4,0,0,0,0,2,0,3,2,496,5,195
"5166","덕곡면","덕곡면제2투","대통령선거","경상북도","고령군",436,325,29,232,34,17,4,0,0,0,0,3,1,0,2,322,3,111
"5167","운수면","관내사전투표","대통령선거","경상북도","고령군",269,269,57,149,25,24,9,0,1,0,0,1,1,0,2,269,0,0
"5168","운수면","운수면제1투","대통령선거","경상북도","고령군",1063,702,79,515,53,26,10,2,1,1,0,1,0,2,4,694,8,361
"5169","운수면","운수면제2투","대통령선거","경상북도","고령군",354,254,46,163,26,9,9,0,0,1,0,0,0,0,0,254,0,100
"5170","성산면","관내사전투표","대통령선거","경상북도","고령군",329,329,51,208,34,20,9,3,0,0,0,2,0,1,0,328,1,0
"5171","성산면","성산면제1투","대통령선거","경상북도","고령군",1349,926,119,609,83,51,21,6,2,0,0,2,1,2,2,898,28,423
"5172","성산면","성산면제2투","대통령선거","경상북도","고령군",626,452,57,322,35,22,7,1,0,0,0,0,0,4,2,450,2,174
"5173","다산면","관내사전투표","대통령선거","경상북도","고령군",1171,1171,262,599,140,92,63,4,0,1,0,0,0,3,1,1165,6,0
"5174","다산면","다산면제1투","대통령선거","경상북도","고령군",1743,1158,173,683,169,75,42,3,0,0,0,2,0,1,2,1150,8,585
"5175","다산면","다산면제2투","대통령선거","경상북도","고령군",3116,2026,372,1078,280,176,102,4,0,0,0,0,2,1,2,2017,9,1090
"5176","다산면","다산면제3투","대통령선거","경상북도","고령군",952,652,54,483,60,32,14,2,1,0,0,0,1,1,0,648,4,300
"5177","개진면","관내사전투표","대통령선거","경상북도","고령군",194,194,25,130,21,8,4,4,0,0,0,0,1,0,0,193,1,0
"5178","개진면","개진면제1투","대통령선거","경상북도","고령군",728,487,54,346,47,19,11,1,1,0,0,1,1,1,1,483,4,241
"5179","개진면","개진면제2투","대통령선거","경상북도","고령군",786,548,63,396,47,28,5,0,0,0,0,1,0,6,0,546,2,238
"5180","우곡면","관내사전투표","대통령선거","경상북도","고령군",203,203,30,128,13,9,11,0,0,3,1,1,1,4,0,201,2,0
"5181","우곡면","우곡면제1투","대통령선거","경상북도","고령군",418,282,42,180,22,20,7,0,0,1,1,1,0,1,2,277,5,136
"5182","우곡면","우곡면제2투","대통령선거","경상북도","고령군",818,580,70,404,42,24,23,1,0,0,0,0,2,2,3,571,9,238
"5183","쌍림면","관내사전투표","대통령선거","경상북도","고령군",397,397,68,220,62,26,7,1,1,1,0,2,0,2,0,390,7,0
"5184","쌍림면","쌍림면제1투","대통령선거","경상북도","고령군",903,604,71,431,60,23,11,0,0,1,0,0,3,2,0,602,2,299
"5185","쌍림면","쌍림면제2투","대통령선거","경상북도","고령군",716,519,67,353,57,25,9,1,0,1,1,0,0,0,2,516,3,197
"5186","쌍림면","쌍림면제3투","대통령선거","경상북도","고령군",953,654,85,461,60,24,9,2,0,0,0,1,1,2,2,647,7,299
"5187","잘못 투입·구분된 투표지","잘못 투입·구분된 투표지","대통령선거","경상북도","고령군",0,0,0,0,0,0,0,0,0,0,0,0,0,0,0,0,0,0
"5188","거소·선상투표","거소·선상투표","대통령선거","경상북도","성주군",100,86,24,29,21,6,0,0,1,1,0,1,0,0,2,85,1,14
"5189","관외사전투표","관외사전투표","대통령선거","경상북도","성주군",4074,4073,1086,1571,555,484,312,10,4,1,1,2,1,3,8,4038,35,1
"5190","재외투표","재외투표","대통령선거","경상북도","성주군",283,134,65,13,32,12,12,0,0,0,0,0,0,0,0,134,0,149
"5191","성주읍","관내사전투표","대통령선거","경상북도","성주군",2057,2057,573,751,238,196,266,3,0,1,3,5,2,2,5,2045,12,0
"5192","성주읍","성주읍제1투","대통령선거","경상북도","성주군",1826,1210,227,694,157,59,61,0,0,0,0,2,0,0,2,1202,8,616
"5193","성주읍","성주읍제2투","대통령선거","경상북도","성주군",2519,1526,271,856,160,97,114,1,0,1,0,1,4,3,3,1511,15,993
"5194","성주읍","성주읍제3투","대통령선거","경상북도","성주군",2424,1534,308,748,197,118,144,4,0,1,0,2,0,4,2,1528,6,890
"5195","성주읍","성주읍제4투","대통령선거","경상북도","성주군",1983,1319,251,723,149,83,97,1,0,0,1,1,0,2,1,1309,10,664
"5196","선남면","관내사전투표","대통령선거","경상북도","성주군",698,698,123,401,77,51,39,4,0,0,0,0,0,1,1,697,1,0
"5197","선남면","선남면제1투","대통령선거","경상북도","성주군",2183,1446,180,917,155,99,73,5,0,5,0,0,0,1,3,1438,8,737
"5198","선남면","선남면제2투","대통령선거","경상북도","성주군",2352,1629,200,1090,163,134,27,1,0,0,0,1,0,3,1,1620,9,723
"5199","용암면","관내사전투표","대통령선거","경상북도","성주군",573,573,94,341,64,41,19,1,0,0,0,1,2,3,2,568,5,0
"5200","용암면","용암면제1투","대통령선거","경상북도","성주군",1277,845,113,526,116,55,27,2,0,0,0,0,1,0,1,841,4,432
"5201","용암면","용암면제2투","대통령선거","경상북도","성주군",1292,831,100,554,91,44,28,1,1,0,0,1,0,5,1,826,5,461
"5202","수륜면","관내사전투표","대통령선거","경상북도","성주군",487,487,67,314,49,25,18,1,0,1,1,2,1,5,1,485,2,0
"5203","수륜면","수륜면제1투","대통령선거","경상북도","성주군",1216,750,91,496,88,41,21,4,0,2,1,0,0,3,1,748,2,466
"5204","수륜면","수륜면제2투","대통령선거","경상북도","성주군",748,501,53,343,62,18,11,0,0,2,1,0,4,1,1,496,5,247
"5205","가천면","관내사전투표","대통령선거","경상북도","성주군",365,365,62,219,43,20,11,2,1,0,2,1,2,0,1,364,1,0
"5206","가천면","가천면투표소","대통령선거","경상북도","성주군",1364,926,108,616,117,37,24,1,0,1,1,3,3,3,3,917,9,438
"5207","금수면","관내사전투표","대통령선거","경상북도","성주군",182,182,45,88,19,14,9,2,0,0,0,0,0,2,0,179,3,0
"5208","금수면","금수면투표소","대통령선거","경상북도","성주군",723,520,73,346,58,22,10,1,0,1,0,0,0,4,2,517,3,203
"5209","대가면","관내사전투표","대통령선거","경상북도","성주군",400,400,72,233,47,20,20,1,0,0,0,1,1,2,0,397,3,0
"5210","대가면","대가면투표소","대통령선거","경상북도","성주군",1633,1100,183,704,91,53,38,2,2,0,1,1,0,4,4,1083,17,533
"5211","벽진면","관내사전투표","대통령선거","경상북도","성주군",567,567,94,319,84,28,30,0,1,0,2,1,0,3,1,563,4,0
"5212","벽진면","벽진면투표소","대통령선거","경상북도","성주군",2159,1389,216,848,169,73,60,1,1,1,1,3,2,6,0,1381,8,770
"5213","초전면","관내사전투표","대통령선거","경상북도","성주군",808,808,167,439,95,41,48,4,0,1,0,1,0,4,2,802,6,0
"5214","초전면","초전면제1투","대통령선거","경상북도","성주군",1730,1082,172,642,136,53,58,3,1,3,0,1,1,5,2,1077,5,648
"5215","초전면","초전면제2투","대통령선거","경상북도","성주군",1485,991,150,577,141,40,63,2,1,0,0,2,2,8,2,988,3,494
"5216","월항면","관내사전투표","대통령선거","경상북도","성주군",346,346,57,205,42,11,21,1,0,2,0,0,2,0,1,342,4,0
"5217","월항면","월항면제1투","대통령선거","경상북도","성주군",1592,1113,118,768,115,61,39,2,0,0,0,0,2,3,2,1110,3,479
"5218","월항면","월항면제2투","대통령선거","경상북도","성주군",838,582,66,417,55,20,14,0,1,0,0,0,1,3,2,579,3,256
"5219","잘못 투입·구분된 투표지","잘못 투입·구분된 투표지","대통령선거","경상북도","성주군",0,0,0,0,0,0,0,0,0,0,0,0,0,0,0,0,0,0
"5220","거소·선상투표","거소·선상투표","대통령선거","경상북도","칠곡군",197,185,41,43,69,17,6,0,1,1,0,0,0,0,0,178,7,12
"5221","관외사전투표","관외사전투표","대통령선거","경상북도","칠곡군",8455,8451,2617,2440,1391,1130,724,16,6,4,2,5,3,5,25,8368,83,4
"5222","재외투표","재외투표","대통령선거","경상북도","칠곡군",392,246,119,25,62,14,23,1,0,0,0,0,0,1,1,246,0,146
"5223","왜관읍","관내사전투표","대통령선거","경상북도","칠곡군",4284,4284,1118,1791,597,442,280,8,0,3,1,2,0,2,8,4252,32,0
"5224","왜관읍","왜관읍제1투","대통령선거","경상북도","칠곡군",3186,1893,323,986,282,185,94,5,0,1,1,0,0,1,1,1879,14,1293
"5225","왜관읍","왜관읍제2투","대통령선거","경상북도","칠곡군",2179,1439,256,825,176,122,51,1,0,1,0,1,0,0,1,1434,5,740
"5226","왜관읍","왜관읍제3투","대통령선거","경상북도","칠곡군",1102,598,91,394,50,41,10,1,0,1,0,0,0,5,1,594,4,504
"5227","왜관읍","왜관읍제4투","대통령선거","경상북도","칠곡군",3445,2426,408,1272,376,228,122,5,0,1,0,0,0,1,2,2415,11,1019
"5228","왜관읍","왜관읍제5투","대통령선거","경상북도","칠곡군",3676,2452,513,1155,405,227,126,4,2,1,0,0,2,3,0,2438,14,1224
"5229","왜관읍","왜관읍제6투","대통령선거","경상북도","칠곡군",1740,1196,195,637,202,97,47,3,0,2,0,0,0,1,0,1184,12,544
"5230","왜관읍","왜관읍제7투","대통령선거","경상북도","칠곡군",1798,1159,175,692,141,81,46,5,0,2,0,1,1,1,2,1147,12,639
"5231","왜관읍","왜관읍제8투","대통령선거","경상북도","칠곡군",3241,2146,400,1106,353,154,113,8,0,0,0,0,0,2,2,2138,8,1095
"5232","북삼읍","관내사전투표","대통령선거","경상북도","칠곡군",3041,3041,887,1104,500,316,195,9,0,2,2,2,0,4,3,3024,17,0
"5233","북삼읍","북삼읍제1투","대통령선거","경상북도","칠곡군",2490,1491,302,686,228,167,94,1,0,0,2,2,0,2,3,1487,4,999
"5234","북삼읍","북삼읍제2투","대통령선거","경상북도","칠곡군",1498,969,108,662,121,44,25,0,0,0,0,1,0,0,1,962,7,529
"5235","북삼읍","북삼읍제3투","대통령선거","경상북도","칠곡군",2784,1603,348,705,302,152,66,9,0,0,0,2,2,0,4,1590,13,1181
"5236","북삼읍","북삼읍제4투","대통령선거","경상북도","칠곡군",2727,1612,362,751,237,165,79,4,1,0,0,1,0,1,1,1602,10,1115
"5237","북삼읍","북삼읍제5투","대통령선거","경상북도","칠곡군",2556,1627,244,954,213,135,60,5,1,1,1,2,0,1,2,1619,8,929
"5238","북삼읍","북삼읍제6투","대통령선거","경상북도","칠곡군",2903,2028,517,700,413,228,143,6,1,2,2,4,1,1,4,2022,6,875
"5239","석적읍","관내사전투표","대통령선거","경상북도","칠곡군",3560,3560,1516,642,571,438,365,4,0,2,1,3,0,3,4,3549,11,0
"5240","석적읍","석적읍제1투","대통령선거","경상북도","칠곡군",2960,2112,638,670,381,254,151,2,1,2,0,3,0,0,3,2105,7,848
"5241","석적읍","석적읍제2투","대통령선거","경상북도","칠곡군",3084,1772,569,349,316,275,244,1,0,1,0,2,1,1,3,1762,10,1312
"5242","석적읍","석적읍제3투","대통령선거","경상북도","칠곡군",4045,2668,889,634,549,316,253,4,1,1,1,1,0,0,8,2657,11,1377
"5243","석적읍","석적읍제4투","대통령선거","경상북도","칠곡군",3673,2867,870,745,659,343,231,4,0,0,0,1,1,1,5,2860,7,806
"5244","석적읍","석적읍제5투","대통령선거","경상북도","칠곡군",547,393,32,261,67,21,7,0,0,0,0,1,0,2,1,392,1,154
"5245","석적읍","석적읍제6투","대통령선거","경상북도","칠곡군",2676,1149,356,337,239,121,86,3,1,0,0,1,0,2,1,1147,2,1527
"5246","석적읍","석적읍제7투","대통령선거","경상북도","칠곡군",3021,1905,641,475,381,232,163,1,0,0,1,2,0,0,3,1899,6,1116
"5247","지천면","관내사전투표","대통령선거","경상북도","칠곡군",823,823,90,572,75,54,24,1,0,0,0,1,0,2,1,820,3,0
"5248","지천면","지천면제1투","대통령선거","경상북도","칠곡군",2075,1306,141,880,145,93,32,3,0,0,0,0,0,0,3,1297,9,769
"5249","지천면","지천면제2투","대통령선거","경상북도","칠곡군",947,658,63,479,70,35,6,0,0,0,0,0,0,0,2,655,3,289
"5250","동명면","관내사전투표","대통령선거","경상북도","칠곡군",867,867,133,550,87,68,15,0,1,3,1,1,1,4,0,864,3,0
"5251","동명면","동명면제1투","대통령선거","경상북도","칠곡군",1214,769,95,484,98,54,28,2,0,0,0,0,0,1,1,763,6,445
"5252","동명면","동명면제2투","대통령선거","경상북도","칠곡군",1348,877,100,618,83,56,10,3,0,0,0,0,0,2,3,875,2,471
"5253","동명면","동명면제3투","대통령선거","경상북도","칠곡군",1279,928,102,607,126,70,16,0,0,0,2,1,0,0,1,925,3,351
"5254","가산면","관내사전투표","대통령선거","경상북도","칠곡군",533,533,84,330,61,22,21,2,0,1,1,0,0,2,2,526,7,0
"5255","가산면","가산면제1투","대통령선거","경상북도","칠곡군",1353,822,78,576,95,45,15,2,1,0,0,0,0,6,1,819,3,531
"5256","가산면","가산면제2투","대통령선거","경상북도","칠곡군",795,555,63,354,71,51,12,0,0,0,0,0,1,2,0,554,1,240
"5257","가산면","가산면제3투","대통령선거","경상북도","칠곡군",312,212,19,154,29,8,1,0,0,0,0,0,0,0,0,211,1,100
"5258","약목면","관내사전투표","대통령선거","경상북도","칠곡군",1553,1553,274,877,211,92,75,4,3,2,0,0,1,3,3,1545,8,0
"5259","약목면","약목면제1투","대통령선거","경상북도","칠곡군",1959,1311,149,894,147,66,43,1,0,1,0,2,1,2,2,1308,3,648
"5260","약목면","약목면제2투","대통령선거","경상북도","칠곡군",2348,1472,229,830,224,100,72,4,0,0,1,0,1,1,0,1462,10,876
"5261","약목면","약목면제3투","대통령선거","경상북도","칠곡군",1204,795,106,509,99,42,31,0,0,0,0,1,0,1,0,789,6,409
"5262","약목면","약목면제4투","대통령선거","경상북도","칠곡군",1814,1135,226,566,173,103,52,1,2,1,0,1,1,1,1,1128,7,679
"5263","기산면","관내사전투표","대통령선거","경상북도","칠곡군",549,549,126,276,71,41,30,0,0,0,1,1,0,1,0,547,2,0
"5264","기산면","기산면제1투","대통령선거","경상북도","칠곡군",1855,1263,202,747,165,104,32,4,0,0,0,0,0,3,2,1259,4,592
"5265","기산면","기산면제2투","대통령선거","경상북도","칠곡군",455,306,57,196,29,14,8,0,0,0,0,0,0,0,0,304,2,149
"5266","잘못 투입·구분된 투표지","잘못 투입·구분된 투표지","대통령선거","경상북도","칠곡군",0,0,0,0,0,0,0,0,0,0,0,0,0,0,0,0,0,0
"5267","거소·선상투표","거소·선상투표","대통령선거","경상북도","군위군",64,59,11,28,12,5,0,1,0,0,0,1,0,0,0,58,1,5
"5268","관외사전투표","관외사전투표","대통령선거","경상북도","군위군",2616,2616,600,1142,356,330,165,4,0,1,1,3,1,0,3,2606,10,0
"5269","재외투표","재외투표","대통령선거","경상북도","군위군",287,121,47,21,40,3,7,0,0,1,0,0,0,0,0,119,2,166
"5270","군위읍","관내사전투표","대통령선거","경상북도","군위군",2121,2121,326,1388,208,107,71,4,0,0,1,0,1,3,1,2110,11,0
"5271","군위읍","군위읍제1투","대통령선거","경상북도","군위군",1509,934,125,618,121,43,16,0,0,0,0,2,0,1,1,927,7,575
"5272","군위읍","군위읍제2투","대통령선거","경상북도","군위군",1516,924,123,565,123,65,39,2,0,0,0,1,0,2,2,922,2,592
"5273","군위읍","군위읍제3투","대통령선거","경상북도","군위군",703,476,30,353,40,35,10,1,0,0,0,0,1,3,1,474,2,227
"5274","군위읍","군위읍제4투","대통령선거","경상북도","군위군",704,482,31,367,49,13,8,0,0,0,0,0,1,1,2,472,10,222
"5275","소보면","관내사전투표","대통령선거","경상북도","군위군",579,579,67,409,45,25,24,0,0,0,0,0,2,3,2,577,2,0
"5276","소보면","소보면제1투","대통령선거","경상북도","군위군",854,522,47,395,42,24,5,1,0,0,1,1,0,2,2,520,2,332
"5277","소보면","소보면제2투","대통령선거","경상북도","군위군",563,368,32,276,32,17,5,1,0,0,0,1,0,0,1,365,3,195
"5278","효령면","관내사전투표","대통령선거","경상북도","군위군",889,889,100,627,96,39,8,0,4,1,1,2,1,6,0,885,4,0
"5279","효령면","효령면제1투","대통령선거","경상북도","군위군",1311,834,107,573,88,44,15,2,0,0,0,0,1,1,0,831,3,477
"5280","효령면","효령면제2투","대통령선거","경상북도","군위군",950,694,63,483,68,50,16,1,2,0,3,1,0,2,0,689,5,256
"5281","부계면","관내사전투표","대통령선거","경상북도","군위군",438,438,45,303,47,27,4,2,0,0,0,2,0,2,3,435,3,0
"5282","부계면","부계면제1투","대통령선거","경상북도","군위군",554,351,44,242,25,29,5,1,0,0,0,0,1,1,0,348,3,203
"5283","부계면","부계면제2투","대통령선거","경상북도","군위군",678,499,33,376,44,26,9,5,0,0,0,1,0,3,0,497,2,179
"5284","우보면","관내사전투표","대통령선거","경상북도","군위군",566,566,50,419,62,20,7,1,0,1,0,0,0,2,1,563,3,0
"5285","우보면","우보면제1투","대통령선거","경상북도","군위군",799,519,48,381,56,18,9,3,0,0,0,0,0,2,0,517,2,280
"5286","우보면","우보면제2투","대통령선거","경상북도","군위군",430,298,15,224,32,13,6,1,0,0,0,0,0,3,3,297,1,132
"5287","의흥면","관내사전투표","대통령선거","경상북도","군위군",682,682,66,491,82,24,9,2,1,0,0,0,0,2,1,678,4,0
"5288","의흥면","의흥면제1투","대통령선거","경상북도","군위군",1160,708,59,519,78,38,10,0,0,0,0,0,0,3,0,707,1,452
"5289","의흥면","의흥면제2투","대통령선거","경상북도","군위군",388,264,22,208,22,5,3,0,0,0,0,0,0,3,1,264,0,124
"5290","산성면","관내사전투표","대통령선거","경상북도","군위군",194,194,14,149,17,9,3,1,0,0,0,0,0,1,0,194,0,0
"5291","산성면","산성면제1투","대통령선거","경상북도","군위군",421,305,22,228,36,9,3,0,0,0,0,0,0,3,2,303,2,116
"5292","산성면","산성면제2투","대통령선거","경상북도","군위군",468,342,28,248,44,8,6,5,0,0,0,0,1,2,0,342,0,126
"5293","고로면","관내사전투표","대통령선거","경상북도","군위군",235,235,28,170,20,12,2,1,0,1,0,0,0,1,0,235,0,0
"5294","고로면","고로면제1투","대통령선거","경상북도","군위군",379,232,29,159,29,7,2,0,0,0,0,0,0,2,1,229,3,147
"5295","고로면","고로면제2투","대통령선거","경상북도","군위군",502,375,39,289,25,9,3,3,0,0,0,0,0,3,2,373,2,127
"5296","잘못 투입·구분된 투표지","잘못 투입·구분된 투표지","대통령선거","경상북도","군위군",0,0,0,0,0,0,0,0,0,0,0,0,0,0,0,0,0,0
"5297","거소·선상투표","거소·선상투표","대통령선거","경상북도","의성군",161,150,36,57,30,8,3,0,0,0,0,1,0,1,1,137,13,11
"5298","관외사전투표","관외사전투표","대통령선거","경상북도","의성군",3889,3889,1128,1374,540,503,298,8,0,2,2,2,0,1,3,3861,28,0
"5299","재외투표","재외투표","대통령선거","경상북도","의성군",637,243,73,40,96,10,17,3,0,1,0,0,0,0,0,240,3,394
"5300","의성읍","관내사전투표","대통령선거","경상북도","의성군",2820,2820,594,1480,389,216,104,7,1,0,0,1,2,1,5,2800,20,0
"5301","의성읍","의성읍제1투","대통령선거","경상북도","의성군",1389,782,99,520,93,48,15,2,0,1,0,0,0,0,0,778,4,607
"5302","의성읍","의성읍제2투","대통령선거","경상북도","의성군",2434,1520,262,890,211,99,38,3,0,1,1,2,2,1,1,1511,9,914
"5303","의성읍","의성읍제3투","대통령선거","경상북도","의성군",2338,1486,222,907,224,69,41,3,0,0,1,1,1,1,2,1472,14,852
"5304","의성읍","의성읍제4투","대통령선거","경상북도","의성군",2156,1437,145,968,185,93,26,1,0,0,0,3,1,7,3,1432,5,719
"5305","단촌면","관내사전투표","대통령선거","경상북도","의성군",430,430,55,282,43,28,8,2,1,2,0,2,1,1,0,425,5,0
"5306","단촌면","단촌면투표소","대통령선거","경상북도","의성군",1398,958,106,666,102,45,13,2,1,2,0,3,3,3,3,949,9,440
"5307","점곡면","관내사전투표","대통령선거","경상북도","의성군",452,452,89,268,60,16,12,0,0,0,0,3,0,2,0,450,2,0
"5308","점곡면","점곡면투표소","대통령선거","경상북도","의성군",1056,669,72,448,80,33,14,1,1,1,0,7,1,6,3,667,2,387
"5309","옥산면","관내사전투표","대통령선거","경상북도","의성군",512,512,83,287,79,36,14,1,0,0,1,0,1,4,0,506,6,0
"5310","옥산면","옥산면투표소","대통령선거","경상북도","의성군",1143,752,88,514,91,34,14,1,0,0,1,1,2,2,2,750,2,391
"5311","사곡면","관내사전투표","대통령선거","경상북도","의성군",432,432,38,287,66,22,11,2,1,0,1,1,0,1,1,431,1,0
"5312","사곡면","사곡면투표소","대통령선거","경상북도","의성군",1005,664,64,461,83,32,12,2,1,0,0,2,0,3,1,661,3,341
"5313","춘산면","관내사전투표","대통령선거","경상북도","의성군",269,269,38,181,28,12,6,1,0,0,1,0,0,1,0,268,1,0
"5314","춘산면","춘산면투표소","대통령선거","경상북도","의성군",1029,715,64,505,85,40,4,0,1,0,1,3,1,4,0,708,7,314
"5315","가음면","관내사전투표","대통령선거","경상북도","의성군",423,423,39,281,58,26,12,0,0,1,0,2,1,0,1,421,2,0
"5316","가음면","가음면투표소","대통령선거","경상북도","의성군",904,585,76,382,81,28,10,0,1,1,0,0,0,2,2,583,2,319
"5317","금성면","관내사전투표","대통령선거","경상북도","의성군",1194,1194,147,805,131,62,23,1,0,3,1,8,3,2,0,1186,8,0
"5318","금성면","금성면제1투","대통령선거","경상북도","의성군",1575,995,106,684,114,54,21,1,1,0,0,4,2,4,1,992,3,580
"5319","금성면","금성면제2투","대통령선거","경상북도","의성군",1138,751,85,511,87,43,12,1,0,0,0,2,1,6,0,748,3,387
"5320","봉양면","관내사전투표","대통령선거","경상북도","의성군",909,909,104,620,120,30,23,0,0,0,0,1,0,3,2,903,6,0
"5321","봉양면","봉양면제1투","대통령선거","경상북도","의성군",638,475,45,350,49,16,7,0,0,0,1,0,2,2,0,472,3,163
"5322","봉양면","봉양면제2투","대통령선거","경상북도","의성군",1814,1170,125,811,134,52,36,1,0,0,1,2,1,1,1,1165,5,644
"5323","비안면","관내사전투표","대통령선거","경상북도","의성군",496,496,53,341,56,21,13,0,0,1,0,0,2,3,1,491,5,0
"5324","비안면","비안면투표소","대통령선거","경상북도","의성군",1552,995,92,714,128,27,12,2,1,3,1,3,0,4,2,989,6,557
"5325","구천면","관내사전투표","대통령선거","경상북도","의성군",496,496,58,345,56,20,6,0,0,0,1,0,0,3,0,489,7,0
"5326","구천면","구천면투표소","대통령선거","경상북도","의성군",1149,697,69,474,101,22,13,4,0,0,0,4,2,1,2,692,5,452
"5327","단밀면","관내사전투표","대통령선거","경상북도","의성군",506,506,55,348,57,18,11,0,1,0,1,1,1,5,2,500,6,0
"5328","단밀면","단밀면투표소","대통령선거","경상북도","의성군",1100,680,68,485,74,26,12,0,0,0,1,4,1,5,0,676,4,420
"5329","단북면","관내사전투표","대통령선거","경상북도","의성군",584,584,39,420,69,28,9,3,0,1,0,1,0,7,3,580,4,0
"5330","단북면","단북면투표소","대통령선거","경상북도","의성군",1041,694,53,493,89,32,13,1,0,0,0,0,2,2,1,686,8,347
"5331","안계면","관내사전투표","대통령선거","경상북도","의성군",1288,1288,146,870,149,66,35,6,0,0,0,0,3,2,4,1281,7,0
"5332","안계면","안계면제1투","대통령선거","경상북도","의성군",1349,859,101,597,91,40,20,2,0,0,0,0,0,1,1,853,6,490
"5333","안계면","안계면제2투","대통령선거","경상북도","의성군",1189,770,82,530,93,37,17,1,0,0,0,1,0,4,0,765,5,419
"5334","다인면","관내사전투표","대통령선거","경상북도","의성군",986,986,106,699,105,34,15,1,0,1,1,0,3,8,4,977,9,0
"5335","다인면","다인면제1투","대통령선거","경상북도","의성군",1306,822,87,575,94,42,8,5,0,0,0,1,0,3,0,815,7,484
"5336","다인면","다인면제2투","대통령선거","경상북도","의성군",1178,747,84,512,82,36,12,3,1,0,1,0,2,8,2,743,4,431
"5337","신평면","관내사전투표","대통령선거","경상북도","의성군",292,292,26,198,39,17,4,1,0,0,0,0,0,2,2,289,3,0
"5338","신평면","신평면투표소","대통령선거","경상북도","의성군",449,319,39,214,39,9,5,0,0,0,0,2,2,5,1,316,3,130
"5339","안평면","관내사전투표","대통령선거","경상북도","의성군",555,555,60,416,48,10,8,0,0,0,2,0,1,3,1,549,6,0
"5340","안평면","안평면투표소","대통령선거","경상북도","의성군",1333,799,84,573,89,27,10,3,0,0,0,3,3,4,1,797,2,534
"5341","안사면","관내사전투표","대통령선거","경상북도","의성군",235,235,40,154,14,8,5,2,1,0,0,0,1,2,1,228,7,0
"5342","안사면","안사면투표소","대통령선거","경상북도","의성군",539,353,40,253,35,9,1,1,0,0,0,1,1,8,1,350,3,186
"5343","잘못 투입·구분된 투표지","잘못 투입·구분된 투표지","대통령선거","경상북도","의성군",0,0,0,0,0,0,0,0,0,0,0,0,0,0,0,0,0,0
"5344","거소·선상투표","거소·선상투표","대통령선거","경상북도","청송군",106,96,21,31,23,5,1,0,2,1,0,1,1,5,0,91,5,10
"5345","관외사전투표","관외사전투표","대통령선거","경상북도","청송군",2178,2178,659,714,340,277,161,2,0,0,0,3,1,1,3,2161,17,0
"5346","재외투표","재외투표","대통령선거","경상북도","청송군",188,86,29,14,28,4,9,2,0,0,0,0,0,0,0,86,0,102
"5347","청송읍","관내사전투표","대통령선거","경상북도","청송군",1289,1289,302,620,165,113,67,6,0,1,2,1,1,2,0,1280,9,0
"5348","청송읍","청송읍제1투","대통령선거","경상북도","청송군",1009,630,99,368,94,39,12,1,0,2,3,1,2,1,1,623,7,379
"5349","청송읍","청송읍제2투","대통령선거","경상북도","청송군",546,348,43,212,50,22,8,4,0,0,0,0,0,2,2,343,5,198
"5350","청송읍","청송읍제3투","대통령선거","경상북도","청송군",933,614,94,383,78,38,11,1,0,0,2,0,1,3,0,611,3,319
"5351","청송읍","청송읍제4투","대통령선거","경상북도","청송군",605,427,63,263,49,35,13,0,1,0,0,0,0,2,1,427,0,178
"5352","부동면","관내사전투표","대통령선거","경상북도","청송군",300,300,38,194,42,14,9,0,0,0,0,0,2,0,0,299,1,0
"5353","부동면","부동면제1투","대통령선거","경상북도","청송군",679,415,58,273,49,19,6,0,1,1,0,0,2,0,0,409,6,264
"5354","부동면","부동면제2투","대통령선거","경상북도","청송군",621,453,81,265,58,24,8,0,0,0,4,2,0,6,2,450,3,168
"5355","부남면","관내사전투표","대통령선거","경상북도","청송군",662,662,98,411,90,33,19,0,0,2,1,0,1,4,0,659,3,0
"5356","부남면","부남면제1투","대통령선거","경상북도","청송군",729,470,72,303,50,30,11,0,0,0,0,0,0,2,1,469,1,259
"5357","부남면","부남면제2투","대통령선거","경상북도","청송군",847,599,82,373,86,26,15,2,1,1,0,0,2,4,2,594,5,248
"5358","현동면","관내사전투표","대통령선거","경상북도","청송군",569,569,74,374,70,26,12,1,0,1,0,1,1,4,2,566,3,0
"5359","현동면","현동면투표소","대통령선거","경상북도","청송군",1274,833,103,572,94,31,18,0,0,1,0,3,1,3,1,827,6,441
"5360","현서면","관내사전투표","대통령선거","경상북도","청송군",510,510,112,290,69,20,10,2,0,0,0,0,0,4,0,507,3,0
"5361","현서면","현서면제1투","대통령선거","경상북도","청송군",1146,774,111,514,94,28,14,2,0,2,1,1,1,3,0,771,3,372
"5362","현서면","현서면제2투","대통령선거","경상북도","청송군",519,394,40,253,62,22,8,1,0,0,0,3,0,3,0,392,2,125
"5363","안덕면","관내사전투표","대통령선거","경상북도","청송군",637,637,89,430,72,24,11,1,0,1,0,1,1,4,1,635,2,0
"5364","안덕면","안덕면제1투","대통령선거","경상북도","청송군",1190,785,83,529,93,45,15,2,0,0,1,3,1,6,1,779,6,405
"5365","안덕면","안덕면제2투","대통령선거","경상북도","청송군",397,277,33,195,28,8,2,3,0,0,0,0,0,5,2,276,1,120
"5366","파천면","관내사전투표","대통령선거","경상북도","청송군",257,257,51,152,30,14,7,0,0,0,0,0,1,1,0,256,1,0
"5367","파천면","파천면제1투","대통령선거","경상북도","청송군",704,478,54,326,52,18,20,2,0,0,1,0,0,4,0,477,1,226
"5368","파천면","파천면제2투","대통령선거","경상북도","청송군",593,436,49,304,47,21,6,0,0,0,1,0,0,2,1,431,5,157
"5369","진보면","관내사전투표","대통령선거","경상북도","청송군",1027,1027,231,517,146,75,45,1,0,1,4,0,2,1,1,1024,3,0
"5370","진보면","진보면제1투","대통령선거","경상북도","청송군",1319,842,101,575,87,51,16,2,0,0,1,0,0,5,3,841,1,477
"5371","진보면","진보면제2투","대통령선거","경상북도","청송군",1406,911,150,545,114,49,37,0,0,0,3,0,2,6,1,907,4,495
"5372","진보면","진보면제3투","대통령선거","경상북도","청송군",759,519,112,288,52,46,16,0,0,0,0,0,0,3,0,517,2,240
"5373","진보면","진보면제4투","대통령선거","경상북도","청송군",811,602,86,381,75,23,18,2,0,0,5,0,0,4,0,594,8,209
"5374","잘못 투입·구분된 투표지","잘못 투입·구분된 투표지","대통령선거","경상북도","청송군",0,0,0,0,0,0,0,0,0,0,0,0,0,0,0,0,0,0
"5375","거소·선상투표","거소·선상투표","대통령선거","경상북도","영양군",77,74,10,34,11,1,1,2,2,0,1,0,1,2,1,66,8,3
"5376","관외사전투표","관외사전투표","대통령선거","경상북도","영양군",1326,1326,459,372,205,165,101,3,0,2,9,0,1,0,2,1319,7,0
"5377","재외투표","재외투표","대통령선거","경상북도","영양군",67,46,22,2,15,2,3,2,0,0,0,0,0,0,0,46,0,21
"5378","영양읍","관내사전투표","대통령선거","경상북도","영양군",1574,1574,386,754,199,121,79,0,1,1,12,1,1,6,3,1564,10,0
"5379","영양읍","영양읍제1투","대통령선거","경상북도","영양군",1702,1115,172,656,161,63,35,1,0,0,9,0,1,6,2,1106,9,587
"5380","영양읍","영양읍제2투","대통령선거","경상북도","영양군",1351,920,141,554,128,50,24,3,0,2,9,0,0,2,3,916,4,431
"5381","영양읍","영양읍제3투","대통령선거","경상북도","영양군",1220,771,117,476,88,46,26,1,1,0,9,1,1,3,1,770,1,449
"5382","입암면","관내사전투표","대통령선거","경상북도","영양군",717,717,98,469,85,33,15,0,0,0,6,0,0,5,2,713,4,0
"5383","입암면","입암면투표소","대통령선거","경상북도","영양군",1212,700,98,437,101,36,16,1,0,1,6,0,0,3,0,699,1,512
"5384","청기면","관내사전투표","대통령선거","경상북도","영양군",224,224,48,123,32,10,6,0,0,0,3,0,0,1,1,224,0,0
"5385","청기면","청기면제1투","대통령선거","경상북도","영양군",831,550,73,362,71,23,8,3,0,2,1,0,2,0,1,546,4,281
"5386","청기면","청기면제2투","대통령선거","경상북도","영양군",501,375,47,250,48,13,2,2,0,0,3,1,0,5,1,372,3,126
"5387","일월면","관내사전투표","대통령선거","경상북도","영양군",380,380,76,197,69,11,16,1,0,0,1,0,0,6,0,377,3,0
"5388","일월면","일월면투표소","대통령선거","경상북도","영양군",1175,808,126,494,106,33,30,0,0,2,3,0,1,2,1,798,10,367
"5389","수비면","관내사전투표","대통령선거","경상북도","영양군",281,281,79,120,47,7,16,0,1,0,3,0,1,3,0,277,4,0
"5390","수비면","수비면투표소","대통령선거","경상북도","영양군",1187,780,109,456,130,28,34,0,1,2,2,0,2,5,1,770,10,407
"5391","석보면","관내사전투표","대통령선거","경상북도","영양군",316,316,64,168,43,14,7,0,0,1,14,0,0,2,2,315,1,0
"5392","석보면","석보면제1투","대통령선거","경상북도","영양군",1153,798,120,465,117,26,16,0,0,1,41,0,0,5,0,791,7,355
"5393","석보면","석보면제2투","대통령선거","경상북도","영양군",411,293,36,165,45,15,3,1,0,0,13,0,1,1,0,280,13,118
"5394","잘못 투입·구분된 투표지","잘못 투입·구분된 투표지","대통령선거","경상북도","영양군",0,0,0,0,0,0,0,0,0,0,0,0,0,0,0,0,0,0
"5395","거소·선상투표","거소·선상투표","대통령선거","경상북도","영덕군",167,148,25,64,31,6,2,1,1,0,2,1,0,2,0,135,13,19
"5396","관외사전투표","관외사전투표","대통령선거","경상북도","영덕군",2774,2774,753,963,474,314,229,3,0,2,0,1,3,2,7,2751,23,0
"5397","재외투표","재외투표","대통령선거","경상북도","영덕군",156,84,44,10,20,5,4,1,0,0,0,0,0,0,0,84,0,72
"5398","영덕읍","관내사전투표","대통령선거","경상북도","영덕군",2195,2195,459,1148,271,180,105,7,0,1,0,4,1,2,4,2182,13,0
"5399","영덕읍","영덕읍제1투","대통령선거","경상북도","영덕군",2085,1366,250,728,198,112,55,8,1,0,1,1,0,1,2,1357,9,719
"5400","영덕읍","영덕읍제2투","대통령선거","경상북도","영덕군",1862,1237,142,867,130,64,21,2,1,1,0,0,1,1,1,1231,6,625
"5401","영덕읍","영덕읍제3투","대통령선거","경상북도","영덕군",1648,1093,137,753,103,57,30,0,1,0,1,1,0,2,2,1087,6,555
"5402","영덕읍","영덕읍제4투","대통령선거","경상북도","영덕군",1068,653,53,502,64,20,4,0,1,0,0,0,0,3,1,648,5,415
"5403","강구면","관내사전투표","대통령선거","경상북도","영덕군",762,762,112,467,106,45,19,0,0,1,0,1,0,3,0,754,8,0
"5404","강구면","강구면제1투","대통령선거","경상북도","영덕군",1711,1056,113,753,94,55,27,1,0,2,0,0,1,1,2,1049,7,655
"5405","강구면","강구면제2투","대통령선거","경상북도","영덕군",1809,1240,111,893,141,53,19,0,0,0,0,3,1,3,3,1227,13,569
"5406","강구면","강구면제3투","대통령선거","경상북도","영덕군",1227,719,83,496,93,29,9,4,0,0,0,0,1,1,1,717,2,508
"5407","남정면","관내사전투표","대통령선거","경상북도","영덕군",454,454,40,314,51,27,16,0,0,1,0,0,0,1,0,450,4,0
"5408","남정면","남정면제1투","대통령선거","경상북도","영덕군",1176,758,74,512,98,41,21,1,0,0,0,1,1,7,0,756,2,418
"5409","남정면","남정면제2투","대통령선거","경상북도","영덕군",556,381,29,286,39,10,6,2,0,1,1,0,0,3,1,378,3,175
"5410","달산면","관내사전투표","대통령선거","경상북도","영덕군",173,173,34,89,27,11,6,2,0,0,0,0,0,2,0,171,2,0
"5411","달산면","달산면제1투","대통령선거","경상북도","영덕군",633,417,37,306,49,7,3,1,0,0,0,0,2,6,1,412,5,216
"5412","달산면","달산면제2투","대통령선거","경상북도","영덕군",228,174,15,119,20,13,1,1,0,0,0,1,0,2,1,173,1,54
"5413","지품면","관내사전투표","대통령선거","경상북도","영덕군",314,314,50,188,33,25,8,0,0,0,0,0,3,3,1,311,3,0
"5414","지품면","지품면제1투","대통령선거","경상북도","영덕군",1028,717,65,520,86,29,6,0,0,0,2,0,0,0,3,711,6,311
"5415","지품면","지품면제2투","대통령선거","경상북도","영덕군",505,385,60,236,55,14,6,1,1,0,0,0,2,3,0,378,7,120
"5416","축산면","관내사전투표","대통령선거","경상북도","영덕군",611,611,76,439,49,24,13,0,0,0,0,0,3,0,0,604,7,0
"5417","축산면","축산면제1투","대통령선거","경상북도","영덕군",632,451,47,332,39,18,6,1,1,1,0,0,2,1,1,449,2,181
"5418","축산면","축산면제2투","대통령선거","경상북도","영덕군",1238,790,74,552,118,27,10,0,0,0,0,0,0,3,0,784,6,448
"5419","영해면","관내사전투표","대통령선거","경상북도","영덕군",1263,1263,208,749,163,76,45,2,0,0,1,1,0,5,2,1252,11,0
"5420","영해면","영해면제1투","대통령선거","경상북도","영덕군",1302,794,122,503,100,42,16,0,0,0,0,0,1,2,2,788,6,508
"5421","영해면","영해면제2투","대통령선거","경상북도","영덕군",1559,1037,154,661,127,59,21,3,0,2,0,0,0,2,1,1030,7,522
"5422","영해면","영해면제3투","대통령선거","경상북도","영덕군",1426,953,91,673,117,36,18,0,1,0,0,0,3,6,1,946,7,473
"5423","병곡면","관내사전투표","대통령선거","경상북도","영덕군",658,658,71,471,65,22,19,0,0,0,0,1,1,2,2,654,4,0
"5424","병곡면","병곡면제1투","대통령선거","경상북도","영덕군",816,493,53,345,48,18,14,2,0,0,0,1,2,1,2,486,7,323
"5425","병곡면","병곡면제2투","대통령선거","경상북도","영덕군",1076,752,58,540,89,28,14,2,0,1,0,0,2,2,2,738,14,324
"5426","창수면","관내사전투표","대통령선거","경상북도","영덕군",338,338,51,219,38,22,5,0,0,1,1,0,0,0,0,337,1,0
"5427","창수면","창수면제1투","대통령선거","경상북도","영덕군",755,519,57,365,51,19,16,0,0,0,2,0,0,6,0,516,3,236
"5428","창수면","창수면제2투","대통령선거","경상북도","영덕군",509,366,38,251,44,5,13,1,0,0,0,1,3,4,2,362,4,143
"5429","잘못 투입·구분된 투표지","잘못 투입·구분된 투표지","대통령선거","경상북도","영덕군",0,0,0,0,0,0,0,0,0,0,0,0,0,0,0,0,0,0
"5430","거소·선상투표","거소·선상투표","대통령선거","경상북도","봉화군",155,139,19,64,33,2,6,1,1,1,0,0,1,3,0,131,8,16
"5431","관외사전투표","관외사전투표","대통령선거","경상북도","봉화군",2515,2515,844,737,421,277,198,10,1,3,0,1,1,2,5,2500,15,0
"5432","재외투표","재외투표","대통령선거","경상북도","봉화군",96,73,41,9,11,5,7,0,0,0,0,0,0,0,0,73,0,23
"5433","봉화읍","관내사전투표","대통령선거","경상북도","봉화군",2286,2286,546,1078,303,195,134,5,0,3,0,1,0,4,2,2271,15,0
"5434","봉화읍","봉화읍제1투","대통령선거","경상북도","봉화군",1818,1155,196,630,175,87,53,1,0,2,1,1,1,1,1,1149,6,663
"5435","봉화읍","봉화읍제2투","대통령선거","경상북도","봉화군",1522,1004,147,606,137,55,37,1,0,0,1,5,0,3,0,992,12,518
"5436","봉화읍","봉화읍제3투","대통령선거","경상북도","봉화군",1403,922,130,582,127,44,28,0,0,0,0,1,0,1,4,917,5,481
"5437","봉화읍","봉화읍제4투","대통령선거","경상북도","봉화군",1143,829,109,511,117,56,16,5,0,0,0,0,2,2,5,823,6,314
"5438","물야면","관내사전투표","대통령선거","경상북도","봉화군",406,406,76,202,66,33,23,0,0,0,0,0,1,2,1,404,2,0
"5439","물야면","물야면제1투","대통령선거","경상북도","봉화군",1099,765,92,456,129,46,24,1,0,0,2,2,1,4,2,759,6,334
"5440","물야면","물야면제2투","대통령선거","경상북도","봉화군",1168,831,115,542,117,28,17,1,0,1,0,2,0,4,1,828,3,337
"5441","봉성면","관내사전투표","대통령선거","경상북도","봉화군",236,236,42,121,39,20,9,0,0,0,0,0,1,2,1,235,1,0
"5442","봉성면","봉성면제1투","대통령선거","경상북도","봉화군",692,486,48,310,77,27,11,1,1,0,0,1,2,3,1,482,4,206
"5443","봉성면","봉성면제2투","대통령선거","경상북도","봉화군",885,635,83,411,73,32,22,1,1,0,0,2,0,3,1,629,6,250
"5444","법전면","관내사전투표","대통령선거","경상북도","봉화군",304,304,51,178,46,7,13,1,0,0,0,2,0,3,0,301,3,0
"5445","법전면","법전면투표소","대통령선거","경상북도","봉화군",1445,981,110,626,154,38,29,2,0,1,0,0,5,6,1,972,9,464
"5446","춘양면","관내사전투표","대통령선거","경상북도","봉화군",992,992,175,573,131,56,40,1,0,2,1,1,0,6,1,987,5,0
"5447","춘양면","춘양면제1투","대통령선거","경상북도","봉화군",920,623,74,401,95,26,15,1,1,0,0,0,0,4,0,617,6,297
"5448","춘양면","춘양면제2투","대통령선거","경상북도","봉화군",1043,776,100,494,120,32,22,2,0,0,0,1,0,3,1,775,1,267
"5449","춘양면","춘양면제3투","대통령선거","경상북도","봉화군",995,703,122,392,114,27,24,0,0,1,2,1,5,7,3,698,5,292
"5450","소천면","관내사전투표","대통령선거","경상북도","봉화군",336,336,81,161,49,25,12,0,1,2,0,1,0,2,0,334,2,0
"5451","소천면","소천면제1투","대통령선거","경상북도","봉화군",609,385,43,249,48,27,7,1,1,0,0,0,3,4,1,384,1,224
"5452","소천면","소천면제2투","대통령선거","경상북도","봉화군",486,368,56,212,52,24,8,2,1,2,0,0,1,1,2,361,7,118
"5453","소천면","소천면제3투","대통령선거","경상북도","봉화군",518,389,83,215,47,18,15,0,0,0,1,0,1,5,1,386,3,129
"5454","석포면","관내사전투표","대통령선거","경상북도","봉화군",408,408,109,175,63,35,20,1,0,1,0,0,1,2,0,407,1,0
"5455","석포면","석포면투표소","대통령선거","경상북도","봉화군",1294,824,199,416,122,31,45,0,0,2,0,0,1,3,1,820,4,470
"5456","재산면","관내사전투표","대통령선거","경상북도","봉화군",292,292,65,149,49,14,7,1,0,0,0,0,0,4,1,290,2,0
"5457","재산면","재산면투표소","대통령선거","경상북도","봉화군",1092,700,125,369,119,39,25,0,0,4,1,3,1,7,4,697,3,392
"5458","명호면","관내사전투표","대통령선거","경상북도","봉화군",375,375,86,201,51,21,11,0,0,2,0,2,0,1,0,375,0,0
"5459","명호면","명호면투표소","대통령선거","경상북도","봉화군",1503,1017,121,660,134,36,32,3,0,2,0,2,1,9,3,1003,14,486
"5460","상운면","관내사전투표","대통령선거","경상북도","봉화군",307,307,40,192,44,19,6,0,0,0,0,0,0,2,1,304,3,0
"5461","상운면","상운면투표소","대통령선거","경상북도","봉화군",1269,885,81,614,107,41,18,3,1,0,0,0,2,5,7,879,6,384
"5462","잘못 투입·구분된 투표지","잘못 투입·구분된 투표지","대통령선거","경상북도","봉화군",0,0,0,0,0,0,0,0,0,0,0,0,0,0,0,0,0,0
"5463","거소·선상투표","거소·선상투표","대통령선거","경상북도","울진군",180,170,41,65,39,2,4,1,0,0,1,1,1,1,1,157,13,10
"5464","관외사전투표","관외사전투표","대통령선거","경상북도","울진군",3424,3424,1182,836,565,479,304,4,1,0,0,8,0,3,6,3388,36,0
"5465","재외투표","재외투표","대통령선거","경상북도","울진군",170,117,65,7,28,4,13,0,0,0,0,0,0,0,0,117,0,53
"5466","울진읍","관내사전투표","대통령선거","경상북도","울진군",2594,2594,810,1008,306,268,178,4,1,1,1,5,2,0,2,2586,8,0
"5467","울진읍","울진읍제1투","대통령선거","경상북도","울진군",1833,1172,240,653,153,69,47,1,0,0,0,0,0,4,0,1167,5,661
"5468","울진읍","울진읍제2투","대통령선거","경상북도","울진군",1879,1244,297,576,200,101,58,2,0,2,0,1,1,1,2,1241,3,635
"5469","울진읍","울진읍제3투","대통령선거","경상북도","울진군",2275,1567,313,807,242,119,68,0,0,4,0,0,0,3,3,1559,8,708
"5470","울진읍","울진읍제4투","대통령선거","경상북도","울진군",1788,1241,258,662,155,86,57,2,0,2,0,1,0,4,2,1229,12,547
"5471","평해읍","관내사전투표","대통령선거","경상북도","울진군",699,699,107,466,68,33,15,1,0,1,0,0,3,2,1,697,2,0
"5472","평해읍","평해읍제1투","대통령선거","경상북도","울진군",883,523,56,364,58,27,13,0,0,1,0,0,0,0,1,520,3,360
"5473","평해읍","평해읍제2투","대통령선거","경상북도","울진군",975,607,73,421,71,22,5,0,0,0,0,0,2,5,2,601,6,368
"5474","북면","관내사전투표","대통령선거","경상북도","울진군",1572,1572,504,612,228,108,90,2,2,1,0,5,1,9,3,1565,7,0
"5475","북면","북면제1투","대통령선거","경상북도","울진군",1939,1120,220,546,191,83,57,4,0,4,0,4,0,5,2,1116,4,819
"5476","북면","북면제2투","대통령선거","경상북도","울진군",509,367,50,224,57,15,14,0,0,1,0,0,0,1,0,362,5,142
"5477","북면","북면제3투","대통령선거","경상북도","울진군",1364,1049,399,307,164,103,69,0,0,0,0,0,1,0,3,1046,3,315
"5478","금강송면","관내사전투표","대통령선거","경상북도","울진군",364,364,62,230,40,14,12,0,0,0,0,0,1,4,0,363,1,0
"5479","금강송면","금강송면제1투","대통령선거","경상북도","울진군",621,377,50,274,29,11,4,1,1,0,0,0,1,3,1,375,2,244
"5480","금강송면","금강송면제2투","대통령선거","경상북도","울진군",219,176,38,98,22,14,1,0,0,0,0,0,1,1,0,175,1,43
"5481","근남면","관내사전투표","대통령선거","경상북도","울진군",608,608,119,342,75,40,16,1,0,1,0,1,0,7,0,602,6,0
"5482","근남면","근남면투표소","대통령선거","경상북도","울진군",1775,1148,188,675,155,72,30,5,0,2,1,0,2,6,4,1140,8,627
"5483","매화면","관내사전투표","대통령선거","경상북도","울진군",674,674,111,421,74,21,24,1,1,1,1,0,2,10,3,670,4,0
"5484","매화면","매화면투표소","대통령선거","경상북도","울진군",1259,745,95,478,108,26,21,0,0,0,2,1,2,6,2,741,4,514
"5485","기성면","관내사전투표","대통령선거","경상북도","울진군",679,679,102,412,107,25,17,0,0,2,0,0,3,6,0,674,5,0
"5486","기성면","기성면투표소","대통령선거","경상북도","울진군",1646,929,109,631,124,34,11,1,0,1,0,0,3,6,0,920,9,717
"5487","온정면","관내사전투표","대통령선거","경상북도","울진군",413,413,54,291,37,16,8,0,0,1,0,1,0,1,3,412,1,0
"5488","온정면","온정면투표소","대통령선거","경상북도","울진군",1218,801,73,590,81,22,14,1,0,1,1,0,5,5,2,795,6,417
"5489","죽변면","관내사전투표","대통령선거","경상북도","울진군",1602,1602,318,886,219,76,72,2,0,0,0,4,1,3,5,1586,16,0
"5490","죽변면","죽변면제1투","대통령선거","경상북도","울진군",1628,794,108,483,110,50,28,0,0,1,0,1,2,0,2,785,9,834
"5491","죽변면","죽변면제2투","대통령선거","경상북도","울진군",2504,1414,320,679,227,98,72,2,2,1,0,0,1,2,1,1405,9,1090
"5492","후포면","관내사전투표","대통령선거","경상북도","울진군",1263,1263,208,779,139,79,46,0,1,1,0,0,0,0,0,1253,10,0
"5493","후포면","후포면제1투","대통령선거","경상북도","울진군",1341,840,73,611,100,34,8,1,1,1,0,1,2,2,1,835,5,501
"5494","후포면","후포면제2투","대통령선거","경상북도","울진군",1849,1074,140,697,154,51,18,2,0,0,0,0,0,2,3,1067,7,775
"5495","후포면","후포면제3투","대통령선거","경상북도","울진군",2007,1201,189,736,150,73,40,0,0,1,1,0,0,4,2,1196,5,806
"5496","잘못 투입·구분된 투표지","잘못 투입·구분된 투표지","대통령선거","경상북도","울진군",0,0,0,0,0,0,0,0,0,0,0,0,0,0,0,0,0,0
"5497","거소·선상투표","거소·선상투표","대통령선거","경기도","수원시장안구",593,554,153,112,179,37,17,5,4,0,1,8,2,0,2,520,34,39
"5498","관외사전투표","관외사전투표","대통령선거","경기도","수원시장안구",21481,21481,9983,2939,4749,1850,1693,26,7,13,7,26,2,6,36,21337,144,0
"5499","재외투표","재외투표","대통령선거","경기도","수원시장안구",1592,1245,758,77,202,50,140,3,0,0,0,3,0,0,2,1235,10,347
"5500","파장동","관내사전투표","대통령선거","경기도","수원시장안구",3513,3513,1576,732,751,194,231,2,0,1,0,16,1,1,1,3506,7,0
"5501","파장동","파장동제1투","대통령선거","경기도","수원시장안구",1747,1083,376,300,281,60,56,2,0,0,0,1,0,1,0,1077,6,664
"5502","파장동","파장동제2투","대통령선거","경기도","수원시장안구",2679,1747,646,461,429,98,104,1,0,0,0,1,0,1,0,1741,6,932
"5503","파장동","파장동제3투","대통령선거","경기도","수원시장안구",2673,1683,607,421,443,92,106,2,0,2,0,1,2,0,2,1678,5,990
"5504","파장동","파장동제4투","대통령선거","경기도","수원시장안구",2206,1487,528,366,379,93,108,1,0,3,0,2,0,0,1,1481,6,719
"5505","파장동","파장동제5투","대통령선거","경기도","수원시장안구",2535,1549,571,397,376,97,100,0,0,3,0,0,0,1,2,1547,2,986
"5506","파장동","파장동제6투","대통령선거","경기도","수원시장안구",2163,1761,803,271,406,135,134,4,0,3,0,0,0,1,1,1758,3,402
"5507","파장동","파장동제7투","대통령선거","경기도","수원시장안구",2004,1671,741,281,404,136,94,8,0,0,0,0,0,1,1,1666,5,333
"5508","율천동","관내사전투표","대통령선거","경기도","수원시장안구",6876,6876,3388,825,1299,661,648,6,1,1,0,7,0,1,6,6843,33,0
"5509","율천동","율천동제1투","대통령선거","경기도","수원시장안구",2732,1974,835,350,462,167,146,1,0,0,0,1,1,1,1,1965,9,758
"5510","율천동","율천동제2투","대통령선거","경기도","수원시장안구",2965,1990,788,452,444,130,147,5,0,3,2,0,0,0,3,1974,16,975
"5511","율천동","율천동제3투","대통령선거","경기도","수원시장안구",2078,1780,854,249,407,136,126,2,0,1,0,1,0,0,1,1777,3,298
"5512","율천동","율천동제4투","대통령선거","경기도","수원시장안구",3080,2543,1162,437,565,180,191,1,0,0,1,1,0,1,0,2539,4,537
"5513","율천동","율천동제5투","대통령선거","경기도","수원시장안구",3272,2596,1085,490,620,205,180,5,0,1,0,0,0,1,2,2589,7,676
"5514","율천동","율천동제6투","대통령선거","경기도","수원시장안구",2846,2075,901,348,482,165,161,2,1,4,0,2,1,2,0,2069,6,771
"5515","율천동","율천동제7투","대통령선거","경기도","수원시장안구",3486,2663,1148,503,619,187,181,4,1,0,0,7,1,1,1,2653,10,823
"5516","율천동","율천동제8투","대통령선거","경기도","수원시장안구",1121,909,300,50,229,208,106,1,0,0,0,0,0,0,1,895,14,212
"5517","율천동","율천동제9투","대통령선거","경기도","수원시장안구",3746,3127,1474,473,732,250,182,2,0,2,0,1,0,1,0,3117,10,619
"5518","정자1동","관내사전투표","대통령선거","경기도","수원시장안구",4120,4120,1944,706,873,299,272,2,0,3,0,7,1,2,1,4110,10,0
"5519","정자1동","정자1동제1투","대통령선거","경기도","수원시장안구",3082,2063,804,431,492,152,161,3,0,3,0,3,3,0,3,2055,8,1019
"5520","정자1동","정자1동제2투","대통령선거","경기도","수원시장안구",1646,1011,396,243,217,56,88,0,0,3,1,2,0,1,1,1008,3,635
"5521","정자1동","정자1동제3투","대통령선거","경기도","수원시장안구",3416,2591,1081,552,596,211,138,1,0,3,0,2,0,0,0,2584,7,825
"5522","정자1동","정자1동제4투","대통령선거","경기도","수원시장안구",3797,2827,1176,665,600,198,172,3,1,2,0,0,0,0,3,2820,7,970
"5523","정자1동","정자1동제5투","대통령선거","경기도","수원시장안구",1787,1178,424,324,276,77,66,3,0,0,0,1,1,0,0,1172,6,609
"5524","정자1동","정자1동제6투","대통령선거","경기도","수원시장안구",3218,2729,1335,356,630,189,213,0,0,0,0,1,0,0,1,2725,4,489
"5525","정자1동","정자1동제7투","대통령선거","경기도","수원시장안구",3536,2974,1371,433,704,244,211,3,0,1,0,0,0,1,2,2970,4,562
"5526","정자2동","관내사전투표","대통령선거","경기도","수원시장안구",3011,3011,1332,637,597,217,203,4,0,2,0,8,1,3,1,3005,6,0
"5527","정자2동","정자2동제1투","대통령선거","경기도","수원시장안구",2871,1674,613,415,420,100,109,1,1,2,0,3,2,1,0,1667,7,1197
"5528","정자2동","정자2동제2투","대통령선거","경기도","수원시장안구",3081,2239,848,541,574,116,139,4,0,2,0,6,0,2,0,2232,7,842
"5529","정자2동","정자2동제3투","대통령선거","경기도","수원시장안구",3393,2285,865,549,548,164,141,4,0,1,0,1,3,0,0,2276,9,1108
"5530","정자2동","정자2동제4투","대통령선거","경기도","수원시장안구",2074,1352,484,392,315,60,81,6,1,8,2,1,1,1,0,1352,0,722
"5531","정자2동","정자2동제5투","대통령선거","경기도","수원시장안구",2728,2248,992,395,528,155,160,4,1,0,1,2,0,0,2,2240,8,480
"5532","정자2동","정자2동제6투","대통령선거","경기도","수원시장안구",3364,2718,1201,484,639,173,195,6,1,2,0,3,2,3,3,2712,6,646
"5533","정자2동","정자2동제7투","대통령선거","경기도","수원시장안구",2288,1909,957,267,400,133,146,1,0,0,0,2,1,1,0,1908,1,379
"5534","정자3동","관내사전투표","대통령선거","경기도","수원시장안구",5921,5921,3182,693,1085,459,457,9,0,4,1,7,0,2,6,5905,16,0
"5535","정자3동","정자3동제1투","대통령선거","경기도","수원시장안구",2291,1742,770,333,376,142,113,1,0,1,0,1,0,1,1,1739,3,549
"5536","정자3동","정자3동제2투","대통령선거","경기도","수원시장안구",2269,1849,797,387,399,123,132,4,0,0,1,2,1,0,0,1846,3,420
"5537","정자3동","정자3동제3투","대통령선거","경기도","수원시장안구",2906,2422,1199,281,563,173,194,1,0,1,1,3,0,2,1,2419,3,484
"5538","정자3동","정자3동제4투","대통령선거","경기도","수원시장안구",2400,2038,960,275,483,169,141,2,0,1,0,0,0,0,2,2033,5,362
"5539","정자3동","정자3동제5투","대통령선거","경기도","수원시장안구",3523,2936,1368,436,633,255,227,1,0,1,0,1,1,1,5,2929,7,587
"5540","정자3동","정자3동제6투","대통령선거","경기도","수원시장안구",3632,3115,1464,513,667,238,221,3,0,1,0,0,0,0,2,3109,6,517
"5541","정자3동","정자3동제7투","대통령선거","경기도","수원시장안구",2069,1620,831,251,316,103,115,1,0,0,0,1,0,1,0,1619,1,449
"5542","정자3동","정자3동제8투","대통령선거","경기도","수원시장안구",3119,2618,1305,368,523,228,183,1,0,2,1,1,0,0,1,2613,5,501
"5543","정자3동","정자3동제9투","대통령선거","경기도","수원시장안구",1976,1478,623,258,362,118,104,3,0,1,0,1,0,3,3,1476,2,498
"5544","영화동","관내사전투표","대통령선거","경기도","수원시장안구",2610,2610,1072,670,553,119,171,4,0,2,0,3,0,1,3,2598,12,0
"5545","영화동","영화동제1투","대통령선거","경기도","수원시장안구",3096,1749,548,529,459,84,108,2,0,2,2,2,0,2,2,1740,9,1347
"5546","영화동","영화동제2투","대통령선거","경기도","수원시장안구",2846,1698,523,492,437,99,127,2,0,1,2,1,1,2,0,1687,11,1148
"5547","영화동","영화동제3투","대통령선거","경기도","수원시장안구",3365,2276,808,624,553,139,136,1,2,1,0,1,1,2,1,2269,7,1089
"5548","영화동","영화동제4투","대통령선거","경기도","수원시장안구",2716,1827,666,482,431,129,106,2,0,0,2,1,0,1,0,1820,7,889
"5549","영화동","영화동제5투","대통령선거","경기도","수원시장안구",2908,1775,679,432,434,96,118,1,0,0,0,2,0,2,4,1768,7,1133
"5550","송죽동","관내사전투표","대통령선거","경기도","수원시장안구",2809,2809,1311,502,585,179,210,7,1,2,0,1,2,0,2,2802,7,0
"5551","송죽동","송죽동제1투","대통령선거","경기도","수원시장안구",3077,2097,858,411,515,141,151,2,0,3,2,0,2,0,2,2087,10,980
"5552","송죽동","송죽동제2투","대통령선거","경기도","수원시장안구",2818,1977,765,400,508,136,150,10,0,2,1,2,0,0,0,1974,3,841
"5553","송죽동","송죽동제3투","대통령선거","경기도","수원시장안구",3096,2136,819,493,511,138,150,7,2,2,2,2,1,0,1,2128,8,960
"5554","송죽동","송죽동제4투","대통령선거","경기도","수원시장안구",3020,2023,760,492,524,116,117,2,0,3,1,0,0,0,3,2018,5,997
"5555","조원1동","관내사전투표","대통령선거","경기도","수원시장안구",4005,4005,1709,832,821,251,359,4,0,4,1,3,0,3,5,3992,13,0
"5556","조원1동","조원1동제1투","대통령선거","경기도","수원시장안구",3709,2235,827,536,536,153,167,3,0,4,0,0,0,0,1,2227,8,1474
"5557","조원1동","조원1동제2투","대통령선거","경기도","수원시장안구",2571,1722,720,365,404,93,125,1,2,0,1,0,0,1,3,1715,7,849
"5558","조원1동","조원1동제3투","대통령선거","경기도","수원시장안구",2934,1868,660,464,495,99,130,3,1,3,2,1,1,0,1,1860,8,1066
"5559","조원1동","조원1동제4투","대통령선거","경기도","수원시장안구",2484,1703,638,446,406,90,108,2,2,3,2,2,0,0,0,1699,4,781
"5560","조원1동","조원1동제5투","대통령선거","경기도","수원시장안구",3102,2176,706,744,493,104,97,3,1,6,0,0,2,2,5,2163,13,926
"5561","조원1동","조원1동제6투","대통령선거","경기도","수원시장안구",2038,1564,586,336,373,143,117,2,0,0,1,0,1,0,0,1559,5,474
"5562","조원1동","조원1동제7투","대통령선거","경기도","수원시장안구",2657,2071,847,399,495,160,153,1,1,0,1,3,0,0,2,2062,9,586
"5563","조원2동","관내사전투표","대통령선거","경기도","수원시장안구",4445,4445,1936,840,952,328,363,5,0,1,0,7,1,1,1,4435,10,0
"5564","조원2동","조원2동제1투","대통령선거","경기도","수원시장안구",2947,2278,889,528,570,165,119,0,0,0,1,0,0,0,1,2273,5,669
"5565","조원2동","조원2동제2투","대통령선거","경기도","수원시장안구",2750,2129,808,460,506,197,153,2,0,0,0,0,0,0,0,2126,3,621
"5566","조원2동","조원2동제3투","대통령선거","경기도","수원시장안구",2710,2167,878,401,522,178,179,3,0,1,1,1,0,0,0,2164,3,543
"5567","조원2동","조원2동제4투","대통령선거","경기도","수원시장안구",2465,1970,780,455,441,170,114,3,0,2,0,0,0,1,0,1966,4,495
"5568","연무동","관내사전투표","대통령선거","경기도","수원시장안구",1820,1820,714,483,371,107,129,1,0,2,0,1,0,3,2,1813,7,0
"5569","연무동","연무동제1투","대통령선거","경기도","수원시장안구",1526,852,265,276,201,56,44,3,1,1,1,2,0,0,0,850,2,674
"5570","연무동","연무동제2투","대통령선거","경기도","수원시장안구",2216,1431,460,433,362,65,94,4,0,1,0,1,2,0,1,1423,8,785
"5571","연무동","연무동제3투","대통령선거","경기도","수원시장안구",3384,2221,717,613,591,139,145,3,0,1,0,1,1,1,4,2216,5,1163
"5572","연무동","연무동제4투","대통령선거","경기도","수원시장안구",419,310,73,138,76,8,10,0,1,0,1,1,0,0,0,308,2,109
"5573","연무동","연무동제5투","대통령선거","경기도","수원시장안구",2933,1975,662,586,455,103,144,4,0,3,0,4,0,0,3,1964,11,958
"5574","연무동","연무동제6투","대통령선거","경기도","수원시장안구",3227,2023,709,562,490,106,133,4,0,5,0,1,1,2,1,2014,9,1204
"5575","잘못 투입·구분된 투표지","잘못 투입·구분된 투표지","대통령선거","경기도","수원시장안구",0,0,0,0,0,0,0,0,0,0,0,0,0,0,0,0,0,0
"5576","거소·선상투표","거소·선상투표","대통령선거","경기도","수원시권선구",551,521,160,91,173,30,23,3,4,0,3,2,4,3,5,501,20,30
"5577","관외사전투표","관외사전투표","대통령선거","경기도","수원시권선구",26085,26032,12290,3682,5556,2052,2151,35,7,9,10,22,10,6,39,25869,163,53
"5578","재외투표","재외투표","대통령선거","경기도","수원시권선구",1552,1248,779,63,195,57,142,6,0,2,0,0,0,2,0,1246,2,304
"5579","세류1동","관내사전투표","대통령선거","경기도","수원시권선구",1908,1908,839,395,418,112,134,2,0,3,0,0,0,0,2,1905,3,0
"5580","세류1동","세류1동제1투","대통령선거","경기도","수원시권선구",1712,1384,576,298,296,106,98,3,1,0,1,1,1,0,1,1382,2,328
"5581","세류1동","세류1동제2투","대통령선거","경기도","수원시권선구",2647,1620,604,403,369,112,117,5,0,1,0,0,1,1,1,1614,6,1027
"5582","세류1동","세류1동제3투","대통령선거","경기도","수원시권선구",2505,1892,725,443,470,130,112,2,0,1,1,0,0,0,3,1887,5,613
"5583","세류2동","관내사전투표","대통령선거","경기도","수원시권선구",2626,2625,1149,526,569,167,185,4,0,2,3,5,1,0,1,2612,13,1
"5584","세류2동","세류2동제1투","대통령선거","경기도","수원시권선구",3613,2010,741,553,482,108,107,2,0,3,0,2,0,1,3,2002,8,1603
"5585","세류2동","세류2동제2투","대통령선거","경기도","수원시권선구",2524,1565,564,397,402,90,103,5,0,0,0,0,1,0,0,1562,3,959
"5586","세류2동","세류2동제3투","대통령선거","경기도","수원시권선구",2634,1523,542,391,374,94,109,2,2,1,1,1,0,0,2,1519,4,1111
"5587","세류2동","세류2동제4투","대통령선거","경기도","수원시권선구",3274,1866,674,466,485,108,114,3,0,4,1,2,0,0,2,1859,7,1408
"5588","세류2동","세류2동제5투","대통령선거","경기도","수원시권선구",3297,1973,747,476,467,112,155,3,0,2,0,0,0,1,1,1964,9,1324
"5589","세류2동","세류2동제6투","대통령선거","경기도","수원시권선구",2436,1455,482,353,412,101,89,1,0,3,1,1,0,0,5,1448,7,981
"5590","세류3동","관내사전투표","대통령선거","경기도","수원시권선구",3309,3309,1363,771,705,210,214,8,6,5,0,6,2,1,3,3294,15,0
"5591","세류3동","세류3동제1투","대통령선거","경기도","수원시권선구",2948,1682,603,468,405,82,109,0,0,2,0,2,2,1,3,1677,5,1266
"5592","세류3동","세류3동제2투","대통령선거","경기도","수원시권선구",2972,1663,618,407,442,83,99,2,0,0,0,1,1,1,1,1655,8,1309
"5593","세류3동","세류3동제3투","대통령선거","경기도","수원시권선구",3225,2060,710,523,559,132,123,0,0,2,0,1,0,0,5,2055,5,1165
"5594","세류3동","세류3동제4투","대통령선거","경기도","수원시권선구",3273,1716,645,406,430,117,107,1,1,1,0,0,0,3,1,1712,4,1557
"5595","세류3동","세류3동제5투","대통령선거","경기도","수원시권선구",3090,1940,687,534,471,107,124,2,1,1,0,1,3,0,1,1932,8,1150
"5596","평동","관내사전투표","대통령선거","경기도","수원시권선구",3708,3708,1737,683,769,203,287,2,0,2,0,6,0,2,4,3695,13,0
"5597","평동","평동제1투","대통령선거","경기도","수원시권선구",1965,1213,411,349,285,93,68,2,0,1,0,0,0,0,1,1210,3,752
"5598","평동","평동제2투","대통령선거","경기도","수원시권선구",2101,1352,434,434,317,68,86,2,1,5,0,1,1,0,1,1350,2,749
"5599","평동","평동제3투","대통령선거","경기도","수원시권선구",2878,1840,700,408,482,112,124,2,0,1,1,2,1,1,2,1836,4,1038
"5600","평동","평동제4투","대통령선거","경기도","수원시권선구",2704,1817,714,355,471,135,125,2,0,2,1,3,0,2,3,1813,4,887
"5601","평동","평동제5투","대통령선거","경기도","수원시권선구",3525,2435,889,543,635,182,168,1,0,2,0,1,0,1,3,2425,10,1090
"5602","평동","평동제6투","대통령선거","경기도","수원시권선구",3770,2630,1024,657,576,164,189,3,0,0,2,1,1,2,2,2621,9,1140
"5603","평동","평동제7투","대통령선거","경기도","수원시권선구",3182,2334,841,538,619,164,152,3,0,3,5,1,0,0,1,2327,7,848
"5604","평동","평동제8투","대통령선거","경기도","수원시권선구",3370,2539,1048,443,629,190,208,5,0,2,0,1,0,1,3,2530,9,831
"5605","서둔동","관내사전투표","대통령선거","경기도","수원시권선구",4034,4034,1814,842,814,228,284,9,2,5,3,2,2,2,3,4010,24,0
"5606","서둔동","서둔동제1투","대통령선거","경기도","수원시권선구",1733,1083,361,288,257,70,97,1,0,2,0,4,1,0,1,1082,1,650
"5607","서둔동","서둔동제2투","대통령선거","경기도","수원시권선구",2144,1514,570,333,385,97,115,4,0,4,0,1,0,0,2,1511,3,630
"5608","서둔동","서둔동제3투","대통령선거","경기도","수원시권선구",3264,2039,665,495,570,132,145,3,0,1,0,7,1,3,3,2025,14,1225
"5609","서둔동","서둔동제4투","대통령선거","경기도","수원시권선구",1934,1014,307,288,276,79,58,1,0,2,0,0,0,0,0,1011,3,920
"5610","서둔동","서둔동제5투","대통령선거","경기도","수원시권선구",3424,2351,955,529,536,149,165,4,0,2,0,0,1,1,1,2343,8,1073
"5611","서둔동","서둔동제6투","대통령선거","경기도","수원시권선구",3717,2464,981,503,612,172,178,0,1,6,1,0,1,1,1,2457,7,1253
"5612","서둔동","서둔동제7투","대통령선거","경기도","수원시권선구",2420,1902,802,332,475,146,130,4,2,3,1,0,1,0,4,1900,2,518
"5613","서둔동","서둔동제8투","대통령선거","경기도","수원시권선구",3780,2460,991,518,593,136,190,6,0,7,0,1,0,6,3,2451,9,1320
"5614","서둔동","서둔동제9투","대통령선거","경기도","수원시권선구",4089,2487,1036,475,593,162,199,1,0,5,0,4,0,0,2,2477,10,1602
"5615","구운동","관내사전투표","대통령선거","경기도","수원시권선구",3567,3567,1634,709,761,200,230,7,0,3,1,3,0,3,1,3552,15,0
"5616","구운동","구운동제1투","대통령선거","경기도","수원시권선구",2622,1624,644,345,401,85,126,1,1,0,0,3,0,4,3,1613,11,998
"5617","구운동","구운동제2투","대통령선거","경기도","수원시권선구",3059,2338,975,534,501,153,160,2,1,0,1,1,2,0,1,2331,7,721
"5618","구운동","구운동제3투","대통령선거","경기도","수원시권선구",2424,1574,550,404,432,75,96,2,0,3,1,1,0,0,1,1565,9,850
"5619","구운동","구운동제4투","대통령선거","경기도","수원시권선구",2904,1930,792,426,466,113,113,1,1,1,0,0,2,2,4,1921,9,974
"5620","구운동","구운동제5투","대통령선거","경기도","수원시권선구",3433,2888,1226,551,694,207,195,0,0,1,0,2,2,0,2,2880,8,545
"5621","구운동","구운동제6투","대통령선거","경기도","수원시권선구",2561,1480,590,327,362,90,107,3,0,0,0,0,0,0,0,1479,1,1081
"5622","권선1동","관내사전투표","대통령선거","경기도","수원시권선구",3012,3012,1387,549,602,225,220,5,0,2,1,3,1,0,4,2999,13,0
"5623","권선1동","권선1동제1투","대통령선거","경기도","수원시권선구",2691,1948,694,537,451,140,111,3,2,1,0,1,3,0,4,1947,1,743
"5624","권선1동","권선1동제2투","대통령선거","경기도","수원시권선구",3183,1995,869,389,447,158,122,1,0,0,2,0,0,1,0,1989,6,1188
"5625","권선1동","권선1동제3투","대통령선거","경기도","수원시권선구",3230,1855,756,388,423,137,131,3,1,0,1,1,1,0,2,1844,11,1375
"5626","권선1동","권선1동제4투","대통령선거","경기도","수원시권선구",2367,1301,419,394,312,77,87,1,2,2,0,1,1,0,2,1298,3,1066
"5627","권선1동","권선1동제5투","대통령선거","경기도","수원시권선구",2414,1414,552,346,322,83,95,2,1,3,1,3,0,1,3,1412,2,1000
"5628","권선1동","권선1동제6투","대통령선거","경기도","수원시권선구",2569,2021,844,354,505,163,132,2,1,1,0,2,1,1,4,2010,11,548
"5629","권선2동","관내사전투표","대통령선거","경기도","수원시권선구",5791,5791,2730,974,1198,436,417,2,1,7,2,1,3,0,3,5774,17,0
"5630","권선2동","권선2동제1투","대통령선거","경기도","수원시권선구",2644,2050,760,484,506,146,134,4,0,0,0,3,0,0,1,2038,12,594
"5631","권선2동","권선2동제2투","대통령선거","경기도","수원시권선구",3256,2501,877,647,565,218,174,0,0,2,0,0,0,0,6,2489,12,755
"5632","권선2동","권선2동제3투","대통령선거","경기도","수원시권선구",2165,1620,623,347,430,119,92,2,0,2,0,0,0,1,0,1616,4,545
"5633","권선2동","권선2동제4투","대통령선거","경기도","수원시권선구",2219,1558,651,315,376,105,101,4,0,1,0,1,0,2,1,1557,1,661
"5634","권선2동","권선2동제5투","대통령선거","경기도","수원시권선구",2325,1763,768,325,390,143,128,1,1,2,0,0,1,0,0,1759,4,562
"5635","권선2동","권선2동제6투","대통령선거","경기도","수원시권선구",2041,1564,704,249,361,131,103,1,0,0,2,3,2,0,2,1558,6,477
"5636","권선2동","권선2동제7투","대통령선거","경기도","수원시권선구",3021,2488,1173,422,564,191,129,0,0,1,1,0,0,1,0,2482,6,533
"5637","권선2동","권선2동제8투","대통령선거","경기도","수원시권선구",3280,2660,1135,474,650,224,156,3,0,2,1,2,0,1,4,2652,8,620
"5638","권선2동","권선2동제9투","대통령선거","경기도","수원시권선구",3030,2487,1151,460,511,223,128,2,0,2,0,3,0,0,1,2481,6,543
"5639","권선2동","권선2동제10투","대통령선거","경기도","수원시권선구",2487,2021,970,211,512,187,133,2,0,2,0,0,1,1,1,2020,1,466
"5640","권선2동","권선2동제11투","대통령선거","경기도","수원시권선구",2445,1939,910,286,449,148,137,2,0,1,0,1,0,0,1,1935,4,506
"5641","곡선동","관내사전투표","대통령선거","경기도","수원시권선구",3982,3982,2045,514,793,294,312,6,0,1,1,2,1,2,3,3974,8,0
"5642","곡선동","곡선동제1투","대통령선거","경기도","수원시권선구",1718,1285,607,189,300,106,76,1,0,0,0,0,0,1,1,1281,4,433
"5643","곡선동","곡선동제2투","대통령선거","경기도","수원시권선구",2959,2466,1041,502,562,192,158,2,0,0,0,2,1,1,0,2461,5,493
"5644","곡선동","곡선동제3투","대통령선거","경기도","수원시권선구",3615,2273,956,412,584,159,146,1,0,3,1,0,1,0,2,2265,8,1342
"5645","곡선동","곡선동제4투","대통령선거","경기도","수원시권선구",2827,2262,1115,276,527,175,158,2,0,1,1,2,2,1,1,2261,1,565
"5646","곡선동","곡선동제5투","대통령선거","경기도","수원시권선구",3241,1579,758,219,331,131,129,1,1,1,0,0,1,1,0,1573,6,1662
"5647","곡선동","곡선동제6투","대통령선거","경기도","수원시권선구",4194,2247,990,332,535,181,185,7,1,2,1,1,1,0,4,2240,7,1947
"5648","입북동","관내사전투표","대통령선거","경기도","수원시권선구",2030,2030,997,318,418,136,146,4,0,3,0,3,0,0,1,2026,4,0
"5649","입북동","입북동제1투","대통령선거","경기도","수원시권선구",2364,1758,766,316,428,124,108,3,0,2,0,1,0,1,2,1751,7,606
"5650","입북동","입북동제2투","대통령선거","경기도","수원시권선구",3211,2499,1027,489,615,174,180,4,1,1,1,0,0,0,2,2494,5,712
"5651","입북동","입북동제3투","대통령선거","경기도","수원시권선구",2540,1968,840,346,452,149,164,3,0,3,0,1,0,0,5,1963,5,572
"5652","입북동","입북동제4투","대통령선거","경기도","수원시권선구",2372,1973,953,275,436,160,143,1,0,0,0,0,0,0,1,1969,4,399
"5653","금곡동","관내사전투표","대통령선거","경기도","수원시권선구",4743,4743,2390,728,954,312,326,5,0,2,1,14,1,1,2,4736,7,0
"5654","금곡동","금곡동제1투","대통령선거","경기도","수원시권선구",1664,1197,502,248,274,79,85,3,0,1,0,1,0,1,0,1194,3,467
"5655","금곡동","금곡동제2투","대통령선거","경기도","수원시권선구",2420,1802,824,338,383,127,122,3,0,1,0,2,0,0,1,1801,1,618
"5656","금곡동","금곡동제3투","대통령선거","경기도","수원시권선구",3276,2482,1060,492,554,187,170,7,0,2,0,1,0,2,1,2476,6,794
"5657","금곡동","금곡동제4투","대통령선거","경기도","수원시권선구",2929,2317,966,521,524,159,127,5,0,2,0,3,0,1,1,2309,8,612
"5658","금곡동","금곡동제5투","대통령선거","경기도","수원시권선구",3118,2534,1070,539,558,175,171,0,0,0,0,12,0,1,0,2526,8,584
"5659","금곡동","금곡동제6투","대통령선거","경기도","수원시권선구",2212,1645,685,316,418,109,105,3,0,1,0,3,0,0,0,1640,5,567
"5660","금곡동","금곡동제7투","대통령선거","경기도","수원시권선구",2214,1678,852,228,374,108,109,1,0,0,0,3,0,0,0,1675,3,536
"5661","금곡동","금곡동제8투","대통령선거","경기도","수원시권선구",2783,2043,892,388,481,123,145,1,0,0,2,2,0,1,1,2036,7,740
"5662","호매실동","관내사전투표","대통령선거","경기도","수원시권선구",5042,5042,2599,724,980,313,391,2,0,4,0,9,0,0,2,5024,18,0
"5663","호매실동","호매실동제1투","대통령선거","경기도","수원시권선구",2931,2035,819,455,458,143,143,0,0,0,0,3,2,1,2,2026,9,896
"5664","호매실동","호매실동제2투","대통령선거","경기도","수원시권선구",3122,2386,939,401,629,203,198,1,0,1,0,3,0,0,2,2377,9,736
"5665","호매실동","호매실동제3투","대통령선거","경기도","수원시권선구",2419,1706,917,152,384,117,120,3,0,0,1,4,0,0,0,1698,8,713
"5666","호매실동","호매실동제4투","대통령선거","경기도","수원시권선구",1875,1182,510,239,259,85,76,1,0,0,1,2,1,0,1,1175,7,693
"5667","호매실동","호매실동제5투","대통령선거","경기도","수원시권선구",3185,2343,1028,385,619,158,135,2,0,3,1,3,1,0,0,2335,8,842
"5668","호매실동","호매실동제6투","대통령선거","경기도","수원시권선구",2694,1980,931,347,459,130,101,1,0,5,0,1,1,2,1,1979,1,714
"5669","잘못 투입·구분된 투표지","잘못 투입·구분된 투표지","대통령선거","경기도","수원시권선구",0,44,22,6,7,4,4,0,0,0,0,0,0,0,0,43,1,-44
"5670","거소·선상투표","거소·선상투표","대통령선거","경기도","수원시팔달구",247,233,81,31,97,6,3,1,1,2,0,0,0,0,2,224,9,14
"5671","관외사전투표","관외사전투표","대통령선거","경기도","수원시팔달구",15626,15625,7262,2403,3275,1245,1264,17,2,9,7,12,6,7,20,15529,96,1
"5672","재외투표","재외투표","대통령선거","경기도","수원시팔달구",1157,913,572,54,155,38,90,3,0,1,0,0,0,0,0,913,0,244
"5673","행궁동","관내사전투표","대통령선거","경기도","수원시팔달구",1929,1929,738,546,406,104,113,5,1,0,0,5,0,2,3,1923,6,0
"5674","행궁동","행궁동제1투","대통령선거","경기도","수원시팔달구",3358,1834,547,617,452,104,92,6,0,2,0,2,1,0,1,1824,10,1524
"5675","행궁동","행궁동제2투","대통령선거","경기도","수원시팔달구",2143,1268,386,426,316,66,58,3,1,5,0,1,0,1,0,1263,5,875
"5676","행궁동","행궁동제3투","대통령선거","경기도","수원시팔달구",2255,1273,396,417,303,67,79,1,0,2,0,3,1,0,0,1269,4,982
"5677","매교동","관내사전투표","대통령선거","경기도","수원시팔달구",1463,1463,523,460,313,65,83,3,0,1,1,5,1,3,0,1458,5,0
"5678","매교동","매교동제1투","대통령선거","경기도","수원시팔달구",2538,1364,457,427,325,64,73,1,0,1,1,3,1,0,1,1354,10,1174
"5679","매교동","매교동제2투","대통령선거","경기도","수원시팔달구",2121,1260,405,378,332,66,68,2,0,1,0,1,1,1,2,1257,3,861
"5680","매교동","매교동제3투","대통령선거","경기도","수원시팔달구",2394,1431,485,391,411,67,69,2,0,1,0,0,0,0,1,1427,4,963
"5681","매산동","관내사전투표","대통령선거","경기도","수원시팔달구",1894,1894,776,411,390,121,178,3,2,0,0,2,0,0,1,1884,10,0
"5682","매산동","매산동제1투","대통령선거","경기도","수원시팔달구",3301,1509,584,382,341,89,91,4,1,0,0,0,0,1,5,1498,11,1792
"5683","매산동","매산동제2투","대통령선거","경기도","수원시팔달구",2921,2271,777,620,572,146,147,1,0,2,0,1,0,0,2,2268,3,650
"5684","매산동","매산동제3투","대통령선거","경기도","수원시팔달구",1433,900,338,237,206,51,64,1,0,1,0,0,0,0,0,898,2,533
"5685","고등동","관내사전투표","대통령선거","경기도","수원시팔달구",1319,1319,550,323,298,53,85,0,0,3,0,3,1,0,0,1316,3,0
"5686","고등동","고등동제1투","대통령선거","경기도","수원시팔달구",2256,1080,405,284,274,53,59,1,0,1,0,0,1,0,0,1078,2,1176
"5687","고등동","고등동제2투","대통령선거","경기도","수원시팔달구",2036,1324,449,353,356,68,87,2,0,1,0,3,0,0,2,1321,3,712
"5688","고등동","고등동제3투","대통령선거","경기도","수원시팔달구",2733,1656,553,519,404,79,89,5,0,3,0,3,0,1,0,1656,0,1077
"5689","화서1동","관내사전투표","대통령선거","경기도","수원시팔달구",3074,3074,1317,652,697,173,210,6,1,1,0,2,0,1,1,3061,13,0
"5690","화서1동","화서1동제1투","대통령선거","경기도","수원시팔달구",3229,1957,702,504,478,124,134,0,0,2,1,2,2,0,1,1950,7,1272
"5691","화서1동","화서1동제2투","대통령선거","경기도","수원시팔달구",3094,1993,698,522,490,116,141,0,0,1,0,3,2,1,6,1980,13,1101
"5692","화서1동","화서1동제3투","대통령선거","경기도","수원시팔달구",3454,2249,890,548,523,128,143,1,1,2,0,1,2,2,0,2241,8,1205
"5693","화서1동","화서1동제4투","대통령선거","경기도","수원시팔달구",2574,1594,554,500,358,95,77,1,1,1,0,1,0,0,3,1591,3,980
"5694","화서1동","화서1동제5투","대통령선거","경기도","수원시팔달구",3667,2946,1303,507,710,184,214,1,1,7,0,2,1,2,5,2937,9,721
"5695","화서2동","관내사전투표","대통령선거","경기도","수원시팔달구",3827,3827,1883,575,724,328,293,7,0,2,1,5,0,0,1,3819,8,0
"5696","화서2동","화서2동제1투","대통령선거","경기도","수원시팔달구",2282,1785,677,423,432,131,110,1,0,0,0,5,0,1,1,1781,4,497
"5697","화서2동","화서2동제2투","대통령선거","경기도","수원시팔달구",2527,1881,833,390,383,149,110,1,0,0,1,2,0,1,0,1870,11,646
"5698","화서2동","화서2동제3투","대통령선거","경기도","수원시팔달구",2238,1802,784,308,442,125,123,4,0,2,0,3,0,2,2,1795,7,436
"5699","화서2동","화서2동제4투","대통령선거","경기도","수원시팔달구",3212,2501,1050,517,563,177,167,3,0,3,3,4,0,0,1,2488,13,711
"5700","화서2동","화서2동제5투","대통령선거","경기도","수원시팔달구",2582,2012,849,398,458,157,141,0,0,1,0,1,0,0,1,2006,6,570
"5701","화서2동","화서2동제6투","대통령선거","경기도","수원시팔달구",3489,2919,1391,483,598,227,203,5,0,2,0,0,0,4,2,2915,4,570
"5702","지동","관내사전투표","대통령선거","경기도","수원시팔달구",1957,1957,777,532,403,108,119,2,0,1,0,0,2,2,2,1948,9,0
"5703","지동","지동제1투","대통령선거","경기도","수원시팔달구",2753,1543,572,390,373,72,115,0,1,3,0,1,0,1,4,1532,11,1210
"5704","지동","지동제2투","대통령선거","경기도","수원시팔달구",2714,1647,486,546,408,90,90,4,1,5,3,1,1,1,3,1639,8,1067
"5705","지동","지동제3투","대통령선거","경기도","수원시팔달구",2055,1281,363,454,336,52,64,2,1,0,0,1,0,0,1,1274,7,774
"5706","지동","지동제4투","대통령선거","경기도","수원시팔달구",2235,1385,467,427,327,79,67,7,0,2,0,0,0,0,3,1379,6,850
"5707","우만1동","관내사전투표","대통령선거","경기도","수원시팔달구",2255,2255,996,464,475,149,152,4,1,3,0,2,0,1,1,2248,7,0
"5708","우만1동","우만1동제1투","대통령선거","경기도","수원시팔달구",2988,1654,634,372,391,119,127,0,0,1,0,0,1,0,1,1646,8,1334
"5709","우만1동","우만1동제2투","대통령선거","경기도","수원시팔달구",3482,2192,836,538,548,115,130,4,0,0,0,2,1,3,3,2180,12,1290
"5710","우만1동","우만1동제3투","대통령선거","경기도","수원시팔달구",2751,1869,679,447,462,126,140,0,0,1,1,2,1,2,3,1864,5,882
"5711","우만1동","우만1동제4투","대통령선거","경기도","수원시팔달구",2865,1744,675,384,424,120,123,0,0,3,1,1,1,1,0,1733,11,1121
"5712","우만1동","우만1동제5투","대통령선거","경기도","수원시팔달구",1501,963,316,302,249,46,27,3,1,2,0,1,1,3,1,952,11,538
"5713","우만1동","우만1동제6투","대통령선거","경기도","수원시팔달구",1505,1061,410,254,245,79,67,3,0,0,0,0,1,0,0,1059,2,444
"5714","우만2동","관내사전투표","대통령선거","경기도","수원시팔달구",3320,3320,1526,528,666,300,279,5,0,1,0,3,0,2,1,3311,9,0
"5715","우만2동","우만2동제1투","대통령선거","경기도","수원시팔달구",2834,1925,800,384,433,154,134,6,0,1,1,3,1,0,1,1918,7,909
"5716","우만2동","우만2동제2투","대통령선거","경기도","수원시팔달구",2535,1899,792,391,433,144,125,4,0,1,0,1,0,0,0,1891,8,636
"5717","우만2동","우만2동제3투","대통령선거","경기도","수원시팔달구",2512,2016,769,461,482,170,125,4,0,0,1,1,0,0,1,2014,2,496
"5718","우만2동","우만2동제4투","대통령선거","경기도","수원시팔달구",2386,1968,831,415,455,158,102,2,0,0,0,0,0,1,0,1964,4,418
"5719","인계동","관내사전투표","대통령선거","경기도","수원시팔달구",4126,4126,1740,951,864,247,294,7,1,3,2,2,0,0,4,4115,11,0
"5720","인계동","인계동제1투","대통령선거","경기도","수원시팔달구",3914,2071,669,596,527,140,120,5,0,1,0,1,1,0,0,2060,11,1843
"5721","인계동","인계동제2투","대통령선거","경기도","수원시팔달구",4397,2692,1035,594,648,200,194,1,0,3,1,1,3,0,5,2685,7,1705
"5722","인계동","인계동제3투","대통령선거","경기도","수원시팔달구",2912,2025,824,446,438,145,153,5,1,1,0,1,2,1,2,2019,6,887
"5723","인계동","인계동제4투","대통령선거","경기도","수원시팔달구",3089,2310,914,559,545,159,122,2,0,0,1,2,0,0,1,2305,5,779
"5724","인계동","인계동제5투","대통령선거","경기도","수원시팔달구",3551,2894,1318,502,671,217,172,7,0,0,0,0,0,0,0,2887,7,657
"5725","인계동","인계동제6투","대통령선거","경기도","수원시팔달구",3974,2246,962,383,531,173,184,3,0,1,0,0,0,1,2,2240,6,1728
"5726","인계동","인계동제7투","대통령선거","경기도","수원시팔달구",3155,1632,628,417,368,84,123,0,1,0,1,1,0,3,3,1629,3,1523
"5727","인계동","인계동제8투","대통령선거","경기도","수원시팔달구",2983,1697,580,439,444,106,109,1,0,1,0,3,0,1,3,1687,10,1286
"5728","잘못 투입·구분된 투표지","잘못 투입·구분된 투표지","대통령선거","경기도","수원시팔달구",0,0,0,0,0,0,0,0,0,0,0,0,0,0,0,0,0,0
"5729","거소·선상투표","거소·선상투표","대통령선거","경기도","수원시영통구",355,337,116,50,119,27,10,0,1,1,1,1,1,0,2,329,8,18
"5730","관외사전투표","관외사전투표","대통령선거","경기도","수원시영통구",27691,27680,13595,3461,5601,2582,2192,16,9,7,3,15,2,9,29,27521,159,11
"5731","재외투표","재외투표","대통령선거","경기도","수원시영통구",2310,1851,1152,89,280,99,221,1,0,0,0,0,0,2,1,1845,6,459
"5732","매탄1동","관내사전투표","대통령선거","경기도","수원시영통구",3658,3658,1691,667,740,265,275,3,0,2,1,0,3,0,0,3647,11,0
"5733","매탄1동","매탄1동제1투","대통령선거","경기도","수원시영통구",1675,1168,481,209,291,93,86,4,0,0,0,1,0,0,0,1165,3,507
"5734","매탄1동","매탄1동제2투","대통령선거","경기도","수원시영통구",2031,1578,598,331,395,122,120,4,0,1,1,1,2,0,0,1575,3,453
"5735","매탄1동","매탄1동제3투","대통령선거","경기도","수원시영통구",1878,1476,666,269,320,123,93,2,0,0,1,1,0,0,0,1475,1,402
"5736","매탄1동","매탄1동제4투","대통령선거","경기도","수원시영통구",2139,1701,782,300,374,147,89,0,0,0,0,1,0,1,1,1695,6,438
"5737","매탄1동","매탄1동제5투","대통령선거","경기도","수원시영통구",1928,1321,479,309,338,99,80,5,1,0,0,5,0,1,0,1317,4,607
"5738","매탄1동","매탄1동제6투","대통령선거","경기도","수원시영통구",1908,1197,439,324,269,81,76,2,0,1,0,0,0,2,0,1194,3,711
"5739","매탄2동","관내사전투표","대통령선거","경기도","수원시영통구",2283,2283,1065,430,468,153,153,1,0,0,0,3,0,1,1,2275,8,0
"5740","매탄2동","매탄2동제1투","대통령선거","경기도","수원시영통구",2788,1741,657,436,431,114,87,2,1,0,1,2,0,1,5,1737,4,1047
"5741","매탄2동","매탄2동제2투","대통령선거","경기도","수원시영통구",2746,1769,656,422,441,127,108,4,0,2,1,0,1,1,1,1764,5,977
"5742","매탄2동","매탄2동제3투","대통령선거","경기도","수원시영통구",2625,1986,781,482,457,135,118,2,0,1,1,2,1,0,2,1982,4,639
"5743","매탄2동","매탄2동제4투","대통령선거","경기도","수원시영통구",1641,1276,571,196,326,97,79,0,0,2,0,1,0,0,1,1273,3,365
"5744","매탄3동","관내사전투표","대통령선거","경기도","수원시영통구",5282,5282,2690,734,1016,426,382,3,0,6,1,4,0,1,6,5269,13,0
"5745","매탄3동","매탄3동제1투","대통령선거","경기도","수원시영통구",3616,3001,1461,461,623,250,194,1,0,1,1,2,0,0,2,2996,5,615
"5746","매탄3동","매탄3동제2투","대통령선거","경기도","수원시영통구",3194,2349,1139,360,495,190,152,2,0,3,0,1,0,0,0,2342,7,845
"5747","매탄3동","매탄3동제3투","대통령선거","경기도","수원시영통구",3103,2396,1112,388,549,189,149,2,0,1,0,0,1,0,1,2392,4,707
"5748","매탄3동","매탄3동제4투","대통령선거","경기도","수원시영통구",3006,2303,1074,401,451,195,163,3,0,4,0,4,0,1,3,2299,4,703
"5749","매탄3동","매탄3동제5투","대통령선거","경기도","수원시영통구",3080,2205,873,450,555,138,167,2,1,5,0,1,0,0,1,2193,12,875
"5750","매탄3동","매탄3동제6투","대통령선거","경기도","수원시영통구",2972,2272,903,472,544,160,175,3,0,4,0,1,0,0,3,2265,7,700
"5751","매탄3동","매탄3동제7투","대통령선거","경기도","수원시영통구",1967,1303,646,127,239,176,103,2,0,0,0,1,0,1,0,1295,8,664
"5752","매탄4동","관내사전투표","대통령선거","경기도","수원시영통구",2920,2920,1368,464,574,241,244,5,0,2,0,6,1,0,2,2907,13,0
"5753","매탄4동","매탄4동제1투","대통령선거","경기도","수원시영통구",2744,1736,705,354,414,113,132,3,1,1,0,2,1,2,2,1730,6,1008
"5754","매탄4동","매탄4동제2투","대통령선거","경기도","수원시영통구",2947,2276,1014,425,485,175,168,0,0,1,0,2,1,0,0,2271,5,671
"5755","매탄4동","매탄4동제3투","대통령선거","경기도","수원시영통구",2661,1735,676,332,450,133,130,3,0,1,1,2,1,0,0,1729,6,926
"5756","매탄4동","매탄4동제4투","대통령선거","경기도","수원시영통구",2893,2240,998,403,499,166,159,2,0,3,0,1,0,1,0,2232,8,653
"5757","매탄4동","매탄4동제5투","대통령선거","경기도","수원시영통구",3067,2268,826,525,579,165,153,4,0,4,1,3,0,0,2,2262,6,799
"5758","원천동","관내사전투표","대통령선거","경기도","수원시영통구",3651,3651,1875,503,714,296,240,2,0,1,0,5,0,2,3,3641,10,0
"5759","원천동","원천동제1투","대통령선거","경기도","수원시영통구",3462,2740,1371,376,575,194,204,3,1,0,0,2,0,1,0,2727,13,722
"5760","원천동","원천동제2투","대통령선거","경기도","수원시영통구",2406,1523,656,310,327,123,95,2,1,0,1,0,0,0,1,1516,7,883
"5761","원천동","원천동제3투","대통령선거","경기도","수원시영통구",3967,2599,1125,424,574,256,194,7,0,2,0,3,0,1,0,2586,13,1368
"5762","원천동","원천동제4투","대통령선거","경기도","수원시영통구",1951,1358,626,239,241,145,95,4,0,0,0,1,0,0,0,1351,7,593
"5763","원천동","원천동제5투","대통령선거","경기도","수원시영통구",2175,1759,885,238,396,153,80,2,0,0,0,0,0,0,0,1754,5,416
"5764","영통1동","관내사전투표","대통령선거","경기도","수원시영통구",6309,6309,3358,750,1121,550,489,7,1,2,1,5,0,2,7,6293,16,0
"5765","영통1동","영통1동제1투","대통령선거","경기도","수원시영통구",2895,2212,1107,298,473,180,141,4,0,0,1,2,0,2,1,2209,3,683
"5766","영통1동","영통1동제2투","대통령선거","경기도","수원시영통구",3422,2689,1406,344,565,198,153,10,0,1,0,1,0,0,2,2680,9,733
"5767","영통1동","영통1동제3투","대통령선거","경기도","수원시영통구",2901,2326,1107,354,503,203,151,1,0,2,0,1,0,0,1,2323,3,575
"5768","영통1동","영통1동제4투","대통령선거","경기도","수원시영통구",3271,2765,1355,404,577,246,171,4,0,1,1,0,0,0,1,2760,5,506
"5769","영통1동","영통1동제5투","대통령선거","경기도","수원시영통구",3025,2018,886,349,436,199,134,1,0,2,0,3,1,0,2,2013,5,1007
"5770","영통1동","영통1동제6투","대통령선거","경기도","수원시영통구",3892,3165,1364,575,732,295,184,1,0,2,0,1,0,1,0,3155,10,727
"5771","영통1동","영통1동제7투","대통령선거","경기도","수원시영통구",2969,2400,1159,360,507,194,171,1,0,0,2,1,0,0,0,2395,5,569
"5772","영통2동","관내사전투표","대통령선거","경기도","수원시영통구",6721,6721,3724,688,1101,614,549,2,1,1,1,3,1,5,4,6694,27,0
"5773","영통2동","영통2동제1투","대통령선거","경기도","수원시영통구",2889,2261,1207,236,476,176,158,1,0,1,0,1,0,0,0,2256,5,628
"5774","영통2동","영통2동제2투","대통령선거","경기도","수원시영통구",3377,2835,1472,318,604,234,195,5,0,0,0,0,0,0,1,2829,6,542
"5775","영통2동","영통2동제3투","대통령선거","경기도","수원시영통구",3320,2616,1383,302,485,235,199,3,0,0,0,2,2,1,0,2612,4,704
"5776","영통2동","영통2동제4투","대통령선거","경기도","수원시영통구",2668,2280,1095,381,456,195,145,1,0,0,0,0,1,0,0,2274,6,388
"5777","영통2동","영통2동제5투","대통령선거","경기도","수원시영통구",2809,2405,1167,310,573,209,134,2,1,0,0,0,0,2,0,2398,7,404
"5778","영통2동","영통2동제6투","대통령선거","경기도","수원시영통구",2337,1894,963,212,381,180,147,3,0,1,1,0,0,1,1,1890,4,443
"5779","영통2동","영통2동제7투","대통령선거","경기도","수원시영통구",2872,2263,1099,320,461,208,159,2,0,1,0,0,0,0,2,2252,11,609
"5780","영통2동","영통2동제8투","대통령선거","경기도","수원시영통구",3824,3118,1252,753,681,242,171,4,0,2,1,1,0,0,1,3108,10,706
"5781","영통2동","영통2동제9투","대통령선거","경기도","수원시영통구",1880,1569,776,217,347,121,101,1,0,0,1,0,0,0,1,1565,4,311
"5782","태장동","관내사전투표","대통령선거","경기도","수원시영통구",6895,6894,3475,998,1386,537,461,10,0,2,0,4,0,1,4,6878,16,1
"5783","태장동","태장동제1투","대통령선거","경기도","수원시영통구",2798,2120,931,411,448,169,151,1,0,4,0,0,0,1,0,2116,4,678
"5784","태장동","태장동제2투","대통령선거","경기도","수원시영통구",2083,1446,750,98,269,207,111,0,0,0,0,1,1,0,3,1440,6,637
"5785","태장동","태장동제3투","대통령선거","경기도","수원시영통구",3245,2612,1158,448,637,204,156,2,0,1,1,0,0,0,0,2607,5,633
"5786","태장동","태장동제4투","대통령선거","경기도","수원시영통구",2472,1928,835,319,463,149,153,1,0,1,0,1,0,0,1,1923,5,544
"5787","태장동","태장동제5투","대통령선거","경기도","수원시영통구",3900,3293,1772,376,665,256,210,0,0,0,0,1,1,1,2,3284,9,607
"5788","태장동","태장동제6투","대통령선거","경기도","수원시영통구",3339,2511,1095,403,623,219,164,0,0,1,0,1,0,0,1,2507,4,828
"5789","태장동","태장동제7투","대통령선거","경기도","수원시영통구",2123,1619,770,213,366,155,107,1,0,1,0,2,0,0,2,1617,2,504
"5790","태장동","태장동제8투","대통령선거","경기도","수원시영통구",3034,2248,891,470,566,179,133,3,0,0,0,0,0,0,0,2242,6,786
"5791","태장동","태장동제9투","대통령선거","경기도","수원시영통구",3428,2759,1334,400,601,249,165,2,0,0,0,0,0,0,2,2753,6,669
"5792","태장동","태장동제10투","대통령선거","경기도","수원시영통구",3460,2571,1093,443,618,237,170,0,0,0,1,1,0,0,2,2565,6,889
"5793","광교1동","관내사전투표","대통령선거","경기도","수원시영통구",6204,6204,3416,687,1140,517,431,3,1,1,0,0,0,0,0,6196,8,0
"5794","광교1동","광교1동제1투","대통령선거","경기도","수원시영통구",2380,1810,936,207,345,195,123,0,1,0,0,0,0,0,1,1808,2,570
"5795","광교1동","광교1동제2투","대통령선거","경기도","수원시영통구",2672,2275,1259,206,481,194,132,1,0,0,0,0,0,1,0,2274,1,397
"5796","광교1동","광교1동제3투","대통령선거","경기도","수원시영통구",2745,2085,906,346,534,172,119,3,1,0,0,1,0,0,1,2083,2,660
"5797","광교1동","광교1동제4투","대통령선거","경기도","수원시영통구",2710,2268,966,374,570,225,123,2,0,1,0,0,0,1,1,2263,5,442
"5798","광교1동","광교1동제5투","대통령선거","경기도","수원시영통구",3517,2898,1360,448,701,238,134,8,1,2,0,1,0,0,1,2894,4,619
"5799","광교1동","광교1동제6투","대통령선거","경기도","수원시영통구",2017,1513,768,180,309,128,122,0,0,0,0,1,0,1,0,1509,4,504
"5800","광교1동","광교1동제7투","대통령선거","경기도","수원시영통구",1606,1360,624,203,325,141,67,0,0,0,0,0,0,0,0,1360,0,246
"5801","광교1동","광교1동제8투","대통령선거","경기도","수원시영통구",2132,1709,847,214,388,145,110,3,0,0,0,0,0,0,0,1707,2,423
"5802","광교1동","광교1동제9투","대통령선거","경기도","수원시영통구",2393,2018,929,323,471,187,95,4,0,1,0,0,0,2,2,2014,4,375
"5803","광교1동","광교1동제10투","대통령선거","경기도","수원시영통구",1947,1582,728,262,327,157,105,3,0,0,0,0,0,0,0,1582,0,365
"5804","광교2동","관내사전투표","대통령선거","경기도","수원시영통구",3011,3011,1625,377,598,203,188,2,0,2,0,5,0,1,3,3004,7,0
"5805","광교2동","광교2동제1투","대통령선거","경기도","수원시영통구",2129,1656,803,292,357,123,67,8,0,2,0,0,0,0,0,1652,4,473
"5806","광교2동","광교2동제2투","대통령선거","경기도","수원시영통구",3106,2312,934,535,549,134,145,6,0,0,0,3,1,1,0,2308,4,794
"5807","광교2동","광교2동제3투","대통령선거","경기도","수원시영통구",3502,2832,1333,407,658,238,178,7,0,0,0,0,0,1,3,2825,7,670
"5808","광교2동","광교2동제4투","대통령선거","경기도","수원시영통구",2738,2166,1027,366,478,151,138,2,0,0,0,0,0,1,2,2165,1,572
"5809","광교2동","광교2동제5투","대통령선거","경기도","수원시영통구",2315,1812,980,215,369,132,109,2,0,1,0,0,1,0,0,1809,3,503
"5810","잘못 투입·구분된 투표지","잘못 투입·구분된 투표지","대통령선거","경기도","수원시영통구",0,11,4,1,1,0,1,0,0,0,0,0,0,0,0,7,4,-11
"5811","거소·선상투표","거소·선상투표","대통령선거","경기도","성남시수정구",326,300,116,49,91,15,7,2,1,1,0,0,2,0,2,286,14,26
"5812","관외사전투표","관외사전투표","대통령선거","경기도","성남시수정구",18887,18880,8991,2719,4102,1401,1475,22,4,10,3,23,9,7,27,18793,87,7
"5813","재외투표","재외투표","대통령선거","경기도","성남시수정구",1203,914,563,64,125,45,105,4,1,0,0,0,0,0,0,907,7,289
"5814","신흥1동","관내사전투표","대통령선거","경기도","성남시수정구",2360,2360,1063,386,604,100,171,11,0,5,0,10,0,0,2,2352,8,0
"5815","신흥1동","신흥1동제1투","대통령선거","경기도","성남시수정구",2904,1477,603,287,419,73,84,2,0,0,0,2,1,0,1,1472,5,1427
"5816","신흥1동","신흥1동제2투","대통령선거","경기도","성남시수정구",2280,1274,520,253,359,67,56,4,0,2,0,4,1,1,1,1268,6,1006
"5817","신흥1동","신흥1동제3투","대통령선거","경기도","성남시수정구",2118,1195,466,241,333,57,82,1,0,0,0,4,1,0,1,1186,9,923
"5818","신흥1동","신흥1동제4투","대통령선거","경기도","성남시수정구",2442,1515,589,366,384,76,84,5,0,4,0,1,0,2,0,1511,4,927
"5819","신흥2동","관내사전투표","대통령선거","경기도","성남시수정구",2424,2424,1078,434,608,136,137,5,2,6,0,8,0,3,5,2422,2,0
"5820","신흥2동","신흥2동제1투","대통령선거","경기도","성남시수정구",1916,1086,435,241,271,65,63,1,0,0,0,4,1,2,0,1083,3,830
"5821","신흥2동","신흥2동제2투","대통령선거","경기도","성남시수정구",3448,2482,964,500,693,165,145,2,0,1,0,4,0,0,0,2474,8,966
"5822","신흥2동","신흥2동제3투","대통령선거","경기도","성남시수정구",3124,1973,811,377,532,100,134,2,0,1,0,0,1,0,3,1961,12,1151
"5823","신흥2동","신흥2동제4투","대통령선거","경기도","성남시수정구",2941,1584,607,284,446,101,122,6,0,4,0,5,0,1,2,1578,6,1357
"5824","신흥2동","신흥2동제5투","대통령선거","경기도","성남시수정구",1233,767,349,122,185,57,51,0,0,1,0,1,0,0,0,766,1,466
"5825","신흥3동","관내사전투표","대통령선거","경기도","성남시수정구",2376,2376,1045,459,564,127,167,1,0,1,0,4,0,2,0,2370,6,0
"5826","신흥3동","신흥3동제1투","대통령선거","경기도","성남시수정구",2450,1330,512,273,380,76,71,2,0,2,0,3,0,1,4,1324,6,1120
"5827","신흥3동","신흥3동제2투","대통령선거","경기도","성남시수정구",2307,1372,505,296,407,80,70,1,0,2,0,1,1,2,1,1366,6,935
"5828","신흥3동","신흥3동제3투","대통령선거","경기도","성남시수정구",2685,1510,588,336,414,84,78,2,0,0,1,2,0,1,1,1507,3,1175
"5829","태평1동","관내사전투표","대통령선거","경기도","성남시수정구",3036,3036,1411,554,661,169,212,3,1,5,0,4,0,2,1,3023,13,0
"5830","태평1동","태평1동제1투","대통령선거","경기도","성남시수정구",3338,2116,902,444,516,114,127,2,0,2,0,5,0,1,1,2114,2,1222
"5831","태평1동","태평1동제2투","대통령선거","경기도","성남시수정구",2774,1794,750,359,440,96,128,2,0,1,0,1,1,1,3,1782,12,980
"5832","태평1동","태평1동제3투","대통령선거","경기도","성남시수정구",2663,1543,643,316,409,77,89,0,0,0,0,3,0,0,2,1539,4,1120
"5833","태평1동","태평1동제4투","대통령선거","경기도","성남시수정구",2412,1519,651,275,401,82,94,1,1,2,0,3,1,1,0,1512,7,893
"5834","태평2동","관내사전투표","대통령선거","경기도","성남시수정구",1844,1844,836,303,480,96,112,3,0,1,0,6,0,0,1,1838,6,0
"5835","태평2동","태평2동제1투","대통령선거","경기도","성남시수정구",2560,1414,620,280,348,68,87,2,0,1,0,2,0,0,0,1408,6,1146
"5836","태평2동","태평2동제2투","대통령선거","경기도","성남시수정구",2936,1981,835,378,534,101,116,3,0,1,0,4,0,1,0,1973,8,955
"5837","태평2동","태평2동제3투","대통령선거","경기도","성남시수정구",1591,949,387,164,279,43,67,0,0,2,0,0,1,1,0,944,5,642
"5838","태평2동","태평2동제4투","대통령선거","경기도","성남시수정구",1321,755,284,163,210,43,45,2,1,0,0,1,1,0,2,752,3,566
"5839","태평2동","태평2동제5투","대통령선거","경기도","성남시수정구",2203,1354,485,284,422,63,77,0,2,1,1,4,2,0,2,1343,11,849
"5840","태평3동","관내사전투표","대통령선거","경기도","성남시수정구",2797,2797,1222,486,702,150,207,0,0,1,0,10,0,2,5,2785,12,0
"5841","태평3동","태평3동제1투","대통령선거","경기도","성남시수정구",2362,1544,665,284,370,123,93,1,0,1,0,3,0,0,2,1542,2,818
"5842","태평3동","태평3동제2투","대통령선거","경기도","성남시수정구",2202,1327,514,279,382,51,80,6,1,4,1,1,0,0,3,1322,5,875
"5843","태평3동","태평3동제3투","대통령선거","경기도","성남시수정구",2427,1361,511,309,341,90,91,4,0,1,0,3,1,2,0,1353,8,1066
"5844","태평3동","태평3동제4투","대통령선거","경기도","성남시수정구",2425,1595,647,333,416,86,92,3,0,1,0,10,0,0,2,1590,5,830
"5845","태평4동","관내사전투표","대통령선거","경기도","성남시수정구",1566,1566,720,267,389,66,109,1,2,1,0,2,2,0,2,1561,5,0
"5846","태평4동","태평4동제1투","대통령선거","경기도","성남시수정구",2099,1294,528,256,337,90,68,1,0,1,1,2,1,3,0,1288,6,805
"5847","태평4동","태평4동제2투","대통령선거","경기도","성남시수정구",2709,1623,634,330,453,80,108,3,1,1,0,4,0,2,1,1617,6,1086
"5848","태평4동","태평4동제3투","대통령선거","경기도","성남시수정구",2249,1345,595,234,347,73,85,5,0,2,0,3,0,0,0,1344,1,904
"5849","태평4동","태평4동제4투","대통령선거","경기도","성남시수정구",2336,1611,641,331,429,85,106,2,0,1,0,3,2,0,2,1602,9,725
"5850","수진1동","관내사전투표","대통령선거","경기도","성남시수정구",2078,2078,937,387,508,87,131,3,1,3,0,8,0,3,3,2071,7,0
"5851","수진1동","수진1동제1투","대통령선거","경기도","성남시수정구",2279,1190,441,280,327,54,69,1,0,2,0,6,0,1,1,1182,8,1089
"5852","수진1동","수진1동제2투","대통령선거","경기도","성남시수정구",2566,1564,612,340,440,79,71,2,0,2,1,6,4,1,1,1559,5,1002
"5853","수진1동","수진1동제3투","대통령선거","경기도","성남시수정구",2252,1202,509,228,310,59,78,2,0,1,0,1,0,0,2,1190,12,1050
"5854","수진1동","수진1동제4투","대통령선거","경기도","성남시수정구",2269,1326,552,270,325,69,96,2,0,2,2,0,1,1,0,1320,6,943
"5855","수진2동","관내사전투표","대통령선거","경기도","성남시수정구",2808,2808,1329,518,635,130,181,3,0,0,1,5,0,0,0,2802,6,0
"5856","수진2동","수진2동제1투","대통령선거","경기도","성남시수정구",2558,1464,608,309,349,100,83,3,0,0,0,1,2,0,2,1457,7,1094
"5857","수진2동","수진2동제2투","대통령선거","경기도","성남시수정구",2464,1487,631,322,367,76,78,3,0,0,2,0,1,1,0,1481,6,977
"5858","수진2동","수진2동제3투","대통령선거","경기도","성남시수정구",1474,863,325,208,233,52,40,0,0,0,0,2,0,0,1,861,2,611
"5859","수진2동","수진2동제4투","대통령선거","경기도","성남시수정구",1760,1261,479,263,345,77,92,0,0,0,0,1,0,1,1,1259,2,499
"5860","수진2동","수진2동제5투","대통령선거","경기도","성남시수정구",2883,2238,811,520,598,157,136,3,0,3,0,3,0,0,0,2231,7,645
"5861","단대동","관내사전투표","대통령선거","경기도","성남시수정구",1879,1879,895,346,378,121,125,0,2,3,1,3,0,0,1,1875,4,0
"5862","단대동","단대동제1투","대통령선거","경기도","성남시수정구",2964,2025,808,424,522,117,141,2,1,0,0,1,1,1,2,2020,5,939
"5863","단대동","단대동제2투","대통령선거","경기도","성남시수정구",3338,2554,1100,502,622,178,134,1,0,0,2,1,2,2,2,2546,8,784
"5864","단대동","단대동제3투","대통령선거","경기도","성남시수정구",2111,1291,531,247,324,86,88,2,2,1,0,1,1,0,1,1284,7,820
"5865","단대동","단대동제4투","대통령선거","경기도","성남시수정구",1845,1214,481,275,268,76,92,3,1,0,0,3,1,2,0,1202,12,631
"5866","산성동","관내사전투표","대통령선거","경기도","성남시수정구",2342,2342,1107,424,526,105,153,4,0,3,0,5,0,2,2,2331,11,0
"5867","산성동","산성동제1투","대통령선거","경기도","성남시수정구",2315,1481,632,291,366,76,101,2,0,1,0,4,1,0,2,1476,5,834
"5868","산성동","산성동제2투","대통령선거","경기도","성남시수정구",2650,1837,835,304,455,112,116,4,0,2,0,3,0,0,1,1832,5,813
"5869","산성동","산성동제3투","대통령선거","경기도","성남시수정구",2327,1315,540,273,355,58,77,3,1,0,0,1,0,2,0,1310,5,1012
"5870","산성동","산성동제4투","대통령선거","경기도","성남시수정구",1814,1165,500,200,315,70,68,1,0,1,1,3,0,0,1,1160,5,649
"5871","양지동","관내사전투표","대통령선거","경기도","성남시수정구",2556,2555,1156,465,616,135,154,4,1,1,0,12,0,1,3,2548,7,1
"5872","양지동","양지동제1투","대통령선거","경기도","성남시수정구",2436,1607,727,273,408,83,99,1,0,1,1,5,0,1,2,1601,6,829
"5873","양지동","양지동제2투","대통령선거","경기도","성남시수정구",2126,1410,575,256,392,83,87,3,0,2,0,3,0,0,3,1404,6,716
"5874","양지동","양지동제3투","대통령선거","경기도","성남시수정구",1652,1083,419,239,286,67,63,2,0,1,0,1,0,1,1,1080,3,569
"5875","복정동","관내사전투표","대통령선거","경기도","성남시수정구",2277,2277,1213,269,408,177,190,3,0,1,0,4,0,0,2,2267,10,0
"5876","복정동","복정동제1투","대통령선거","경기도","성남시수정구",1935,1354,634,228,264,123,95,1,0,2,0,2,0,0,2,1351,3,581
"5877","복정동","복정동제2투","대통령선거","경기도","성남시수정구",288,196,53,65,56,12,6,0,1,1,0,0,0,0,0,194,2,92
"5878","복정동","복정동제3투","대통령선거","경기도","성남시수정구",2445,1809,900,249,367,142,143,0,0,0,0,0,1,0,0,1802,7,636
"5879","복정동","복정동제4투","대통령선거","경기도","성남시수정구",2475,1742,908,229,335,121,144,0,0,2,0,0,0,0,0,1739,3,733
"5880","신촌동","관내사전투표","대통령선거","경기도","성남시수정구",715,715,287,156,161,64,38,0,0,2,0,1,0,0,1,710,5,0
"5881","신촌동","신촌동투표소","대통령선거","경기도","성남시수정구",2348,1696,563,412,445,151,110,5,0,3,3,0,0,1,0,1693,3,652
"5882","고등동","관내사전투표","대통령선거","경기도","성남시수정구",337,337,109,106,82,18,19,1,0,0,0,1,0,0,0,336,1,0
"5883","고등동","고등동투표소","대통령선거","경기도","성남시수정구",1129,706,192,264,170,42,31,2,0,0,0,0,0,0,1,702,4,423
"5884","시흥동","관내사전투표","대통령선거","경기도","성남시수정구",510,510,198,157,89,28,34,0,0,0,0,1,0,0,0,507,3,0
"5885","시흥동","시흥동투표소","대통령선거","경기도","성남시수정구",2006,1400,380,542,324,91,56,1,0,1,0,1,0,0,1,1397,3,606
"5886","위례동","관내사전투표","대통령선거","경기도","성남시수정구",4156,4156,1928,719,914,329,247,2,0,2,0,4,1,2,2,4150,6,0
"5887","위례동","위례동제1투","대통령선거","경기도","성남시수정구",2305,1814,649,444,446,177,87,4,0,1,0,1,1,0,0,1810,4,491
"5888","위례동","위례동제2투","대통령선거","경기도","성남시수정구",2798,2281,880,466,576,237,108,4,0,0,0,1,0,0,1,2273,8,517
"5889","위례동","위례동제3투","대통령선거","경기도","성남시수정구",2212,1828,926,223,401,139,134,1,0,0,0,0,0,0,0,1824,4,384
"5890","위례동","위례동제4투","대통령선거","경기도","성남시수정구",2117,1701,671,317,426,177,99,4,0,0,0,2,0,0,1,1697,4,416
"5891","위례동","위례동제5투","대통령선거","경기도","성남시수정구",2031,1647,536,402,437,181,86,0,0,2,0,0,0,1,0,1645,2,384
"5892","위례동","위례동제6투","대통령선거","경기도","성남시수정구",2142,1550,524,390,452,72,88,1,0,3,1,4,2,0,5,1542,8,592
"5893","위례동","위례동제7투","대통령선거","경기도","성남시수정구",1859,1269,490,277,346,56,86,1,0,1,0,2,0,2,2,1263,6,590
"5894","잘못 투입·구분된 투표지","잘못 투입·구분된 투표지","대통령선거","경기도","성남시수정구",0,0,0,0,0,0,0,0,0,0,0,0,0,0,0,0,0,0
"5895","거소·선상투표","거소·선상투표","대통령선거","경기도","성남시중원구",354,326,145,38,94,20,15,1,2,2,1,0,1,1,0,320,6,28
"5896","관외사전투표","관외사전투표","대통령선거","경기도","성남시중원구",19170,19165,9195,2633,4313,1240,1537,16,5,13,7,48,4,6,30,19047,118,5
"5897","재외투표","재외투표","대통령선거","경기도","성남시중원구",989,762,470,67,102,23,94,2,0,0,0,0,0,0,1,759,3,227
"5898","성남동","관내사전투표","대통령선거","경기도","성남시중원구",4810,4810,2120,1046,1089,220,288,2,1,5,1,9,0,2,6,4789,21,0
"5899","성남동","성남동제1투","대통령선거","경기도","성남시중원구",3990,2235,924,450,580,120,136,5,0,1,2,6,0,0,1,2225,10,1755
"5900","성남동","성남동제2투","대통령선거","경기도","성남시중원구",3963,2635,1068,517,702,153,156,4,2,2,0,8,2,0,6,2620,15,1328
"5901","성남동","성남동제3투","대통령선거","경기도","성남시중원구",2958,2120,821,421,595,136,119,3,1,5,0,5,0,0,0,2106,14,838
"5902","성남동","성남동제4투","대통령선거","경기도","성남시중원구",2959,1951,755,421,515,113,132,0,0,1,0,3,1,1,3,1945,6,1008
"5903","성남동","성남동제5투","대통령선거","경기도","성남시중원구",3796,2157,854,486,559,120,123,2,0,4,0,1,0,1,1,2151,6,1639
"5904","성남동","성남동제6투","대통령선거","경기도","성남시중원구",1872,1075,403,237,316,58,53,0,0,2,0,0,1,0,2,1072,3,797
"5905","중앙동","관내사전투표","대통령선거","경기도","성남시중원구",2413,2413,1056,474,557,143,151,6,0,2,0,9,0,3,4,2405,8,0
"5906","중앙동","중앙동제1투","대통령선거","경기도","성남시중원구",2881,1797,700,413,463,104,104,2,1,0,0,4,0,2,0,1793,4,1084
"5907","중앙동","중앙동제2투","대통령선거","경기도","성남시중원구",2366,1447,573,301,394,63,103,2,0,0,1,2,0,0,4,1443,4,919
"5908","중앙동","중앙동제3투","대통령선거","경기도","성남시중원구",2819,1115,353,275,354,55,68,2,0,1,1,0,1,0,1,1111,4,1704
"5909","중앙동","중앙동제4투","대통령선거","경기도","성남시중원구",2881,2113,930,376,555,135,104,6,0,0,0,1,1,1,1,2110,3,768
"5910","금광1동","관내사전투표","대통령선거","경기도","성남시중원구",1483,1483,658,280,369,67,89,6,0,1,0,3,0,1,0,1474,9,0
"5911","금광1동","금광1동제1투","대통령선거","경기도","성남시중원구",1785,843,290,211,220,50,59,3,0,1,0,3,1,0,1,839,4,942
"5912","금광1동","금광1동제2투","대통령선거","경기도","성남시중원구",1839,1166,473,236,304,62,79,2,0,0,0,7,0,1,1,1165,1,673
"5913","금광1동","금광1동제3투","대통령선거","경기도","성남시중원구",1036,620,245,128,175,26,38,1,0,0,0,1,0,1,2,617,3,416
"5914","금광1동","금광1동제4투","대통령선거","경기도","성남시중원구",1144,688,249,155,207,27,42,1,0,0,1,3,0,0,1,686,2,456
"5915","금광1동","금광1동제5투","대통령선거","경기도","성남시중원구",1803,1333,591,223,311,96,99,3,0,1,2,5,0,1,0,1332,1,470
"5916","금광2동","관내사전투표","대통령선거","경기도","성남시중원구",3915,3914,1762,799,821,209,288,9,0,3,0,9,0,2,0,3902,12,1
"5917","금광2동","금광2동제1투","대통령선거","경기도","성남시중원구",2810,1628,693,328,391,107,101,0,0,1,0,3,0,1,0,1625,3,1182
"5918","금광2동","금광2동제2투","대통령선거","경기도","성남시중원구",2912,1621,706,349,349,97,101,3,0,4,0,5,1,0,0,1615,6,1291
"5919","금광2동","금광2동제3투","대통령선거","경기도","성남시중원구",2203,1443,625,265,379,63,86,2,0,1,0,11,3,0,1,1436,7,760
"5920","금광2동","금광2동제4투","대통령선거","경기도","성남시중원구",2497,1582,651,265,436,104,111,2,2,0,0,4,0,1,0,1576,6,915
"5921","금광2동","금광2동제5투","대통령선거","경기도","성남시중원구",3062,1694,644,382,432,92,117,3,0,3,1,3,1,0,0,1678,16,1368
"5922","금광2동","금광2동제6투","대통령선거","경기도","성남시중원구",3069,2230,971,430,525,153,137,4,0,1,0,3,1,1,1,2227,3,839
"5923","은행1동","관내사전투표","대통령선거","경기도","성남시중원구",2039,2039,933,344,503,89,145,2,3,2,0,3,1,2,5,2032,7,0
"5924","은행1동","은행1동제1투","대통령선거","경기도","성남시중원구",2105,1237,483,232,340,70,94,0,0,4,1,2,0,1,1,1228,9,868
"5925","은행1동","은행1동제2투","대통령선거","경기도","성남시중원구",2413,1428,634,260,340,76,103,1,1,2,0,5,0,2,2,1426,2,985
"5926","은행1동","은행1동제3투","대통령선거","경기도","성남시중원구",2381,1891,766,385,486,125,108,3,1,2,1,8,0,0,1,1886,5,490
"5927","은행2동","관내사전투표","대통령선거","경기도","성남시중원구",3644,3644,1690,696,799,208,217,4,1,4,2,10,0,1,1,3633,11,0
"5928","은행2동","은행2동제1투","대통령선거","경기도","성남시중원구",2485,1318,547,247,344,71,96,2,0,3,0,3,1,0,2,1316,2,1167
"5929","은행2동","은행2동제2투","대통령선거","경기도","성남시중원구",2192,1461,603,254,385,101,105,1,0,1,0,3,1,0,5,1459,2,731
"5930","은행2동","은행2동제3투","대통령선거","경기도","성남시중원구",2215,1560,662,268,424,99,89,3,0,1,0,4,2,2,2,1556,4,655
"5931","은행2동","은행2동제4투","대통령선거","경기도","성남시중원구",1789,1102,442,178,310,78,86,1,0,0,0,2,0,1,1,1099,3,687
"5932","은행2동","은행2동제5투","대통령선거","경기도","성남시중원구",1862,1090,435,202,310,61,70,1,0,0,0,3,0,2,1,1085,5,772
"5933","은행2동","은행2동제6투","대통령선거","경기도","성남시중원구",3328,2557,1011,505,677,176,166,7,0,3,0,1,0,0,1,2547,10,771
"5934","은행2동","은행2동제7투","대통령선거","경기도","성남시중원구",2869,1868,761,392,478,112,104,2,1,2,0,6,0,1,2,1861,7,1001
"5935","상대원1동","관내사전투표","대통령선거","경기도","성남시중원구",2737,2737,1253,513,625,140,182,5,0,3,0,5,0,2,2,2730,7,0
"5936","상대원1동","상대원1동제1투","대통령선거","경기도","성남시중원구",3910,2257,880,451,602,137,153,6,0,1,0,4,2,1,3,2240,17,1653
"5937","상대원1동","상대원1동제2투","대통령선거","경기도","성남시중원구",3511,2119,861,403,564,115,150,5,0,1,1,4,0,0,6,2110,9,1392
"5938","상대원1동","상대원1동제3투","대통령선거","경기도","성남시중원구",2165,1289,489,259,374,71,82,1,1,1,0,3,0,1,2,1284,5,876
"5939","상대원1동","상대원1동제4투","대통령선거","경기도","성남시중원구",2140,1718,784,339,402,92,88,4,0,1,0,4,0,0,2,1716,2,422
"5940","상대원1동","상대원1동제5투","대통령선거","경기도","성남시중원구",2511,1961,875,346,495,102,123,2,1,0,1,8,1,0,1,1955,6,550
"5941","상대원1동","상대원1동제6투","대통령선거","경기도","성남시중원구",1488,984,416,208,246,52,53,4,1,0,0,0,1,1,0,982,2,504
"5942","상대원1동","상대원1동제7투","대통령선거","경기도","성남시중원구",2791,1901,784,401,470,107,123,4,0,1,0,2,0,1,1,1894,7,890
"5943","상대원2동","관내사전투표","대통령선거","경기도","성남시중원구",2708,2708,1132,593,684,107,157,6,0,4,0,10,1,2,4,2700,8,0
"5944","상대원2동","상대원2동제1투","대통령선거","경기도","성남시중원구",4164,2225,866,485,619,96,133,5,0,2,0,5,1,1,2,2215,10,1939
"5945","상대원2동","상대원2동제2투","대통령선거","경기도","성남시중원구",2155,1262,478,244,351,85,93,1,0,2,0,2,0,0,0,1256,6,893
"5946","상대원2동","상대원2동제3투","대통령선거","경기도","성남시중원구",4140,2390,844,482,775,107,145,5,1,2,0,9,0,3,2,2375,15,1750
"5947","상대원3동","관내사전투표","대통령선거","경기도","성남시중원구",2121,2121,955,395,524,110,113,2,0,2,0,10,1,1,1,2114,7,0
"5948","상대원3동","상대원3동제1투","대통령선거","경기도","성남시중원구",3447,1928,729,435,526,101,110,4,0,2,0,4,3,2,3,1919,9,1519
"5949","상대원3동","상대원3동제2투","대통령선거","경기도","성남시중원구",2716,1577,638,311,431,81,96,4,0,4,1,5,0,0,1,1572,5,1139
"5950","상대원3동","상대원3동제3투","대통령선거","경기도","성남시중원구",3164,1809,697,398,481,82,120,6,1,3,2,6,1,1,3,1801,8,1355
"5951","하대원동","관내사전투표","대통령선거","경기도","성남시중원구",3293,3293,1481,655,737,194,188,2,2,3,0,10,3,1,5,3281,12,0
"5952","하대원동","하대원동제1투","대통령선거","경기도","성남시중원구",2456,1581,604,345,413,89,115,1,0,0,0,4,0,1,1,1573,8,875
"5953","하대원동","하대원동제2투","대통령선거","경기도","성남시중원구",2754,1899,760,387,489,105,144,2,0,1,0,4,0,0,1,1893,6,855
"5954","하대원동","하대원동제3투","대통령선거","경기도","성남시중원구",3318,2460,1005,486,648,161,140,1,0,2,0,7,0,0,0,2450,10,858
"5955","하대원동","하대원동제4투","대통령선거","경기도","성남시중원구",3234,2616,1012,635,653,151,146,2,0,1,0,8,1,2,0,2611,5,618
"5956","하대원동","하대원동제5투","대통령선거","경기도","성남시중원구",1791,1240,477,289,334,64,68,0,0,0,1,0,0,0,1,1234,6,551
"5957","도촌동","관내사전투표","대통령선거","경기도","성남시중원구",3494,3494,1649,612,758,234,216,4,1,0,0,9,0,1,1,3485,9,0
"5958","도촌동","도촌동제1투","대통령선거","경기도","성남시중원구",2210,1578,644,335,421,87,79,1,0,0,0,6,0,2,0,1575,3,632
"5959","도촌동","도촌동제2투","대통령선거","경기도","성남시중원구",2789,2073,877,403,499,136,138,5,2,0,1,2,0,1,1,2065,8,716
"5960","도촌동","도촌동제3투","대통령선거","경기도","성남시중원구",2926,2123,898,390,511,151,152,3,1,0,1,7,2,1,2,2119,4,803
"5961","도촌동","도촌동제4투","대통령선거","경기도","성남시중원구",3114,2492,1213,365,559,177,169,0,1,2,0,1,1,0,0,2488,4,622
"5962","도촌동","도촌동제5투","대통령선거","경기도","성남시중원구",2740,2227,1050,349,506,168,134,7,2,0,0,5,1,0,2,2224,3,513
"5963","도촌동","도촌동제6투","대통령선거","경기도","성남시중원구",1575,1178,486,213,312,78,76,0,1,0,0,5,0,0,4,1175,3,397
"5964","잘못 투입·구분된 투표지","잘못 투입·구분된 투표지","대통령선거","경기도","성남시중원구",0,0,0,0,0,0,0,0,0,0,0,0,0,0,0,0,0,0
"5965","거소·선상투표","거소·선상투표","대통령선거","경기도","성남시분당구",591,552,166,135,177,37,16,1,1,1,0,0,2,0,1,537,15,39
"5966","관외사전투표","관외사전투표","대통령선거","경기도","성남시분당구",34589,34570,15709,5523,7360,3188,2508,41,4,11,6,19,7,21,34,34431,139,19
"5967","재외투표","재외투표","대통령선거","경기도","성남시분당구",6733,5380,2951,462,1006,299,628,20,0,0,0,2,0,1,0,5369,11,1353
"5968","분당동","관내사전투표","대통령선거","경기도","성남시분당구",2933,2933,1322,579,562,273,181,1,1,3,1,2,0,3,1,2929,4,0
"5969","분당동","분당동제1투","대통령선거","경기도","성남시분당구",2820,2134,841,519,449,208,107,6,0,0,0,0,0,0,0,2130,4,686
"5970","분당동","분당동제2투","대통령선거","경기도","성남시분당구",2486,2100,918,403,449,186,138,1,0,1,0,1,0,0,0,2097,3,386
"5971","분당동","분당동제3투","대통령선거","경기도","성남시분당구",2488,1931,620,591,446,163,99,5,0,2,0,1,0,1,0,1928,3,557
"5972","분당동","분당동제4투","대통령선거","경기도","성남시분당구",2711,1912,814,392,436,134,125,7,1,0,0,0,0,0,1,1910,2,799
"5973","분당동","분당동제5투","대통령선거","경기도","성남시분당구",2889,2346,883,530,566,205,145,2,0,0,0,2,1,3,0,2337,9,543
"5974","분당동","분당동제6투","대통령선거","경기도","성남시분당구",2886,2076,860,432,467,150,152,4,0,1,0,1,0,3,0,2070,6,810
"5975","수내1동","관내사전투표","대통령선거","경기도","성남시분당구",3195,3195,1461,659,573,302,185,4,0,0,0,2,0,0,0,3186,9,0
"5976","수내1동","수내1동제1투","대통령선거","경기도","성남시분당구",2044,1553,487,432,396,158,73,2,0,0,0,0,0,0,0,1548,5,491
"5977","수내1동","수내1동제2투","대통령선거","경기도","성남시분당구",1997,1646,513,471,387,185,76,7,0,0,0,0,0,1,0,1640,6,351
"5978","수내1동","수내1동제3투","대통령선거","경기도","성남시분당구",2797,1965,826,395,418,195,113,6,0,1,0,1,0,1,1,1957,8,832
"5979","수내1동","수내1동제4투","대통령선거","경기도","성남시분당구",1534,1161,414,301,248,110,78,3,0,0,1,0,0,1,0,1156,5,373
"5980","수내1동","수내1동제5투","대통령선거","경기도","성남시분당구",2119,1686,541,470,404,187,77,1,0,0,0,0,0,0,0,1680,6,433
"5981","수내2동","관내사전투표","대통령선거","경기도","성남시분당구",1813,1813,707,380,412,188,121,0,0,0,0,0,0,0,0,1808,5,0
"5982","수내2동","수내2동제1투","대통령선거","경기도","성남시분당구",1894,1487,549,326,357,180,70,0,0,0,1,0,0,1,0,1484,3,407
"5983","수내2동","수내2동제2투","대통령선거","경기도","성남시분당구",2338,1910,680,454,451,223,96,2,0,0,0,0,0,0,1,1907,3,428
"5984","수내2동","수내2동제3투","대통령선거","경기도","성남시분당구",1418,1169,397,283,277,137,69,3,0,0,1,1,0,0,0,1168,1,249
"5985","수내3동","관내사전투표","대통령선거","경기도","성남시분당구",2378,2378,1149,368,463,222,159,4,0,1,0,2,0,1,1,2370,8,0
"5986","수내3동","수내3동제1투","대통령선거","경기도","성남시분당구",2494,2026,819,376,482,227,112,5,0,0,0,0,0,2,0,2023,3,468
"5987","수내3동","수내3동제2투","대통령선거","경기도","성남시분당구",2351,1973,758,431,450,204,119,1,1,0,0,0,0,2,0,1966,7,378
"5988","수내3동","수내3동제3투","대통령선거","경기도","성남시분당구",3065,2136,934,372,506,164,141,6,0,0,0,1,0,1,3,2128,8,929
"5989","정자1동","관내사전투표","대통령선거","경기도","성남시분당구",4624,4624,2124,880,802,450,351,8,0,0,0,1,0,1,1,4618,6,0
"5990","정자1동","정자1동제1투","대통령선거","경기도","성남시분당구",2467,1899,586,586,412,223,84,5,0,1,0,0,0,1,0,1898,1,568
"5991","정자1동","정자1동제2투","대통령선거","경기도","성남시분당구",2184,1646,520,414,412,205,89,2,0,0,0,0,0,2,0,1644,2,538
"5992","정자1동","정자1동제3투","대통령선거","경기도","성남시분당구",3506,2275,1040,336,470,249,168,4,0,1,0,0,0,0,1,2269,6,1231
"5993","정자1동","정자1동제4투","대통령선거","경기도","성남시분당구",2368,1818,393,726,447,172,70,4,0,0,1,0,0,0,0,1813,5,550
"5994","정자1동","정자1동제5투","대통령선거","경기도","성남시분당구",2510,1826,670,449,423,175,102,1,0,0,0,0,0,0,1,1821,5,684
"5995","정자1동","정자1동제6투","대통령선거","경기도","성남시분당구",3559,2822,683,1097,696,267,66,5,0,0,0,1,0,0,0,2815,7,737
"5996","정자1동","정자1동제7투","대통령선거","경기도","성남시분당구",2100,1619,350,706,360,143,46,7,0,0,1,0,0,0,0,1613,6,481
"5997","정자2동","관내사전투표","대통령선거","경기도","성남시분당구",3760,3760,1940,559,667,329,243,2,0,3,1,5,0,2,0,3751,9,0
"5998","정자2동","정자2동제1투","대통령선거","경기도","성남시분당구",1315,959,473,150,189,78,63,1,1,0,0,0,0,0,0,955,4,356
"5999","정자2동","정자2동제2투","대통령선거","경기도","성남시분당구",2039,1547,752,218,305,153,111,0,0,1,1,1,2,1,0,1545,2,492
"6000","정자2동","정자2동제3투","대통령선거","경기도","성남시분당구",2023,1346,405,386,418,49,69,3,0,0,0,2,1,3,2,1338,8,677
"6001","정자2동","정자2동제4투","대통령선거","경기도","성남시분당구",1661,1314,588,241,274,120,78,1,0,0,0,3,0,0,3,1308,6,347
"6002","정자2동","정자2동제5투","대통령선거","경기도","성남시분당구",1615,1356,563,290,277,135,82,4,0,0,1,1,0,0,0,1353,3,259
"6003","정자2동","정자2동제6투","대통령선거","경기도","성남시분당구",1920,1555,584,407,337,137,80,4,0,0,0,1,0,0,0,1550,5,365
"6004","정자3동","관내사전투표","대통령선거","경기도","성남시분당구",2655,2655,1234,507,500,238,160,6,1,0,0,2,0,0,3,2651,4,0
"6005","정자3동","정자3동제1투","대통령선거","경기도","성남시분당구",3165,2481,1042,487,565,227,147,10,0,1,0,0,0,0,0,2479,2,684
"6006","정자3동","정자3동제2투","대통령선거","경기도","성남시분당구",2569,1962,848,381,427,154,144,1,0,0,0,1,0,0,1,1957,5,607
"6007","정자3동","정자3동제3투","대통령선거","경기도","성남시분당구",3191,2569,957,620,580,257,143,3,0,1,1,0,0,0,0,2562,7,622
"6008","서현1동","관내사전투표","대통령선거","경기도","성남시분당구",5535,5535,2464,1111,1088,489,360,5,0,0,3,1,0,2,2,5525,10,0
"6009","서현1동","서현1동제1투","대통령선거","경기도","성남시분당구",3751,2470,1044,523,514,220,155,2,0,1,0,0,0,1,0,2460,10,1281
"6010","서현1동","서현1동제2투","대통령선거","경기도","성남시분당구",3331,2517,873,604,640,261,124,5,0,1,2,1,1,1,1,2514,3,814
"6011","서현1동","서현1동제3투","대통령선거","경기도","성남시분당구",3462,2835,1082,639,665,283,147,7,0,2,1,0,0,1,0,2827,8,627
"6012","서현1동","서현1동제4투","대통령선거","경기도","성남시분당구",2307,1851,577,545,451,185,86,1,0,0,0,0,0,0,0,1845,6,456
"6013","서현1동","서현1동제5투","대통령선거","경기도","성남시분당구",3377,2742,946,744,615,288,130,12,0,1,0,1,0,0,0,2737,5,635
"6014","서현1동","서현1동제6투","대통령선거","경기도","성남시분당구",1712,1294,538,284,267,102,93,2,0,1,1,0,0,2,1,1291,3,418
"6015","서현2동","관내사전투표","대통령선거","경기도","성남시분당구",3806,3806,1754,670,748,339,285,4,0,0,0,2,0,0,0,3802,4,0
"6016","서현2동","서현2동제1투","대통령선거","경기도","성남시분당구",2912,2301,785,542,565,257,142,5,0,0,0,0,0,0,0,2296,5,611
"6017","서현2동","서현2동제2투","대통령선거","경기도","성남시분당구",2596,2160,796,489,514,228,124,4,0,0,0,1,0,0,0,2156,4,436
"6018","서현2동","서현2동제3투","대통령선거","경기도","성남시분당구",2694,2173,925,380,489,212,153,5,0,1,0,0,0,0,1,2166,7,521
"6019","서현2동","서현2동제4투","대통령선거","경기도","성남시분당구",2639,2038,808,423,464,180,149,3,0,1,0,3,0,1,0,2032,6,601
"6020","이매1동","관내사전투표","대통령선거","경기도","성남시분당구",3416,3416,1453,740,689,305,212,7,1,0,0,2,0,0,1,3410,6,0
"6021","이매1동","이매1동제1투","대통령선거","경기도","성남시분당구",3405,2728,929,771,597,277,138,2,1,1,0,2,0,0,1,2719,9,677
"6022","이매1동","이매1동제2투","대통령선거","경기도","성남시분당구",2746,2310,825,545,553,240,128,4,0,1,0,3,0,2,1,2302,8,436
"6023","이매1동","이매1동제3투","대통령선거","경기도","성남시분당구",2122,1777,566,497,404,183,111,12,0,0,1,0,1,0,1,1776,1,345
"6024","이매1동","이매1동제4투","대통령선거","경기도","성남시분당구",2408,1997,788,450,433,203,112,3,0,1,1,0,0,1,0,1992,5,411
"6025","이매1동","이매1동제5투","대통령선거","경기도","성남시분당구",1957,1658,711,329,320,170,120,3,0,0,0,2,0,0,1,1656,2,299
"6026","이매1동","이매1동제6투","대통령선거","경기도","성남시분당구",2870,2108,812,455,503,192,118,9,1,1,0,2,1,1,3,2098,10,762
"6027","이매2동","관내사전투표","대통령선거","경기도","성남시분당구",2508,2508,1062,538,531,222,141,4,0,0,1,1,1,1,1,2503,5,0
"6028","이매2동","이매2동제1투","대통령선거","경기도","성남시분당구",2176,1722,563,442,438,186,85,3,0,1,0,0,0,0,1,1719,3,454
"6029","이매2동","이매2동제2투","대통령선거","경기도","성남시분당구",2765,2208,769,592,511,200,115,6,0,1,0,2,0,1,4,2201,7,557
"6030","이매2동","이매2동제3투","대통령선거","경기도","성남시분당구",3157,2564,799,796,618,230,109,4,1,0,0,1,0,0,1,2559,5,593
"6031","야탑1동","관내사전투표","대통령선거","경기도","성남시분당구",4116,4116,1969,678,816,316,309,8,1,0,0,0,1,2,3,4103,13,0
"6032","야탑1동","야탑1동제1투","대통령선거","경기도","성남시분당구",2180,1376,526,362,281,111,85,5,0,1,1,1,0,0,1,1374,2,804
"6033","야탑1동","야탑1동제2투","대통령선거","경기도","성남시분당구",2960,2368,846,603,599,195,101,6,0,1,0,4,1,2,2,2360,8,592
"6034","야탑1동","야탑1동제3투","대통령선거","경기도","성남시분당구",2247,1910,699,464,471,178,93,2,0,1,1,0,0,1,0,1910,0,337
"6035","야탑1동","야탑1동제4투","대통령선거","경기도","성남시분당구",2080,1763,760,328,432,137,93,1,0,1,0,4,0,0,1,1757,6,317
"6036","야탑1동","야탑1동제5투","대통령선거","경기도","성남시분당구",1648,1252,462,328,292,83,72,3,0,0,1,1,0,0,1,1243,9,396
"6037","야탑2동","관내사전투표","대통령선거","경기도","성남시분당구",2892,2892,1215,635,572,272,186,1,1,1,0,2,0,0,1,2886,6,0
"6038","야탑2동","야탑2동제1투","대통령선거","경기도","성남시분당구",2382,1877,595,591,433,165,79,5,0,0,0,0,0,0,2,1870,7,505
"6039","야탑2동","야탑2동제2투","대통령선거","경기도","성남시분당구",3434,2805,927,816,688,227,137,3,1,0,0,0,1,0,2,2802,3,629
"6040","야탑2동","야탑2동제3투","대통령선거","경기도","성남시분당구",2745,2213,819,588,474,208,113,4,0,2,0,0,0,0,1,2209,4,532
"6041","야탑2동","야탑2동제4투","대통령선거","경기도","성남시분당구",1879,1503,606,355,330,113,88,4,0,0,0,3,0,1,1,1501,2,376
"6042","야탑3동","관내사전투표","대통령선거","경기도","성남시분당구",3230,3230,1493,568,665,258,210,2,0,6,2,6,5,3,4,3222,8,0
"6043","야탑3동","야탑3동제1투","대통령선거","경기도","성남시분당구",3451,2366,1039,449,521,183,150,0,0,1,1,6,0,4,2,2356,10,1085
"6044","야탑3동","야탑3동제2투","대통령선거","경기도","성남시분당구",2806,2167,926,423,517,169,124,1,0,2,0,0,0,0,1,2163,4,639
"6045","야탑3동","야탑3동제3투","대통령선거","경기도","성남시분당구",2940,2389,1059,428,561,178,152,3,0,1,1,2,0,0,2,2387,2,551
"6046","야탑3동","야탑3동제4투","대통령선거","경기도","성남시분당구",2452,1546,555,354,433,96,84,2,0,1,1,2,0,1,3,1532,14,906
"6047","야탑3동","야탑3동제5투","대통령선거","경기도","성남시분당구",1981,1548,676,337,331,109,89,2,0,1,0,2,0,0,0,1547,1,433
"6048","야탑3동","야탑3동제6투","대통령선거","경기도","성남시분당구",2577,2047,832,449,508,136,113,1,0,0,0,1,0,0,3,2043,4,530
"6049","야탑3동","야탑3동제7투","대통령선거","경기도","성남시분당구",2632,2124,992,330,484,172,138,2,0,0,0,1,1,0,0,2120,4,508
"6050","금곡동","관내사전투표","대통령선거","경기도","성남시분당구",4057,4057,1898,770,761,343,268,3,0,0,1,3,0,0,0,4047,10,0
"6051","금곡동","금곡동제1투","대통령선거","경기도","성남시분당구",2623,1986,813,389,448,190,137,0,0,0,1,1,0,0,1,1980,6,637
"6052","금곡동","금곡동제2투","대통령선거","경기도","성남시분당구",2607,2137,861,460,490,205,111,2,0,1,1,0,0,0,0,2131,6,470
"6053","금곡동","금곡동제3투","대통령선거","경기도","성남시분당구",2569,1842,710,419,468,115,111,1,0,2,1,7,0,0,2,1836,6,727
"6054","금곡동","금곡동제4투","대통령선거","경기도","성남시분당구",3124,2513,833,719,617,205,119,4,0,0,1,3,0,0,1,2502,11,611
"6055","금곡동","금곡동제5투","대통령선거","경기도","성남시분당구",1749,1423,566,303,333,113,98,3,0,1,1,3,0,0,0,1421,2,326
"6056","금곡동","금곡동제6투","대통령선거","경기도","성남시분당구",3211,2380,865,570,594,208,129,4,0,0,0,1,0,0,1,2372,8,831
"6057","금곡동","금곡동제7투","대통령선거","경기도","성남시분당구",2357,1716,472,705,353,122,57,5,0,0,0,0,0,0,1,1715,1,641
"6058","구미동","관내사전투표","대통령선거","경기도","성남시분당구",3912,3912,1785,815,736,333,229,3,0,1,0,1,0,1,2,3906,6,0
"6059","구미동","구미동제1투","대통령선거","경기도","성남시분당구",2141,1848,743,402,419,183,83,8,0,2,0,2,0,0,1,1843,5,293
"6060","구미동","구미동제2투","대통령선거","경기도","성남시분당구",2678,2199,1002,382,489,185,129,4,0,1,0,1,1,0,1,2195,4,479
"6061","구미동","구미동제3투","대통령선거","경기도","성남시분당구",1466,1226,502,285,254,111,69,0,0,1,0,2,0,0,1,1225,1,240
"6062","구미동","구미동제4투","대통령선거","경기도","성남시분당구",2218,1473,310,618,328,151,58,2,0,1,0,0,0,1,0,1469,4,745
"6063","구미동","구미동제5투","대통령선거","경기도","성남시분당구",2792,2243,867,526,526,184,130,1,0,0,0,5,0,0,0,2239,4,549
"6064","구미동","구미동제6투","대통령선거","경기도","성남시분당구",2259,1761,629,480,392,159,86,8,0,1,1,0,0,0,0,1756,5,498
"6065","구미동","구미동제7투","대통령선거","경기도","성남시분당구",3326,2366,978,525,503,210,136,7,0,0,0,0,1,0,1,2361,5,960
"6066","구미동","구미동제8투","대통령선거","경기도","성남시분당구",2959,2149,846,493,530,130,118,7,0,3,0,7,0,2,1,2137,12,810
"6067","구미1동","관내사전투표","대통령선거","경기도","성남시분당구",4431,4431,2126,817,833,338,294,5,0,2,2,3,0,0,2,4422,9,0
"6068","구미1동","구미1동제1투","대통령선거","경기도","성남시분당구",3481,2386,1032,472,495,190,187,2,0,0,1,1,0,0,1,2381,5,1095
"6069","구미1동","구미1동제2투","대통령선거","경기도","성남시분당구",3309,2645,1083,558,622,226,146,1,0,0,0,1,0,0,0,2637,8,664
"6070","구미1동","구미1동제3투","대통령선거","경기도","성남시분당구",1614,1262,414,370,277,109,84,0,0,0,0,2,0,0,0,1256,6,352
"6071","구미1동","구미1동제4투","대통령선거","경기도","성남시분당구",1875,1559,693,284,362,134,80,2,2,0,0,0,0,0,0,1557,2,316
"6072","판교동","관내사전투표","대통령선거","경기도","성남시분당구",3271,3271,1577,622,619,259,185,4,0,0,0,2,0,0,0,3268,3,0
"6073","판교동","판교동제1투","대통령선거","경기도","성남시분당구",2640,2124,1049,383,387,194,104,2,0,0,1,1,0,1,1,2123,1,516
"6074","판교동","판교동제2투","대통령선거","경기도","성남시분당구",3214,2719,1169,498,628,285,124,3,0,0,2,2,0,0,2,2713,6,495
"6075","판교동","판교동제3투","대통령선거","경기도","성남시분당구",3472,2832,1120,625,660,273,135,10,0,0,0,0,0,2,0,2825,7,640
"6076","판교동","판교동제4투","대통령선거","경기도","성남시분당구",2989,2326,1118,393,505,176,124,2,0,0,1,0,0,0,3,2322,4,663
"6077","삼평동","관내사전투표","대통령선거","경기도","성남시분당구",3699,3699,1905,514,691,324,249,1,0,2,0,4,1,2,0,3693,6,0
"6078","삼평동","삼평동제1투","대통령선거","경기도","성남시분당구",3345,2661,1241,479,583,203,134,5,0,1,1,8,0,0,0,2655,6,684
"6079","삼평동","삼평동제2투","대통령선거","경기도","성남시분당구",2390,1950,915,307,430,206,84,2,1,0,0,0,1,1,1,1948,2,440
"6080","삼평동","삼평동제3투","대통령선거","경기도","성남시분당구",3474,2479,980,476,655,157,179,4,1,1,1,9,1,0,1,2465,14,995
"6081","삼평동","삼평동제4투","대통령선거","경기도","성남시분당구",4571,3732,1484,729,912,390,201,6,0,1,0,1,0,0,0,3724,8,839
"6082","백현동","관내사전투표","대통령선거","경기도","성남시분당구",4035,4035,2042,579,798,349,237,9,0,2,0,3,0,2,2,4023,12,0
"6083","백현동","백현동제1투","대통령선거","경기도","성남시분당구",3327,2802,1216,511,631,291,138,3,0,0,0,1,0,0,1,2792,10,525
"6084","백현동","백현동제2투","대통령선거","경기도","성남시분당구",2910,2336,1110,323,511,234,146,5,0,1,0,2,0,0,0,2332,4,574
"6085","백현동","백현동제3투","대통령선거","경기도","성남시분당구",2265,1834,732,379,418,202,96,3,0,0,0,1,0,0,0,1831,3,431
"6086","백현동","백현동제4투","대통령선거","경기도","성남시분당구",3060,2217,1074,348,502,145,129,3,0,2,1,1,1,0,2,2208,9,843
"6087","백현동","백현동제5투","대통령선거","경기도","성남시분당구",2772,2104,991,379,467,122,132,1,0,2,0,2,1,0,1,2098,6,668
"6088","백현동","백현동제6투","대통령선거","경기도","성남시분당구",1729,1378,394,326,398,163,92,1,0,0,0,0,0,2,0,1376,2,351
"6089","운중동","관내사전투표","대통령선거","경기도","성남시분당구",3308,3308,1531,634,611,301,213,6,1,2,0,2,0,1,1,3303,5,0
"6090","운중동","운중동제1투","대통령선거","경기도","성남시분당구",1936,1394,511,377,307,120,70,4,0,0,0,0,1,1,0,1391,3,542
"6091","운중동","운중동제2투","대통령선거","경기도","성남시분당구",2265,1759,682,421,384,176,89,1,0,0,0,0,0,0,1,1754,5,506
"6092","운중동","운중동제3투","대통령선거","경기도","성남시분당구",2537,1953,715,462,437,206,124,1,0,0,1,0,0,0,1,1947,6,584
"6093","운중동","운중동제4투","대통령선거","경기도","성남시분당구",1578,1227,582,205,284,78,72,1,0,0,0,2,0,0,1,1225,2,351
"6094","운중동","운중동제5투","대통령선거","경기도","성남시분당구",3479,2865,1115,624,666,281,166,6,0,0,0,0,0,2,0,2860,5,614
"6095","정자동","관내사전투표","대통령선거","경기도","성남시분당구",1906,1906,845,413,372,158,106,3,0,2,0,2,0,0,1,1902,4,0
"6096","정자동","정자동제1투","대통령선거","경기도","성남시분당구",2235,1636,566,424,405,144,87,4,0,0,0,1,0,0,1,1632,4,599
"6097","정자동","정자동제2투","대통령선거","경기도","성남시분당구",3112,2561,900,691,506,278,175,3,0,1,0,0,1,0,2,2557,4,551
"6098","정자동","정자동제3투","대통령선거","경기도","성남시분당구",2833,2372,1124,364,531,224,121,4,0,0,1,1,0,0,0,2370,2,461
"6099","정자동","정자동제4투","대통령선거","경기도","성남시분당구",1993,1401,641,253,277,109,106,3,0,1,0,3,0,1,0,1394,7,592
"6100","정자동","정자동제5투","대통령선거","경기도","성남시분당구",1879,1397,557,311,304,113,101,2,0,0,0,3,0,0,0,1391,6,482
"6101","잘못 투입·구분된 투표지","잘못 투입·구분된 투표지","대통령선거","경기도","성남시분당구",0,9,3,1,3,2,0,0,0,0,0,0,0,0,0,9,0,-9
"6102","거소·선상투표","거소·선상투표","대통령선거","경기도","의정부시",660,600,228,109,175,36,17,1,2,2,3,1,1,3,2,580,20,60
"6103","관외사전투표","관외사전투표","대통령선거","경기도","의정부시",26166,26145,12120,3850,5870,1882,2116,32,6,15,9,23,10,7,52,25992,153,21
"6104","재외투표","재외투표","대통령선거","경기도","의정부시",2071,1583,960,133,208,68,191,15,0,0,0,1,0,1,0,1577,6,488
"6105","의정부1동","관내사전투표","대통령선거","경기도","의정부시",2462,2462,1046,563,513,135,185,3,0,0,1,1,1,0,2,2450,12,0
"6106","의정부1동","의정부1동제1투","대통령선거","경기도","의정부시",3692,1922,631,524,505,113,129,1,0,1,0,0,0,1,3,1908,14,1770
"6107","의정부1동","의정부1동제2투","대통령선거","경기도","의정부시",3805,1820,595,513,465,96,141,2,0,0,0,1,0,2,2,1817,3,1985
"6108","의정부1동","의정부1동제3투","대통령선거","경기도","의정부시",3816,2207,804,591,519,119,147,3,3,3,0,3,2,1,1,2196,11,1609
"6109","의정부1동","의정부1동제4투","대통령선거","경기도","의정부시",3387,2135,711,652,531,97,127,6,0,1,0,0,0,0,2,2127,8,1252
"6110","의정부2동","관내사전투표","대통령선거","경기도","의정부시",3686,3686,1820,640,712,209,282,6,0,1,1,2,0,1,4,3678,8,0
"6111","의정부2동","의정부2동제1투","대통령선거","경기도","의정부시",3466,1865,707,466,463,100,109,3,0,1,0,4,0,0,2,1855,10,1601
"6112","의정부2동","의정부2동제2투","대통령선거","경기도","의정부시",3140,1835,621,521,460,104,113,0,0,2,0,0,0,4,4,1829,6,1305
"6113","의정부2동","의정부2동제3투","대통령선거","경기도","의정부시",3936,2373,949,498,601,168,139,5,0,0,0,3,1,0,1,2365,8,1563
"6114","의정부2동","의정부2동제4투","대통령선거","경기도","의정부시",2390,1370,514,280,387,76,105,0,0,0,0,0,0,1,1,1364,6,1020
"6115","의정부2동","의정부2동제5투","대통령선거","경기도","의정부시",3036,1824,718,340,520,118,115,2,0,0,0,1,1,1,2,1818,6,1212
"6116","의정부2동","의정부2동제6투","대통령선거","경기도","의정부시",3516,2328,940,478,585,159,147,7,0,0,0,2,1,0,1,2320,8,1188
"6117","의정부3동","관내사전투표","대통령선거","경기도","의정부시",2273,2273,1037,456,471,135,158,2,0,0,1,3,0,3,0,2266,7,0
"6118","의정부3동","의정부3동제1투","대통령선거","경기도","의정부시",2803,1412,522,344,350,79,98,1,0,1,1,4,2,1,2,1405,7,1391
"6119","의정부3동","의정부3동제2투","대통령선거","경기도","의정부시",3019,1608,515,477,403,87,104,1,1,3,0,1,3,3,3,1601,7,1411
"6120","의정부3동","의정부3동제3투","대통령선거","경기도","의정부시",3193,2052,773,493,507,129,140,4,0,0,0,3,0,0,1,2050,2,1141
"6121","호원1동","관내사전투표","대통령선거","경기도","의정부시",4692,4691,2198,919,932,277,336,8,0,2,1,5,0,1,3,4682,9,1
"6122","호원1동","호원1동제1투","대통령선거","경기도","의정부시",3322,2199,857,485,583,120,140,2,0,2,0,0,1,1,0,2191,8,1123
"6123","호원1동","호원1동제2투","대통령선거","경기도","의정부시",3080,2522,868,702,610,154,159,11,0,1,3,1,2,2,2,2515,7,558
"6124","호원1동","호원1동제3투","대통령선거","경기도","의정부시",2224,1371,510,335,357,77,81,0,1,1,0,0,0,4,0,1366,5,853
"6125","호원1동","호원1동제4투","대통령선거","경기도","의정부시",4131,2817,1063,674,709,157,193,5,0,1,1,1,0,1,6,2811,6,1314
"6126","호원1동","호원1동제5투","대통령선거","경기도","의정부시",2675,2120,854,458,576,108,113,3,0,0,0,1,0,1,1,2115,5,555
"6127","호원1동","호원1동제6투","대통령선거","경기도","의정부시",2462,1951,701,499,515,109,109,5,0,2,1,2,0,0,0,1943,8,511
"6128","호원1동","호원1동제7투","대통령선거","경기도","의정부시",3218,2482,967,579,636,140,155,1,0,1,0,1,0,0,0,2480,2,736
"6129","호원1동","호원1동제8투","대통령선거","경기도","의정부시",1549,1174,434,280,321,66,63,0,0,0,0,1,0,2,0,1167,7,375
"6130","호원2동","관내사전투표","대통령선거","경기도","의정부시",5721,5721,2652,1068,1205,354,398,14,0,5,0,3,0,3,5,5707,14,0
"6131","호원2동","호원2동제1투","대통령선거","경기도","의정부시",3767,2613,1023,574,668,155,172,5,0,3,1,2,0,0,3,2606,7,1154
"6132","호원2동","호원2동제2투","대통령선거","경기도","의정부시",3022,2398,917,508,638,150,160,5,0,2,1,1,0,2,3,2387,11,624
"6133","호원2동","호원2동제3투","대통령선거","경기도","의정부시",3665,2657,1028,557,690,164,197,5,0,2,0,2,3,3,0,2651,6,1008
"6134","호원2동","호원2동제4투","대통령선거","경기도","의정부시",2993,2205,900,474,533,135,148,6,1,0,0,1,0,0,1,2199,6,788
"6135","호원2동","호원2동제5투","대통령선거","경기도","의정부시",2712,2144,829,531,543,127,93,8,1,1,0,1,0,0,2,2136,8,568
"6136","호원2동","호원2동제6투","대통령선거","경기도","의정부시",2942,2182,903,469,516,144,140,5,0,1,0,1,0,2,0,2181,1,760
"6137","호원2동","호원2동제7투","대통령선거","경기도","의정부시",3313,2630,1022,597,684,181,131,1,1,0,1,0,0,0,3,2621,9,683
"6138","장암동","관내사전투표","대통령선거","경기도","의정부시",2836,2836,1360,510,566,192,179,2,2,5,0,5,1,3,2,2827,9,0
"6139","장암동","장암동제1투","대통령선거","경기도","의정부시",2685,2137,850,473,513,163,125,1,0,3,0,2,0,3,1,2134,3,548
"6140","장암동","장암동제2투","대통령선거","경기도","의정부시",2650,1710,617,421,456,98,96,3,0,3,0,0,1,2,2,1699,11,940
"6141","장암동","장암동제3투","대통령선거","경기도","의정부시",2358,1644,643,420,384,97,94,0,0,0,0,3,0,0,1,1642,2,714
"6142","장암동","장암동제4투","대통령선거","경기도","의정부시",2680,2013,752,438,537,149,127,5,0,1,1,1,0,0,1,2012,1,667
"6143","장암동","장암동제5투","대통령선거","경기도","의정부시",235,170,35,67,42,14,11,0,0,0,0,0,0,1,0,170,0,65
"6144","장암동","장암동제6투","대통령선거","경기도","의정부시",2286,1908,842,310,497,133,117,2,0,1,0,1,0,0,2,1905,3,378
"6145","신곡1동","관내사전투표","대통령선거","경기도","의정부시",4404,4404,2146,734,927,277,290,8,1,2,1,3,1,0,2,4392,12,0
"6146","신곡1동","신곡1동제1투","대통령선거","경기도","의정부시",2982,1582,533,405,433,106,82,7,1,2,0,2,1,1,1,1574,8,1400
"6147","신곡1동","신곡1동제2투","대통령선거","경기도","의정부시",2734,1911,653,535,487,127,93,3,0,2,0,1,0,0,3,1904,7,823
"6148","신곡1동","신곡1동제3투","대통령선거","경기도","의정부시",2802,1742,622,415,457,119,112,2,0,2,0,4,1,1,2,1737,5,1060
"6149","신곡1동","신곡1동제4투","대통령선거","경기도","의정부시",3066,2302,889,485,606,156,146,7,0,2,0,1,0,1,1,2294,8,764
"6150","신곡1동","신곡1동제5투","대통령선거","경기도","의정부시",3783,2816,1050,694,694,183,169,3,0,1,2,2,0,1,2,2801,15,967
"6151","신곡1동","신곡1동제6투","대통령선거","경기도","의정부시",3338,2441,1000,506,586,154,176,1,0,3,0,1,0,0,2,2429,12,897
"6152","신곡1동","신곡1동제7투","대통령선거","경기도","의정부시",2876,2298,969,430,569,146,167,0,0,4,1,0,1,1,2,2290,8,578
"6153","신곡1동","신곡1동제8투","대통령선거","경기도","의정부시",3462,2647,1153,503,631,157,189,4,0,0,1,1,1,1,1,2642,5,815
"6154","신곡1동","신곡1동제9투","대통령선거","경기도","의정부시",3373,2745,1060,650,647,177,196,5,0,0,1,3,0,0,2,2741,4,628
"6155","신곡2동","관내사전투표","대통령선거","경기도","의정부시",5874,5874,2665,1057,1311,392,391,12,1,4,0,10,2,1,10,5856,18,0
"6156","신곡2동","신곡2동제1투","대통령선거","경기도","의정부시",2707,1759,715,373,418,107,128,5,1,2,0,0,0,1,2,1752,7,948
"6157","신곡2동","신곡2동제2투","대통령선거","경기도","의정부시",2512,1885,741,395,489,128,114,4,0,1,1,3,2,0,2,1880,5,627
"6158","신곡2동","신곡2동제3투","대통령선거","경기도","의정부시",2533,1901,735,420,499,118,117,2,0,1,0,0,0,1,2,1895,6,632
"6159","신곡2동","신곡2동제4투","대통령선거","경기도","의정부시",2613,1992,833,368,478,143,162,0,0,1,0,3,0,1,0,1989,3,621
"6160","신곡2동","신곡2동제5투","대통령선거","경기도","의정부시",2912,2180,834,468,548,150,162,3,0,1,0,2,1,2,1,2172,8,732
"6161","신곡2동","신곡2동제6투","대통령선거","경기도","의정부시",2540,1908,660,494,483,132,124,5,0,3,2,1,0,0,1,1905,3,632
"6162","신곡2동","신곡2동제7투","대통령선거","경기도","의정부시",3603,2490,969,517,638,167,180,1,0,5,1,1,0,1,3,2483,7,1113
"6163","신곡2동","신곡2동제8투","대통령선거","경기도","의정부시",3018,2453,984,519,589,179,168,1,0,1,0,2,1,0,2,2446,7,565
"6164","신곡2동","신곡2동제9투","대통령선거","경기도","의정부시",2964,2328,917,507,596,173,126,3,0,1,0,0,1,0,0,2324,4,636
"6165","신곡2동","신곡2동제10투","대통령선거","경기도","의정부시",3133,2086,724,536,568,112,126,4,0,1,0,3,0,0,1,2075,11,1047
"6166","송산1동","관내사전투표","대통령선거","경기도","의정부시",3972,3971,1892,722,807,255,268,8,0,2,0,3,3,0,2,3962,9,1
"6167","송산1동","송산1동제1투","대통령선거","경기도","의정부시",2657,1933,731,423,501,134,132,2,0,0,0,4,0,1,3,1931,2,724
"6168","송산1동","송산1동제2투","대통령선거","경기도","의정부시",2304,1734,692,370,445,100,112,3,0,0,1,1,0,2,1,1727,7,570
"6169","송산1동","송산1동제3투","대통령선거","경기도","의정부시",2908,1957,765,409,536,98,126,3,0,2,0,4,2,2,3,1950,7,951
"6170","송산1동","송산1동제4투","대통령선거","경기도","의정부시",2559,1859,812,318,474,114,124,2,0,3,3,1,0,0,0,1851,8,700
"6171","송산1동","송산1동제5투","대통령선거","경기도","의정부시",2066,1295,527,301,307,71,83,0,1,2,0,1,0,0,1,1294,1,771
"6172","송산1동","송산1동제6투","대통령선거","경기도","의정부시",3469,1895,711,454,452,128,137,1,1,0,1,2,1,0,2,1890,5,1574
"6173","송산1동","송산1동제7투","대통령선거","경기도","의정부시",3870,2485,986,526,605,169,183,2,0,0,1,0,0,2,1,2475,10,1385
"6174","송산1동","송산1동제8투","대통령선거","경기도","의정부시",644,434,86,206,98,24,12,4,0,2,0,0,0,0,0,432,2,210
"6175","송산1동","송산1동제9투","대통령선거","경기도","의정부시",782,477,142,174,128,16,17,0,0,0,0,0,0,0,0,477,0,305
"6176","송산2동","관내사전투표","대통령선거","경기도","의정부시",6437,6437,3150,948,1349,473,467,7,1,1,1,7,2,4,6,6416,21,0
"6177","송산2동","송산2동제1투","대통령선거","경기도","의정부시",3429,2153,884,411,546,128,163,5,1,1,0,5,0,1,1,2146,7,1276
"6178","송산2동","송산2동제2투","대통령선거","경기도","의정부시",3814,2765,1267,442,651,203,184,3,0,3,0,0,0,0,0,2753,12,1049
"6179","송산2동","송산2동제3투","대통령선거","경기도","의정부시",5134,3906,1566,764,993,274,278,4,0,3,4,2,1,1,1,3891,15,1228
"6180","송산2동","송산2동제4투","대통령선거","경기도","의정부시",2421,1848,788,344,457,135,113,1,0,0,1,1,1,1,3,1845,3,573
"6181","송산2동","송산2동제5투","대통령선거","경기도","의정부시",2904,2033,863,356,514,135,148,5,1,1,0,2,1,2,1,2029,4,871
"6182","송산2동","송산2동제6투","대통령선거","경기도","의정부시",3248,2191,888,437,539,136,167,6,0,0,0,2,1,3,3,2182,9,1057
"6183","송산2동","송산2동제7투","대통령선거","경기도","의정부시",3583,2600,1075,479,688,189,154,2,0,1,1,2,1,1,2,2595,5,983
"6184","송산2동","송산2동제8투","대통령선거","경기도","의정부시",4856,3449,1486,625,829,254,233,3,0,0,1,2,2,1,3,3439,10,1407
"6185","송산2동","송산2동제9투","대통령선거","경기도","의정부시",4315,2998,1176,648,773,194,190,5,0,0,1,1,1,1,2,2992,6,1317
"6186","자금동","관내사전투표","대통령선거","경기도","의정부시",3037,3037,1364,552,659,230,211,2,1,1,1,4,0,3,2,3030,7,0
"6187","자금동","자금동제1투","대통령선거","경기도","의정부시",3126,1774,599,440,483,94,136,2,0,4,1,1,2,0,2,1764,10,1352
"6188","자금동","자금동제2투","대통령선거","경기도","의정부시",3286,2308,872,535,598,145,140,3,0,3,1,1,0,2,3,2303,5,978
"6189","자금동","자금동제3투","대통령선거","경기도","의정부시",2571,1619,542,461,415,99,84,3,0,2,0,0,1,1,1,1609,10,952
"6190","자금동","자금동제4투","대통령선거","경기도","의정부시",2407,1572,545,442,337,102,138,2,0,1,0,1,0,0,2,1570,2,835
"6191","자금동","자금동제5투","대통령선거","경기도","의정부시",3650,2491,959,598,612,164,136,4,0,1,0,5,2,2,0,2483,8,1159
"6192","자금동","자금동제6투","대통령선거","경기도","의정부시",4257,3326,1431,606,813,241,217,5,0,0,1,0,0,3,1,3318,8,931
"6193","가능1동","관내사전투표","대통령선거","경기도","의정부시",3363,3363,1507,715,739,176,199,7,0,3,1,1,3,1,2,3354,9,0
"6194","가능1동","가능1동제1투","대통령선거","경기도","의정부시",3071,1603,546,467,371,83,111,3,0,0,2,5,0,2,1,1591,12,1468
"6195","가능1동","가능1동제2투","대통령선거","경기도","의정부시",3348,2219,803,579,526,159,137,2,0,0,1,0,2,0,2,2211,8,1129
"6196","가능1동","가능1동제3투","대통령선거","경기도","의정부시",2407,1402,498,343,376,73,97,2,1,0,1,2,0,1,1,1395,7,1005
"6197","가능1동","가능1동제4투","대통령선거","경기도","의정부시",2111,1332,482,347,323,72,102,0,0,0,1,0,0,0,1,1328,4,779
"6198","가능1동","가능1동제5투","대통령선거","경기도","의정부시",2940,1662,549,443,443,97,106,7,0,1,1,2,2,1,4,1656,6,1278
"6199","가능1동","가능1동제6투","대통령선거","경기도","의정부시",2602,1537,551,400,396,69,103,7,0,1,0,4,0,2,0,1533,4,1065
"6200","녹양동","관내사전투표","대통령선거","경기도","의정부시",3244,3244,1499,598,681,213,233,4,0,0,0,6,1,1,1,3237,7,0
"6201","녹양동","녹양동제1투","대통령선거","경기도","의정부시",3034,1857,649,412,515,132,134,0,0,1,0,0,0,3,1,1847,10,1177
"6202","녹양동","녹양동제2투","대통령선거","경기도","의정부시",3309,2321,978,498,545,140,151,1,0,0,1,1,0,0,0,2315,6,988
"6203","녹양동","녹양동제3투","대통령선거","경기도","의정부시",2355,1401,466,376,372,83,96,0,0,2,0,0,1,0,2,1398,3,954
"6204","녹양동","녹양동제4투","대통령선거","경기도","의정부시",3321,2372,924,526,586,156,162,4,0,2,0,4,0,1,1,2366,6,949
"6205","녹양동","녹양동제5투","대통령선거","경기도","의정부시",1919,1341,504,357,307,90,75,1,0,1,0,0,0,0,3,1338,3,578
"6206","흥선동","관내사전투표","대통령선거","경기도","의정부시",2319,2319,1003,505,512,122,165,4,0,0,0,1,1,0,0,2313,6,0
"6207","흥선동","흥선동제1투","대통령선거","경기도","의정부시",1946,1136,377,329,290,52,75,2,0,0,0,2,2,1,2,1132,4,810
"6208","흥선동","흥선동제2투","대통령선거","경기도","의정부시",2420,1573,522,362,433,127,101,14,1,1,0,1,2,1,2,1567,6,847
"6209","흥선동","흥선동제3투","대통령선거","경기도","의정부시",2328,1410,547,382,327,63,82,2,0,1,0,0,1,0,0,1405,5,918
"6210","흥선동","흥선동제4투","대통령선거","경기도","의정부시",2648,1748,649,414,441,117,114,1,0,1,0,1,0,1,2,1741,7,900
"6211","흥선동","흥선동제5투","대통령선거","경기도","의정부시",2803,1219,412,345,306,73,77,1,1,1,0,0,0,0,0,1216,3,1584
"6212","흥선동","흥선동제6투","대통령선거","경기도","의정부시",2097,1256,427,351,293,74,93,2,0,1,0,1,3,1,2,1248,8,841
"6213","잘못 투입·구분된 투표지","잘못 투입·구분된 투표지","대통령선거","경기도","의정부시",0,3,0,0,2,1,0,0,0,0,0,0,0,0,0,3,0,-3
"6214","거소·선상투표","거소·선상투표","대통령선거","경기도","안양시만안구",364,336,120,61,106,21,12,0,0,0,0,1,1,2,3,327,9,28
"6215","관외사전투표","관외사전투표","대통령선거","경기도","안양시만안구",17658,17658,8374,2559,3825,1323,1357,26,6,7,4,14,11,7,30,17543,115,0
"6216","재외투표","재외투표","대통령선거","경기도","안양시만안구",1484,1136,715,62,161,49,133,10,0,0,1,0,0,0,0,1131,5,348
"6217","안양1동","관내사전투표","대통령선거","경기도","안양시만안구",2824,2824,1431,413,548,205,208,8,1,1,0,0,0,2,0,2817,7,0
"6218","안양1동","안양1동제1투","대통령선거","경기도","안양시만안구",2069,1620,651,342,393,117,109,4,0,0,0,1,1,0,1,1619,1,449
"6219","안양1동","안양1동제2투","대통령선거","경기도","안양시만안구",3660,3040,1244,585,731,264,201,8,0,0,1,0,1,0,0,3035,5,620
"6220","안양1동","안양1동제3투","대통령선거","경기도","안양시만안구",1658,1270,537,268,297,92,69,3,0,0,1,0,0,0,0,1267,3,388
"6221","안양1동","안양1동제4투","대통령선거","경기도","안양시만안구",2051,1595,589,394,391,107,102,3,0,1,1,1,0,0,2,1591,4,456
"6222","안양1동","안양1동제5투","대통령선거","경기도","안양시만안구",1288,759,278,206,185,38,47,1,1,0,1,0,1,0,0,758,1,529
"6223","안양2동","관내사전투표","대통령선거","경기도","안양시만안구",3021,3021,1368,656,628,157,193,5,0,1,0,2,1,0,3,3014,7,0
"6224","안양2동","안양2동제1투","대통령선거","경기도","안양시만안구",3577,2158,836,543,491,123,148,5,0,4,0,0,0,1,2,2153,5,1419
"6225","안양2동","안양2동제2투","대통령선거","경기도","안양시만안구",3432,2412,1027,500,529,162,171,6,0,0,0,2,1,0,3,2401,11,1020
"6226","안양2동","안양2동제3투","대통령선거","경기도","안양시만안구",2958,1901,756,469,433,98,125,1,0,4,0,1,3,0,1,1891,10,1057
"6227","안양2동","안양2동제4투","대통령선거","경기도","안양시만안구",2856,1925,698,497,480,118,114,1,2,2,1,0,2,1,3,1919,6,931
"6228","안양2동","안양2동제5투","대통령선거","경기도","안양시만안구",1926,1298,448,377,301,72,83,5,0,4,0,1,0,2,0,1293,5,628
"6229","안양3동","관내사전투표","대통령선거","경기도","안양시만안구",2932,2932,1362,574,587,181,203,9,0,1,0,4,1,1,2,2925,7,0
"6230","안양3동","안양3동제1투","대통령선거","경기도","안양시만안구",2488,1503,595,332,375,102,81,2,0,3,1,2,2,2,0,1497,6,985
"6231","안양3동","안양3동제2투","대통령선거","경기도","안양시만안구",2742,1816,744,370,444,112,130,3,0,3,0,1,0,1,2,1810,6,926
"6232","안양3동","안양3동제3투","대통령선거","경기도","안양시만안구",3451,2115,807,496,530,121,134,7,0,6,1,0,0,1,1,2104,11,1336
"6233","안양3동","안양3동제4투","대통령선거","경기도","안양시만안구",2617,2098,872,485,436,176,115,1,1,2,1,1,0,2,1,2093,5,519
"6234","안양4동","관내사전투표","대통령선거","경기도","안양시만안구",1437,1437,615,324,312,89,92,0,0,1,1,1,0,0,0,1435,2,0
"6235","안양4동","안양4동제1투","대통령선거","경기도","안양시만안구",2471,1536,571,396,376,81,98,4,1,2,1,0,0,0,1,1531,5,935
"6236","안양4동","안양4동제2투","대통령선거","경기도","안양시만안구",2319,1687,611,476,391,118,80,3,0,2,0,0,1,1,1,1684,3,632
"6237","안양5동","관내사전투표","대통령선거","경기도","안양시만안구",2227,2227,893,621,472,98,128,3,0,4,0,0,0,0,0,2219,8,0
"6238","안양5동","안양5동제1투","대통령선거","경기도","안양시만안구",3175,2139,779,552,532,136,119,1,0,3,0,4,2,1,2,2131,8,1036
"6239","안양5동","안양5동제2투","대통령선거","경기도","안양시만안구",3086,1996,672,542,475,144,156,2,0,0,0,0,0,0,0,1991,5,1090
"6240","안양5동","안양5동제3투","대통령선거","경기도","안양시만안구",2678,1567,554,437,377,90,93,2,0,1,0,0,2,1,2,1559,8,1111
"6241","안양6동","관내사전투표","대통령선거","경기도","안양시만안구",2447,2447,1056,535,544,128,165,3,0,4,0,1,1,0,1,2438,9,0
"6242","안양6동","안양6동제1투","대통령선거","경기도","안양시만안구",3821,2419,928,591,584,147,154,2,0,4,0,1,0,0,2,2413,6,1402
"6243","안양6동","안양6동제2투","대통령선거","경기도","안양시만안구",1556,1041,404,291,238,55,47,1,0,2,0,0,1,2,0,1041,0,515
"6244","안양6동","안양6동제3투","대통령선거","경기도","안양시만안구",3914,2631,1029,662,582,163,173,4,0,0,1,2,2,1,1,2620,11,1283
"6245","안양6동","안양6동제4투","대통령선거","경기도","안양시만안구",2875,1960,731,436,516,112,151,4,0,4,0,0,1,0,0,1955,5,915
"6246","안양7동","관내사전투표","대통령선거","경기도","안양시만안구",2851,2851,1377,483,573,204,199,5,0,1,1,2,0,0,0,2845,6,0
"6247","안양7동","안양7동제1투","대통령선거","경기도","안양시만안구",3576,2825,1200,517,672,220,202,3,0,2,0,0,1,0,2,2819,6,751
"6248","안양7동","안양7동제2투","대통령선거","경기도","안양시만안구",3057,2487,1128,438,572,195,142,1,1,2,0,1,0,1,1,2482,5,570
"6249","안양7동","안양7동제3투","대통령선거","경기도","안양시만안구",1960,1153,487,222,285,80,73,0,0,1,0,1,0,0,0,1149,4,807
"6250","안양8동","관내사전투표","대통령선거","경기도","안양시만안구",2536,2536,1107,547,540,144,167,1,3,2,1,7,1,2,3,2525,11,0
"6251","안양8동","안양8동제1투","대통령선거","경기도","안양시만안구",2576,1627,610,399,387,85,120,4,0,4,2,4,2,1,3,1621,6,949
"6252","안양8동","안양8동제2투","대통령선거","경기도","안양시만안구",3023,2003,801,420,483,135,140,5,0,7,1,0,2,2,1,1997,6,1020
"6253","안양8동","안양8동제3투","대통령선거","경기도","안양시만안구",2033,1329,490,318,344,81,85,1,0,4,0,1,1,0,1,1326,3,704
"6254","안양9동","관내사전투표","대통령선거","경기도","안양시만안구",2538,2538,1016,647,548,132,164,6,1,7,1,5,0,0,2,2529,9,0
"6255","안양9동","안양9동제1투","대통령선거","경기도","안양시만안구",1891,1262,444,312,339,70,85,4,0,0,0,2,2,0,1,1259,3,629
"6256","안양9동","안양9동제2투","대통령선거","경기도","안양시만안구",2739,1963,761,400,498,147,142,3,0,2,1,1,1,0,1,1957,6,776
"6257","안양9동","안양9동제3투","대통령선거","경기도","안양시만안구",2729,1718,663,369,465,98,111,0,0,2,0,1,0,1,1,1711,7,1011
"6258","안양9동","안양9동제4투","대통령선거","경기도","안양시만안구",3833,2751,1060,641,702,161,167,5,0,1,0,1,1,1,0,2740,11,1082
"6259","석수1동","관내사전투표","대통령선거","경기도","안양시만안구",3171,3171,1442,671,606,211,221,5,0,1,0,1,1,0,1,3160,11,0
"6260","석수1동","석수1동제1투","대통령선거","경기도","안양시만안구",3447,2456,967,575,581,172,141,5,0,1,0,2,0,1,3,2448,8,991
"6261","석수1동","석수1동제2투","대통령선거","경기도","안양시만안구",2735,1816,724,453,399,108,115,1,1,0,1,2,0,0,4,1808,8,919
"6262","석수1동","석수1동제3투","대통령선거","경기도","안양시만안구",2466,2071,928,395,456,154,129,0,0,0,0,5,0,1,1,2069,2,395
"6263","석수1동","석수1동제4투","대통령선거","경기도","안양시만안구",3919,3280,1331,742,782,231,180,2,0,2,0,2,0,0,1,3273,7,639
"6264","석수2동","관내사전투표","대통령선거","경기도","안양시만안구",4343,4343,2015,847,864,277,300,6,0,2,0,5,1,4,3,4324,19,0
"6265","석수2동","석수2동제1투","대통령선거","경기도","안양시만안구",1433,978,385,274,194,50,62,6,0,0,1,1,0,0,1,974,4,455
"6266","석수2동","석수2동제2투","대통령선거","경기도","안양시만안구",3293,2427,912,602,604,157,134,1,1,2,0,0,0,2,2,2417,10,866
"6267","석수2동","석수2동제3투","대통령선거","경기도","안양시만안구",2247,1539,575,364,369,124,96,2,0,0,0,1,0,0,2,1533,6,708
"6268","석수2동","석수2동제4투","대통령선거","경기도","안양시만안구",2492,1988,806,452,466,131,118,5,0,2,0,2,0,0,1,1983,5,504
"6269","석수2동","석수2동제5투","대통령선거","경기도","안양시만안구",2281,1536,569,349,399,94,105,7,0,3,0,1,0,1,0,1528,8,745
"6270","석수2동","석수2동제6투","대통령선거","경기도","안양시만안구",2660,1743,683,389,427,98,126,3,0,0,0,0,0,0,4,1730,13,917
"6271","석수2동","석수2동제7투","대통령선거","경기도","안양시만안구",3601,2876,1307,469,677,207,200,6,0,1,0,0,1,0,1,2869,7,725
"6272","석수2동","석수2동제8투","대통령선거","경기도","안양시만안구",3193,2616,1178,402,636,191,199,1,0,1,0,2,0,1,0,2611,5,577
"6273","석수3동","관내사전투표","대통령선거","경기도","안양시만안구",2180,2180,1003,375,486,105,186,0,1,2,0,2,1,2,4,2167,13,0
"6274","석수3동","석수3동제1투","대통령선거","경기도","안양시만안구",3111,2044,836,440,484,136,130,0,0,4,1,0,1,1,1,2034,10,1067
"6275","석수3동","석수3동제2투","대통령선거","경기도","안양시만안구",2871,2219,973,417,542,146,125,3,0,0,1,1,1,0,4,2213,6,652
"6276","석수3동","석수3동제3투","대통령선거","경기도","안양시만안구",2989,2004,809,417,510,115,136,2,0,2,0,0,0,0,3,1994,10,985
"6277","박달1동","관내사전투표","대통령선거","경기도","안양시만안구",2730,2730,1186,565,616,164,181,2,2,1,0,3,2,2,1,2725,5,0
"6278","박달1동","박달1동제1투","대통령선거","경기도","안양시만안구",3202,1935,772,423,467,97,149,6,0,3,1,2,0,0,2,1922,13,1267
"6279","박달1동","박달1동제2투","대통령선거","경기도","안양시만안구",2358,1497,552,388,368,93,82,1,0,2,0,1,1,1,1,1490,7,861
"6280","박달1동","박달1동제3투","대통령선거","경기도","안양시만안구",2373,1440,548,328,374,80,95,0,0,0,1,1,1,1,3,1432,8,933
"6281","박달1동","박달1동제4투","대통령선거","경기도","안양시만안구",2965,2202,929,445,539,135,138,4,0,4,0,1,0,0,1,2196,6,763
"6282","박달2동","관내사전투표","대통령선거","경기도","안양시만안구",2907,2907,1332,524,622,210,208,1,0,0,1,3,1,2,0,2904,3,0
"6283","박달2동","박달2동제1투","대통령선거","경기도","안양시만안구",2564,1720,700,368,403,128,107,4,0,3,1,1,1,0,0,1716,4,844
"6284","박달2동","박달2동제2투","대통령선거","경기도","안양시만안구",2246,1831,725,392,445,128,122,6,1,4,0,1,0,0,2,1826,5,415
"6285","박달2동","박달2동제3투","대통령선거","경기도","안양시만안구",2838,2195,884,425,538,180,161,0,0,0,0,0,0,0,1,2189,6,643
"6286","박달2동","박달2동제4투","대통령선거","경기도","안양시만안구",3141,2308,984,426,571,141,169,2,0,4,0,1,1,0,1,2300,8,833
"6287","박달2동","박달2동제5투","대통령선거","경기도","안양시만안구",2872,2396,960,507,568,176,172,1,0,4,1,2,0,0,1,2392,4,476
"6288","잘못 투입·구분된 투표지","잘못 투입·구분된 투표지","대통령선거","경기도","안양시만안구",0,0,0,0,0,0,0,0,0,0,0,0,0,0,0,0,0,0
"6289","거소·선상투표","거소·선상투표","대통령선거","경기도","안양시동안구",455,428,143,79,149,29,18,2,0,1,0,0,0,1,1,423,5,27
"6290","관외사전투표","관외사전투표","대통령선거","경기도","안양시동안구",23805,23805,11429,3339,5103,1954,1745,29,6,11,4,21,13,6,20,23680,125,0
"6291","재외투표","재외투표","대통령선거","경기도","안양시동안구",2660,2112,1245,127,348,106,268,12,0,1,0,1,0,0,0,2108,4,548
"6292","비산1동","관내사전투표","대통령선거","경기도","안양시동안구",3160,3160,1380,642,642,249,226,3,0,0,0,1,1,1,1,3146,14,0
"6293","비산1동","비산1동제1투","대통령선거","경기도","안양시동안구",1832,1054,419,254,238,59,66,1,1,0,1,0,2,1,0,1042,12,778
"6294","비산1동","비산1동제2투","대통령선거","경기도","안양시동안구",2233,1561,677,344,355,89,89,2,0,1,0,0,0,0,1,1558,3,672
"6295","비산1동","비산1동제3투","대통령선거","경기도","안양시동안구",3600,2936,1307,564,682,179,186,1,0,3,0,1,0,1,3,2927,9,664
"6296","비산1동","비산1동제4투","대통령선거","경기도","안양시동안구",3240,2696,936,708,646,254,139,2,1,0,0,0,2,0,0,2688,8,544
"6297","비산1동","비산1동제5투","대통령선거","경기도","안양시동안구",2187,1835,701,396,463,155,113,2,0,0,0,1,1,0,1,1833,2,352
"6298","비산1동","비산1동제6투","대통령선거","경기도","안양시동안구",2120,1783,779,373,370,151,102,0,1,1,0,0,0,0,1,1778,5,337
"6299","비산2동","관내사전투표","대통령선거","경기도","안양시동안구",2225,2225,971,445,523,151,118,4,0,2,0,1,0,0,0,2215,10,0
"6300","비산2동","비산2동제1투","대통령선거","경기도","안양시동안구",2115,1483,557,359,365,108,82,5,0,2,0,0,0,0,0,1478,5,632
"6301","비산2동","비산2동제2투","대통령선거","경기도","안양시동안구",3153,2493,1038,502,560,201,172,4,1,2,1,0,1,1,1,2484,9,660
"6302","비산2동","비산2동제3투","대통령선거","경기도","안양시동안구",2833,2315,881,522,537,199,165,1,0,1,0,2,0,0,2,2310,5,518
"6303","비산3동","관내사전투표","대통령선거","경기도","안양시동안구",3718,3718,1607,806,795,249,244,3,1,0,0,2,0,0,2,3709,9,0
"6304","비산3동","비산3동제1투","대통령선거","경기도","안양시동안구",2574,1921,788,409,420,173,113,5,0,1,1,1,1,0,1,1913,8,653
"6305","비산3동","비산3동제2투","대통령선거","경기도","안양시동안구",2387,1810,658,434,459,130,118,4,0,0,0,0,0,2,0,1805,5,577
"6306","비산3동","비산3동제3투","대통령선거","경기도","안양시동안구",2667,1703,654,363,445,92,135,1,0,2,0,1,1,1,1,1696,7,964
"6307","비산3동","비산3동제4투","대통령선거","경기도","안양시동안구",2286,1607,615,358,422,98,106,2,0,0,0,1,1,0,0,1603,4,679
"6308","비산3동","비산3동제5투","대통령선거","경기도","안양시동안구",2506,1821,733,399,427,158,91,0,0,2,0,1,0,0,0,1811,10,685
"6309","비산3동","비산3동제6투","대통령선거","경기도","안양시동안구",2699,1915,761,421,451,133,128,0,0,3,1,1,0,1,2,1902,13,784
"6310","부흥동","관내사전투표","대통령선거","경기도","안양시동안구",3060,3060,1501,484,635,222,201,5,0,3,0,2,0,0,3,3056,4,0
"6311","부흥동","부흥동제1투","대통령선거","경기도","안양시동안구",1772,1332,576,255,310,104,83,1,0,1,0,1,0,0,0,1331,1,440
"6312","부흥동","부흥동제2투","대통령선거","경기도","안양시동안구",1842,1514,670,264,363,128,84,2,0,0,0,1,0,0,0,1512,2,328
"6313","부흥동","부흥동제3투","대통령선거","경기도","안양시동안구",1688,1202,450,268,312,83,77,4,0,2,0,0,0,1,0,1197,5,486
"6314","부흥동","부흥동제4투","대통령선거","경기도","안양시동안구",2721,2268,1070,424,461,150,158,1,0,0,0,0,0,0,0,2264,4,453
"6315","부흥동","부흥동제5투","대통령선거","경기도","안양시동안구",2009,1692,776,292,367,130,119,0,0,1,1,0,0,1,0,1687,5,317
"6316","달안동","관내사전투표","대통령선거","경기도","안양시동안구",2487,2487,1307,336,474,183,175,3,0,3,1,0,2,0,0,2484,3,0
"6317","달안동","달안동제1투","대통령선거","경기도","안양시동안구",2526,1825,809,301,425,141,135,3,0,1,1,0,0,2,0,1818,7,701
"6318","달안동","달안동제2투","대통령선거","경기도","안양시동안구",2219,1599,755,287,314,113,124,0,0,0,0,1,0,0,0,1594,5,620
"6319","달안동","달안동제3투","대통령선거","경기도","안양시동안구",2414,1935,912,324,427,130,124,6,0,3,0,2,0,0,0,1928,7,479
"6320","관양1동","관내사전투표","대통령선거","경기도","안양시동안구",4776,4777,2293,799,1020,301,331,10,0,2,0,2,0,1,5,4764,13,-1
"6321","관양1동","관양1동제1투","대통령선거","경기도","안양시동안구",2996,2022,812,414,490,140,144,6,0,0,1,2,1,1,1,2012,10,974
"6322","관양1동","관양1동제2투","대통령선거","경기도","안양시동안구",3487,2646,950,715,589,217,154,5,0,3,0,1,0,1,0,2635,11,841
"6323","관양1동","관양1동제3투","대통령선거","경기도","안양시동안구",3077,2158,821,525,524,131,135,5,0,4,0,2,0,0,4,2151,7,919
"6324","관양1동","관양1동제4투","대통령선거","경기도","안양시동안구",2830,1927,721,449,467,124,145,2,0,4,1,3,0,0,2,1918,9,903
"6325","관양1동","관양1동제5투","대통령선거","경기도","안양시동안구",2847,2054,925,368,470,143,134,4,0,0,1,2,0,0,1,2048,6,793
"6326","관양1동","관양1동제6투","대통령선거","경기도","안양시동안구",2654,1911,782,402,456,124,123,9,0,1,0,0,0,2,2,1901,10,743
"6327","관양1동","관양1동제7투","대통령선거","경기도","안양시동안구",3270,2576,1018,541,621,186,191,0,0,0,1,2,2,2,2,2566,10,694
"6328","관양1동","관양1동제8투","대통령선거","경기도","안양시동안구",3319,2532,1089,488,601,166,174,1,0,1,0,1,2,1,2,2526,6,787
"6329","관양2동","관내사전투표","대통령선거","경기도","안양시동안구",2575,2575,1234,421,554,176,173,3,0,1,1,3,1,1,1,2569,6,0
"6330","관양2동","관양2동제1투","대통령선거","경기도","안양시동안구",2357,1553,657,328,361,86,110,2,0,0,0,0,2,0,1,1547,6,804
"6331","관양2동","관양2동제2투","대통령선거","경기도","안양시동안구",2536,1611,691,347,360,109,92,4,1,1,1,0,0,0,0,1606,5,925
"6332","관양2동","관양2동제3투","대통령선거","경기도","안양시동안구",1657,1006,426,239,217,58,61,2,1,0,0,0,0,0,1,1005,1,651
"6333","관양2동","관양2동제4투","대통령선거","경기도","안양시동안구",2980,2356,934,539,573,175,120,6,0,0,0,0,0,3,1,2351,5,624
"6334","관양2동","관양2동제5투","대통령선거","경기도","안양시동안구",2791,2499,1149,344,636,210,152,3,1,1,0,0,0,0,0,2496,3,292
"6335","부림동","관내사전투표","대통령선거","경기도","안양시동안구",4706,4705,2549,595,836,372,337,1,1,1,1,2,0,0,0,4695,10,1
"6336","부림동","부림동제1투","대통령선거","경기도","안양시동안구",2794,2070,1015,343,441,133,125,2,0,1,0,1,0,0,2,2063,7,724
"6337","부림동","부림동제2투","대통령선거","경기도","안양시동안구",2502,2019,953,321,440,171,126,0,0,1,1,1,0,0,0,2014,5,483
"6338","부림동","부림동제3투","대통령선거","경기도","안양시동안구",2792,2282,982,451,521,152,156,4,0,1,0,7,0,1,0,2275,7,510
"6339","부림동","부림동제4투","대통령선거","경기도","안양시동안구",2670,2152,1093,277,490,145,139,3,0,0,0,0,1,0,1,2149,3,518
"6340","부림동","부림동제5투","대통령선거","경기도","안양시동안구",3717,2724,1293,445,604,180,182,8,1,0,2,0,0,0,1,2716,8,993
"6341","평촌동","관내사전투표","대통령선거","경기도","안양시동안구",3340,3340,1621,513,749,213,222,1,2,1,0,1,0,1,5,3329,11,0
"6342","평촌동","평촌동제1투","대통령선거","경기도","안양시동안구",2665,2156,945,392,486,174,149,0,0,1,0,0,2,2,1,2152,4,509
"6343","평촌동","평촌동제2투","대통령선거","경기도","안양시동안구",2650,2075,867,449,468,151,124,5,0,1,0,1,0,0,2,2068,7,575
"6344","평촌동","평촌동제3투","대통령선거","경기도","안양시동안구",3105,2565,1163,420,561,241,171,4,0,1,0,1,0,0,0,2562,3,540
"6345","평안동","관내사전투표","대통령선거","경기도","안양시동안구",3838,3838,1977,510,752,315,273,0,0,2,0,1,0,0,1,3831,7,0
"6346","평안동","평안동제1투","대통령선거","경기도","안양시동안구",2258,1743,799,292,380,118,145,1,0,2,1,0,1,0,0,1739,4,515
"6347","평안동","평안동제2투","대통령선거","경기도","안양시동안구",2699,2246,981,418,515,183,140,3,0,0,1,2,0,0,0,2243,3,453
"6348","평안동","평안동제3투","대통령선거","경기도","안양시동안구",2324,1863,903,279,392,146,137,3,0,1,0,0,0,0,1,1862,1,461
"6349","평안동","평안동제4투","대통령선거","경기도","안양시동안구",2444,2055,1015,289,431,193,116,0,1,0,0,1,1,0,0,2047,8,389
"6350","평안동","평안동제5투","대통령선거","경기도","안양시동안구",3306,2896,1461,393,626,237,175,0,0,0,0,1,0,1,1,2895,1,410
"6351","귀인동","관내사전투표","대통령선거","경기도","안양시동안구",2371,2371,1101,412,484,200,166,2,0,0,0,0,0,0,0,2365,6,0
"6352","귀인동","귀인동제1투","대통령선거","경기도","안양시동안구",2709,2218,856,491,526,225,110,0,0,0,0,3,1,1,2,2215,3,491
"6353","귀인동","귀인동제2투","대통령선거","경기도","안양시동안구",3151,2650,1088,528,652,227,147,4,0,0,1,0,1,0,0,2648,2,501
"6354","귀인동","귀인동제3투","대통령선거","경기도","안양시동안구",3133,2566,1161,357,646,213,178,2,0,0,0,1,1,1,0,2560,6,567
"6355","호계1동","관내사전투표","대통령선거","경기도","안양시동안구",1978,1978,864,430,436,95,133,3,0,2,0,2,0,2,4,1971,7,0
"6356","호계1동","호계1동제1투","대통령선거","경기도","안양시동안구",1796,1053,403,253,246,82,65,0,1,0,0,0,0,0,2,1052,1,743
"6357","호계1동","호계1동제2투","대통령선거","경기도","안양시동안구",2471,1740,677,383,435,137,95,3,0,1,0,4,1,0,2,1738,2,731
"6358","호계1동","호계1동제3투","대통령선거","경기도","안양시동안구",1184,809,308,167,199,76,57,0,0,0,0,0,0,0,1,808,1,375
"6359","호계1동","호계1동제4투","대통령선거","경기도","안양시동안구",1271,817,306,194,229,42,42,3,0,0,0,0,0,0,0,816,1,454
"6360","호계2동","관내사전투표","대통령선거","경기도","안양시동안구",2912,2912,1271,547,658,207,202,7,1,3,1,0,0,0,2,2899,13,0
"6361","호계2동","호계2동제1투","대통령선거","경기도","안양시동안구",3436,2390,889,553,593,160,168,5,1,6,0,1,3,1,2,2382,8,1046
"6362","호계2동","호계2동제2투","대통령선거","경기도","안양시동안구",2629,2082,704,488,593,152,130,7,0,1,0,0,0,1,0,2076,6,547
"6363","호계2동","호계2동제3투","대통령선거","경기도","안양시동안구",3160,2487,1047,511,578,168,166,0,0,4,0,0,0,1,2,2477,10,673
"6364","호계2동","호계2동제4투","대통령선거","경기도","안양시동안구",3340,2638,1013,666,599,219,125,0,0,11,0,0,1,0,0,2634,4,702
"6365","호계2동","호계2동제5투","대통령선거","경기도","안양시동안구",3026,2498,1111,454,528,198,194,4,0,1,0,0,0,0,1,2491,7,528
"6366","호계3동","관내사전투표","대통령선거","경기도","안양시동안구",4001,4001,1719,743,935,308,274,2,0,6,1,2,0,2,1,3993,8,0
"6367","호계3동","호계3동제1투","대통령선거","경기도","안양시동안구",3126,2260,912,508,512,182,136,2,0,0,0,0,0,1,1,2254,6,866
"6368","호계3동","호계3동제2투","대통령선거","경기도","안양시동안구",3616,2374,892,567,585,153,158,1,1,1,1,0,0,0,4,2363,11,1242
"6369","호계3동","호계3동제3투","대통령선거","경기도","안양시동안구",2324,1750,717,364,399,132,129,2,1,0,0,2,1,0,0,1747,3,574
"6370","호계3동","호계3동제4투","대통령선거","경기도","안양시동안구",2354,1842,746,376,431,163,111,4,0,2,1,2,0,1,0,1837,5,512
"6371","호계3동","호계3동제5투","대통령선거","경기도","안양시동안구",3101,2455,962,498,609,216,161,1,1,1,0,0,0,0,0,2449,6,646
"6372","범계동","관내사전투표","대통령선거","경기도","안양시동안구",3722,3722,1796,529,727,344,307,4,0,1,0,2,0,0,3,3713,9,0
"6373","범계동","범계동제1투","대통령선거","경기도","안양시동안구",2441,1870,819,368,409,161,102,1,0,0,0,1,0,2,0,1863,7,571
"6374","범계동","범계동제2투","대통령선거","경기도","안양시동안구",2132,1663,832,237,362,136,88,2,0,0,0,0,1,0,1,1659,4,469
"6375","범계동","범계동제3투","대통령선거","경기도","안양시동안구",2213,1875,671,486,440,172,100,2,0,1,0,1,0,0,0,1873,2,338
"6376","범계동","범계동제4투","대통령선거","경기도","안양시동안구",2010,1717,629,393,441,149,99,1,0,0,0,1,0,1,1,1715,2,293
"6377","신촌동","관내사전투표","대통령선거","경기도","안양시동안구",2748,2748,1328,441,578,206,181,9,0,0,0,3,0,0,1,2747,1,0
"6378","신촌동","신촌동제1투","대통령선거","경기도","안양시동안구",3033,2450,1055,420,585,215,167,3,0,0,0,1,0,0,0,2446,4,583
"6379","신촌동","신촌동제2투","대통령선거","경기도","안양시동안구",3014,2395,1076,443,505,184,168,6,0,1,1,1,0,0,0,2385,10,619
"6380","신촌동","신촌동제3투","대통령선거","경기도","안양시동안구",1304,1091,425,255,261,82,65,0,0,2,0,0,0,0,1,1091,0,213
"6381","갈산동","관내사전투표","대통령선거","경기도","안양시동안구",1860,1860,769,418,395,151,120,0,0,2,0,1,0,0,0,1856,4,0
"6382","갈산동","갈산동제1투","대통령선거","경기도","안양시동안구",2754,2189,707,542,589,207,127,6,0,1,1,2,0,1,2,2185,4,565
"6383","갈산동","갈산동제2투","대통령선거","경기도","안양시동안구",1826,1508,571,400,315,138,75,4,0,1,0,0,0,0,1,1505,3,318
"6384","갈산동","갈산동제3투","대통령선거","경기도","안양시동안구",2075,1468,629,265,367,106,88,3,1,3,0,1,0,0,0,1463,5,607
"6385","잘못 투입·구분된 투표지","잘못 투입·구분된 투표지","대통령선거","경기도","안양시동안구",0,0,0,0,0,0,0,0,0,0,0,0,0,0,0,0,0,0
"6386","거소·선상투표","거소·선상투표","대통령선거","경기도","부천시",1165,1125,392,186,386,76,34,3,4,1,3,2,2,2,7,1098,27,40
"6387","관외사전투표","관외사전투표","대통령선거","경기도","부천시",51722,51684,24969,6833,11427,3763,4120,52,21,22,15,35,31,21,77,51386,298,38
"6388","재외투표","재외투표","대통령선거","경기도","부천시",4272,3359,2080,237,473,125,417,14,0,1,0,2,0,1,1,3351,8,913
"6389","심곡2동","관내사전투표","대통령선거","경기도","부천시",3144,3144,1496,530,653,186,249,4,1,4,0,0,2,2,2,3129,15,0
"6390","심곡2동","심곡2동제1투","대통령선거","경기도","부천시",4127,2374,1010,475,599,112,163,1,1,1,1,2,2,1,1,2369,5,1753
"6391","심곡2동","심곡2동제2투","대통령선거","경기도","부천시",4407,2530,1087,486,618,152,165,4,0,1,2,2,0,0,0,2517,13,1877
"6392","심곡2동","심곡2동제3투","대통령선거","경기도","부천시",3999,2143,905,406,571,105,133,4,1,2,1,4,0,0,5,2137,6,1856
"6393","심곡1동","관내사전투표","대통령선거","경기도","부천시",2309,2309,1136,342,509,123,178,5,0,2,1,2,0,0,1,2299,10,0
"6394","심곡1동","심곡1동제1투","대통령선거","경기도","부천시",3555,2147,841,499,517,113,164,5,0,1,0,2,0,2,1,2145,2,1408
"6395","심곡1동","심곡1동제2투","대통령선거","경기도","부천시",2707,1791,727,341,487,93,118,6,0,3,0,3,0,1,4,1783,8,916
"6396","심곡1동","심곡1동제3투","대통령선거","경기도","부천시",2850,1533,607,321,415,94,90,1,0,2,0,0,0,1,1,1532,1,1317
"6397","심곡3동","관내사전투표","대통령선거","경기도","부천시",1956,1956,924,349,437,101,129,5,0,3,1,1,0,0,1,1951,5,0
"6398","심곡3동","심곡3동제1투","대통령선거","경기도","부천시",3305,1958,706,454,514,132,129,1,0,2,0,4,0,1,5,1948,10,1347
"6399","심곡3동","심곡3동제2투","대통령선거","경기도","부천시",2558,1515,599,303,393,89,121,3,1,0,0,1,0,1,1,1512,3,1043
"6400","심곡3동","심곡3동제3투","대통령선거","경기도","부천시",3073,2068,858,419,524,121,128,2,0,1,0,4,0,0,3,2060,8,1005
"6401","원미2동","관내사전투표","대통령선거","경기도","부천시",2088,2088,899,438,518,94,125,2,0,1,0,2,1,2,1,2083,5,0
"6402","원미2동","원미2동제1투","대통령선거","경기도","부천시",3242,1855,720,389,528,86,104,2,0,1,0,3,1,1,1,1836,19,1387
"6403","원미2동","원미2동제2투","대통령선거","경기도","부천시",3466,2449,974,524,654,135,142,5,0,2,0,3,0,1,1,2441,8,1017
"6404","원미2동","원미2동제3투","대통령선거","경기도","부천시",2655,1636,609,356,457,83,117,3,0,0,0,0,1,2,1,1629,7,1019
"6405","소사동","관내사전투표","대통령선거","경기도","부천시",1672,1672,808,340,329,87,95,3,0,1,0,1,0,2,1,1667,5,0
"6406","소사동","소사동제1투","대통령선거","경기도","부천시",3119,1910,778,407,512,92,105,4,1,3,1,1,1,0,1,1906,4,1209
"6407","소사동","소사동제2투","대통령선거","경기도","부천시",2921,1855,708,453,460,101,118,1,1,1,0,3,1,1,0,1848,7,1066
"6408","원미1동","관내사전투표","대통령선거","경기도","부천시",3400,3400,1535,668,756,166,245,6,0,2,0,2,1,2,3,3386,14,0
"6409","원미1동","원미1동제1투","대통령선거","경기도","부천시",3533,2171,852,477,581,105,140,2,0,1,0,1,1,0,2,2162,9,1362
"6410","원미1동","원미1동제2투","대통령선거","경기도","부천시",3646,2290,957,456,563,138,153,2,2,2,1,6,2,0,0,2282,8,1356
"6411","원미1동","원미1동제3투","대통령선거","경기도","부천시",2395,1887,787,391,445,122,133,0,0,0,2,0,0,0,0,1880,7,508
"6412","원미1동","원미1동제4투","대통령선거","경기도","부천시",1878,1189,443,286,318,54,78,1,1,1,1,0,1,0,0,1184,5,689
"6413","역곡1동","관내사전투표","대통령선거","경기도","부천시",3595,3595,1773,594,743,206,262,2,0,1,1,3,0,2,3,3590,5,0
"6414","역곡1동","역곡1동제1투","대통령선거","경기도","부천시",3829,2613,1121,547,664,123,148,0,0,1,0,0,1,1,2,2608,5,1216
"6415","역곡1동","역곡1동제2투","대통령선거","경기도","부천시",3178,2283,971,473,536,139,148,3,0,4,0,1,1,0,2,2278,5,895
"6416","역곡1동","역곡1동제3투","대통령선거","경기도","부천시",2116,1577,685,324,371,86,98,3,0,1,0,2,1,1,1,1573,4,539
"6417","역곡1동","역곡1동제4투","대통령선거","경기도","부천시",2494,1871,787,374,489,115,94,1,1,0,0,2,1,0,1,1865,6,623
"6418","역곡2동","관내사전투표","대통령선거","경기도","부천시",4035,4035,1956,596,897,234,323,5,0,1,3,3,1,1,2,4022,13,0
"6419","역곡2동","역곡2동제1투","대통령선거","경기도","부천시",3940,2650,1130,496,638,186,167,10,2,2,1,3,1,0,4,2640,10,1290
"6420","역곡2동","역곡2동제2투","대통령선거","경기도","부천시",4230,3131,1366,585,778,196,179,11,0,1,1,1,1,0,2,3121,10,1099
"6421","역곡2동","역곡2동제3투","대통령선거","경기도","부천시",3651,2377,1023,428,576,170,162,3,0,0,1,5,1,0,0,2369,8,1274
"6422","춘의동","관내사전투표","대통령선거","경기도","부천시",2148,2148,1033,361,458,117,160,3,0,4,1,2,0,0,0,2139,9,0
"6423","춘의동","춘의동제1투","대통령선거","경기도","부천시",3279,2122,902,424,502,143,135,0,1,2,0,0,3,0,1,2113,9,1157
"6424","춘의동","춘의동제2투","대통령선거","경기도","부천시",2398,1612,605,395,442,59,88,2,1,1,0,1,0,3,3,1600,12,786
"6425","춘의동","춘의동제3투","대통령선거","경기도","부천시",4283,2915,1228,575,723,170,203,2,0,1,1,0,1,0,3,2907,8,1368
"6426","도당동","관내사전투표","대통령선거","경기도","부천시",2693,2693,1310,394,615,158,197,2,0,0,1,5,0,0,1,2683,10,0
"6427","도당동","도당동제1투","대통령선거","경기도","부천시",4822,3166,1308,578,839,192,213,4,0,4,0,4,0,1,2,3145,21,1656
"6428","도당동","도당동제2투","대통령선거","경기도","부천시",3216,2213,916,456,535,139,151,2,0,2,0,1,1,0,1,2204,9,1003
"6429","도당동","도당동제3투","대통령선거","경기도","부천시",3318,2242,956,443,543,105,172,4,1,3,0,0,2,3,1,2233,9,1076
"6430","도당동","도당동제4투","대통령선거","경기도","부천시",2889,1825,657,478,487,89,97,2,0,2,0,2,1,2,1,1818,7,1064
"6431","도당동","도당동제5투","대통령선거","경기도","부천시",1939,1126,418,283,307,51,58,1,1,0,0,1,0,0,1,1121,5,813
"6432","중동","관내사전투표","대통령선거","경기도","부천시",2880,2880,1379,515,611,165,187,2,0,5,2,2,0,4,2,2874,6,0
"6433","중동","중동제1투","대통령선거","경기도","부천시",3270,1962,747,466,488,114,129,5,1,1,0,0,2,1,4,1958,4,1308
"6434","중동","중동제2투","대통령선거","경기도","부천시",2725,2095,969,354,467,161,131,3,0,0,0,2,1,1,0,2089,6,630
"6435","중동","중동제3투","대통령선거","경기도","부천시",3243,2226,880,460,573,136,148,3,0,4,0,1,0,1,5,2211,15,1017
"6436","중동","중동제4투","대통령선거","경기도","부천시",2736,1754,678,366,454,114,125,4,0,3,1,0,1,1,2,1749,5,982
"6437","중동","중동제5투","대통령선거","경기도","부천시",3356,2685,1202,520,584,201,166,1,0,1,2,0,0,0,1,2678,7,671
"6438","상동","관내사전투표","대통령선거","경기도","부천시",3836,3836,1766,679,814,252,295,7,0,1,3,4,0,1,1,3823,13,0
"6439","상동","상동제1투","대통령선거","경기도","부천시",2963,2205,847,508,556,144,135,5,1,1,2,1,1,0,0,2201,4,758
"6440","상동","상동제2투","대통령선거","경기도","부천시",3660,2597,1043,555,606,214,165,4,0,1,0,1,0,1,1,2591,6,1063
"6441","상동","상동제3투","대통령선거","경기도","부천시",2801,1859,767,390,449,103,131,2,0,1,1,2,3,1,4,1854,5,942
"6442","상동","상동제4투","대통령선거","경기도","부천시",3389,2231,907,487,541,117,154,2,0,3,1,0,1,1,0,2214,17,1158
"6443","상1동","관내사전투표","대통령선거","경기도","부천시",5310,5310,2873,697,980,373,346,11,1,3,1,0,1,3,2,5291,19,0
"6444","상1동","상1동제1투","대통령선거","경기도","부천시",3517,2777,1325,434,637,188,176,2,0,2,1,0,1,1,1,2768,9,740
"6445","상1동","상1동제2투","대통령선거","경기도","부천시",4111,2993,1412,498,651,210,207,2,0,1,0,1,0,0,0,2982,11,1118
"6446","상1동","상1동제3투","대통령선거","경기도","부천시",3152,2495,1178,416,574,144,165,4,0,0,3,0,0,1,0,2485,10,657
"6447","상1동","상1동제4투","대통령선거","경기도","부천시",3569,2717,1290,423,646,178,161,5,0,2,1,1,0,2,0,2709,8,852
"6448","중4동","관내사전투표","대통령선거","경기도","부천시",4353,4353,2218,686,839,267,306,2,3,1,1,5,2,1,3,4334,19,0
"6449","중4동","중4동제1투","대통령선거","경기도","부천시",3774,3005,1172,724,701,211,181,5,0,3,1,0,0,0,0,2998,7,769
"6450","중4동","중4동제2투","대통령선거","경기도","부천시",2565,1650,798,271,365,119,85,1,0,1,0,1,1,1,2,1645,5,915
"6451","중4동","중4동제3투","대통령선거","경기도","부천시",3105,2339,1122,329,532,155,185,0,0,1,1,3,0,1,1,2330,9,766
"6452","중4동","중4동제4투","대통령선거","경기도","부천시",2687,2066,924,318,477,157,179,1,0,0,2,1,0,1,1,2061,5,621
"6453","약대동","관내사전투표","대통령선거","경기도","부천시",3637,3637,1728,600,796,220,267,5,0,1,0,4,0,2,2,3625,12,0
"6454","약대동","약대동제1투","대통령선거","경기도","부천시",3939,2628,1065,506,660,171,200,7,0,2,3,1,0,2,3,2620,8,1311
"6455","약대동","약대동제2투","대통령선거","경기도","부천시",3833,2755,1142,525,719,186,163,1,0,5,1,2,1,2,2,2749,6,1078
"6456","약대동","약대동제3투","대통령선거","경기도","부천시",3715,2708,1153,503,634,241,165,3,0,0,1,1,1,0,0,2702,6,1007
"6457","중1동","관내사전투표","대통령선거","경기도","부천시",5302,5302,2631,797,1116,347,388,4,0,1,0,6,0,1,3,5294,8,0
"6458","중1동","중1동제1투","대통령선거","경기도","부천시",2870,1930,869,339,467,118,116,3,0,2,1,4,0,2,1,1922,8,940
"6459","중1동","중1동제2투","대통령선거","경기도","부천시",2976,2338,1072,370,585,161,144,1,0,3,0,0,0,1,0,2337,1,638
"6460","중1동","중1동제3투","대통령선거","경기도","부천시",4235,2569,1231,413,535,168,197,7,0,2,0,3,2,2,3,2563,6,1666
"6461","중1동","중1동제4투","대통령선거","경기도","부천시",1963,1635,705,370,380,89,81,2,0,0,0,2,0,0,1,1630,5,328
"6462","중1동","중1동제5투","대통령선거","경기도","부천시",2499,2008,807,408,505,144,129,4,0,2,0,1,2,0,1,2003,5,491
"6463","중1동","중1동제6투","대통령선거","경기도","부천시",2850,1947,886,333,455,132,127,1,0,2,0,4,0,1,1,1942,5,903
"6464","중1동","중1동제7투","대통령선거","경기도","부천시",3785,3082,1427,530,740,204,168,0,0,2,1,3,0,0,2,3077,5,703
"6465","중2동","관내사전투표","대통령선거","경기도","부천시",3001,3001,1397,520,643,215,200,3,1,5,0,3,0,2,2,2991,10,0
"6466","중2동","중2동제1투","대통령선거","경기도","부천시",3582,2497,1003,523,639,141,173,1,0,2,0,3,0,0,2,2487,10,1085
"6467","중2동","중2동제2투","대통령선거","경기도","부천시",2250,1793,631,458,463,148,86,2,0,0,0,1,0,0,1,1790,3,457
"6468","중2동","중2동제3투","대통령선거","경기도","부천시",2926,2162,891,456,532,130,138,2,1,1,1,2,1,3,1,2159,3,764
"6469","중2동","중2동제4투","대통령선거","경기도","부천시",4905,3803,1499,874,928,257,228,1,1,0,1,1,0,1,1,3792,11,1102
"6470","중2동","중2동제5투","대통령선거","경기도","부천시",3127,2385,961,469,630,172,142,7,0,0,0,0,1,0,1,2383,2,742
"6471","중2동","중2동제6투","대통령선거","경기도","부천시",2997,2290,907,535,558,167,102,5,0,1,2,2,0,1,1,2281,9,707
"6472","중3동","관내사전투표","대통령선거","경기도","부천시",3973,3973,1864,664,862,288,275,4,0,1,1,3,1,0,2,3965,8,0
"6473","중3동","중3동제1투","대통령선거","경기도","부천시",3678,2650,1168,497,626,189,160,2,0,2,0,0,0,1,0,2645,5,1028
"6474","중3동","중3동제2투","대통령선거","경기도","부천시",3243,2553,969,638,621,162,146,7,0,0,1,0,0,1,3,2548,5,690
"6475","중3동","중3동제3투","대통령선거","경기도","부천시",3044,2200,1021,396,484,140,143,0,0,0,1,4,1,3,3,2196,4,844
"6476","중3동","중3동제4투","대통령선거","경기도","부천시",3597,2873,1359,451,688,170,192,4,0,0,1,0,0,0,0,2865,8,724
"6477","중3동","중3동제5투","대통령선거","경기도","부천시",2453,1594,637,331,408,95,105,0,1,1,2,1,1,0,2,1584,10,859
"6478","상2동","관내사전투표","대통령선거","경기도","부천시",4846,4846,2501,665,935,360,361,7,0,1,1,2,1,0,2,4836,10,0
"6479","상2동","상2동제1투","대통령선거","경기도","부천시",1973,1506,665,269,367,103,95,5,0,1,0,0,0,0,0,1505,1,467
"6480","상2동","상2동제2투","대통령선거","경기도","부천시",3688,2869,1344,485,650,193,188,2,0,0,0,1,1,0,0,2864,5,819
"6481","상2동","상2동제3투","대통령선거","경기도","부천시",3983,2935,1312,475,728,236,176,2,0,1,0,1,0,2,1,2934,1,1048
"6482","상2동","상2동제4투","대통령선거","경기도","부천시",3267,2662,1226,391,658,197,167,3,1,2,0,3,0,0,1,2649,13,605
"6483","상2동","상2동제5투","대통령선거","경기도","부천시",3697,2888,1586,332,608,186,161,2,0,0,0,1,1,0,1,2878,10,809
"6484","상3동","관내사전투표","대통령선거","경기도","부천시",5483,5483,2745,769,1143,417,370,8,0,3,1,3,0,2,7,5468,15,0
"6485","상3동","상3동제1투","대통령선거","경기도","부천시",3828,2815,1235,492,678,231,163,6,0,0,0,2,0,0,0,2807,8,1013
"6486","상3동","상3동제2투","대통령선거","경기도","부천시",3792,3030,1436,460,688,220,213,2,0,0,1,2,1,0,0,3023,7,762
"6487","상3동","상3동제3투","대통령선거","경기도","부천시",3563,2793,1118,555,695,253,159,3,0,1,0,0,2,0,2,2788,5,770
"6488","상3동","상3동제4투","대통령선거","경기도","부천시",3527,2899,1149,644,679,252,163,5,0,2,0,1,0,0,3,2898,1,628
"6489","상3동","상3동제5투","대통령선거","경기도","부천시",3602,2909,1350,477,705,188,172,4,1,0,2,0,1,0,1,2901,8,693
"6490","심곡본동","관내사전투표","대통령선거","경기도","부천시",2528,2528,1102,575,537,121,172,4,0,6,0,0,0,1,2,2520,8,0
"6491","심곡본동","심곡본동제1투","대통령선거","경기도","부천시",2753,1642,615,372,456,71,115,2,0,2,1,1,0,1,3,1639,3,1111
"6492","심곡본동","심곡본동제2투","대통령선거","경기도","부천시",3063,1830,688,457,480,79,96,3,1,4,0,2,0,1,2,1813,17,1233
"6493","심곡본동","심곡본동제3투","대통령선거","경기도","부천시",2935,1776,704,388,451,98,123,0,0,2,0,0,0,1,1,1768,8,1159
"6494","심곡본동","심곡본동제4투","대통령선거","경기도","부천시",3093,2283,891,530,583,128,136,0,1,1,1,2,1,1,1,2276,7,810
"6495","심곡본1동","관내사전투표","대통령선거","경기도","부천시",3193,3193,1451,654,693,148,218,4,0,1,0,1,1,1,5,3177,16,0
"6496","심곡본1동","심곡본1동제1투","대통령선거","경기도","부천시",3609,2043,808,488,529,75,106,7,1,7,0,1,2,3,4,2031,12,1566
"6497","심곡본1동","심곡본1동제2투","대통령선거","경기도","부천시",3178,2162,864,482,542,127,126,9,0,0,0,1,0,0,0,2151,11,1016
"6498","심곡본1동","심곡본1동제3투","대통령선거","경기도","부천시",3246,1966,774,422,487,118,146,5,0,4,0,0,0,1,1,1958,8,1280
"6499","심곡본1동","심곡본1동제4투","대통령선거","경기도","부천시",2336,1431,548,302,381,88,98,5,0,1,1,0,0,0,2,1426,5,905
"6500","송내1동","관내사전투표","대통령선거","경기도","부천시",3086,3086,1516,491,685,179,195,3,1,1,0,1,1,2,2,3077,9,0
"6501","송내1동","송내1동제1투","대통령선거","경기도","부천시",3698,2473,1083,456,588,181,154,2,0,1,1,1,0,1,0,2468,5,1225
"6502","송내1동","송내1동제2투","대통령선거","경기도","부천시",2177,1579,673,324,410,62,95,3,2,0,0,0,1,1,1,1572,7,598
"6503","송내1동","송내1동제3투","대통령선거","경기도","부천시",2225,1800,730,360,475,113,115,1,0,2,0,0,0,1,0,1797,3,425
"6504","송내1동","송내1동제4투","대통령선거","경기도","부천시",3046,2431,1064,505,538,173,135,2,1,1,0,0,0,0,2,2421,10,615
"6505","송내1동","송내1동제5투","대통령선거","경기도","부천시",1966,1477,663,323,301,94,84,0,0,1,2,2,0,2,0,1472,5,489
"6506","송내1동","송내1동제6투","대통령선거","경기도","부천시",1837,1301,518,273,355,67,77,2,0,1,0,2,0,0,0,1295,6,536
"6507","송내2동","관내사전투표","대통령선거","경기도","부천시",3810,3810,1850,579,809,266,288,2,0,3,2,0,1,0,4,3804,6,0
"6508","송내2동","송내2동제1투","대통령선거","경기도","부천시",3124,2081,857,430,529,110,142,2,0,1,0,0,0,0,0,2071,10,1043
"6509","송내2동","송내2동제2투","대통령선거","경기도","부천시",2926,1880,709,431,482,111,132,1,0,0,0,4,1,1,1,1873,7,1046
"6510","송내2동","송내2동제3투","대통령선거","경기도","부천시",3338,2519,1106,480,558,180,173,5,0,2,2,2,2,0,2,2512,7,819
"6511","송내2동","송내2동제4투","대통령선거","경기도","부천시",3589,2628,1085,508,642,179,195,4,0,3,2,2,0,1,2,2623,5,961
"6512","송내2동","송내2동제5투","대통령선거","경기도","부천시",2616,1892,744,429,439,114,146,3,0,0,0,1,1,0,3,1880,12,724
"6513","송내2동","송내2동제6투","대통령선거","경기도","부천시",2027,1745,773,282,406,184,93,1,0,0,0,0,0,0,3,1742,3,282
"6514","소사본동","관내사전투표","대통령선거","경기도","부천시",3185,3185,1344,728,712,157,214,8,1,6,2,1,0,1,0,3174,11,0
"6515","소사본동","소사본동제1투","대통령선거","경기도","부천시",3026,1903,650,491,550,96,106,0,0,1,0,1,1,2,0,1898,5,1123
"6516","소사본동","소사본동제2투","대통령선거","경기도","부천시",2353,1415,535,354,362,72,80,3,1,0,1,0,2,0,2,1412,3,938
"6517","소사본동","소사본동제3투","대통령선거","경기도","부천시",2960,1912,718,431,510,108,119,7,1,1,0,1,2,1,2,1901,11,1048
"6518","소사본동","소사본동제4투","대통령선거","경기도","부천시",4037,2797,1151,618,654,204,158,2,0,3,0,0,0,1,2,2793,4,1240
"6519","소사본동","소사본동제5투","대통령선거","경기도","부천시",3675,2272,906,566,548,117,120,6,0,0,1,1,0,1,1,2267,5,1403
"6520","소사본3동","관내사전투표","대통령선거","경기도","부천시",4506,4506,2061,869,965,279,293,1,0,5,1,8,2,5,1,4490,16,0
"6521","소사본3동","소사본3동제1투","대통령선거","경기도","부천시",2402,1670,601,424,442,96,91,1,1,1,0,1,0,1,3,1662,8,732
"6522","소사본3동","소사본3동제2투","대통령선거","경기도","부천시",2587,1817,725,386,453,130,111,1,0,2,1,0,0,1,1,1811,6,770
"6523","소사본3동","소사본3동제3투","대통령선거","경기도","부천시",3677,2685,1204,528,592,181,157,4,0,1,0,6,0,0,3,2676,9,992
"6524","소사본3동","소사본3동제4투","대통령선거","경기도","부천시",2458,1490,552,357,394,83,94,2,0,1,0,0,0,0,3,1486,4,968
"6525","소사본3동","소사본3동제5투","대통령선거","경기도","부천시",2796,2250,979,451,527,130,146,7,0,3,0,1,0,0,0,2244,6,546
"6526","소사본3동","소사본3동제6투","대통령선거","경기도","부천시",2797,2228,796,579,544,157,139,2,0,2,1,2,1,0,1,2224,4,569
"6527","소사본3동","소사본3동제7투","대통령선거","경기도","부천시",3670,2918,1322,456,746,169,207,7,0,1,0,1,0,1,1,2911,7,752
"6528","괴안동","관내사전투표","대통령선거","경기도","부천시",3691,3691,1699,670,781,229,284,4,0,4,1,3,2,3,1,3681,10,0
"6529","괴안동","괴안동제1투","대통령선거","경기도","부천시",2619,1603,633,359,400,99,98,1,0,1,0,4,0,1,1,1597,6,1016
"6530","괴안동","괴안동제2투","대통령선거","경기도","부천시",2555,1713,677,393,412,96,117,2,1,1,0,2,0,2,1,1704,9,842
"6531","괴안동","괴안동제3투","대통령선거","경기도","부천시",2671,1806,772,362,419,110,129,0,0,2,0,2,0,0,1,1797,9,865
"6532","괴안동","괴안동제4투","대통령선거","경기도","부천시",2148,1503,650,292,341,108,95,0,0,2,0,4,1,4,1,1498,5,645
"6533","괴안동","괴안동제5투","대통령선거","경기도","부천시",3013,2451,1029,462,606,165,173,1,0,1,0,0,0,0,3,2440,11,562
"6534","범박동","관내사전투표","대통령선거","경기도","부천시",5220,5220,2658,816,1042,349,325,5,1,4,0,3,1,2,2,5208,12,0
"6535","범박동","범박동제1투","대통령선거","경기도","부천시",3465,2603,1233,410,625,162,157,3,0,4,1,0,1,1,1,2598,5,862
"6536","범박동","범박동제2투","대통령선거","경기도","부천시",2647,2217,971,450,537,123,127,1,1,0,0,2,0,0,1,2213,4,430
"6537","범박동","범박동제3투","대통령선거","경기도","부천시",513,324,111,90,84,20,17,0,1,0,0,0,1,0,0,324,0,189
"6538","범박동","범박동제4투","대통령선거","경기도","부천시",2603,2073,928,422,455,129,119,9,0,2,0,0,1,1,4,2070,3,530
"6539","범박동","범박동제5투","대통령선거","경기도","부천시",2832,2243,942,503,524,132,131,0,0,2,0,1,0,0,4,2239,4,589
"6540","범박동","범박동제6투","대통령선거","경기도","부천시",4371,3475,1793,413,780,223,248,1,0,1,1,4,0,0,1,3465,10,896
"6541","범박동","범박동제7투","대통령선거","경기도","부천시",2411,1844,758,415,448,105,108,1,1,2,0,0,2,1,0,1841,3,567
"6542","역곡3동","관내사전투표","대통령선거","경기도","부천시",3542,3542,1693,631,737,200,258,7,0,0,1,5,1,1,0,3534,8,0
"6543","역곡3동","역곡3동제1투","대통령선거","경기도","부천시",2585,1627,668,387,390,79,94,1,0,3,0,0,0,0,1,1623,4,958
"6544","역곡3동","역곡3동제2투","대통령선거","경기도","부천시",2944,2048,894,374,480,141,137,7,0,0,0,2,2,0,4,2041,7,896
"6545","역곡3동","역곡3동제3투","대통령선거","경기도","부천시",2612,1853,778,363,470,114,114,2,2,1,0,2,1,2,0,1849,4,759
"6546","역곡3동","역곡3동제4투","대통령선거","경기도","부천시",2962,2096,842,452,517,127,139,4,0,0,0,3,0,1,1,2086,10,866
"6547","역곡3동","역곡3동제5투","대통령선거","경기도","부천시",1628,1111,458,244,268,62,66,6,0,0,1,1,0,0,0,1106,5,517
"6548","역곡3동","역곡3동제6투","대통령선거","경기도","부천시",2943,2065,948,410,458,121,120,1,0,1,1,0,0,0,1,2061,4,878
"6549","성곡동","관내사전투표","대통령선거","경기도","부천시",5909,5908,2935,938,1209,334,437,11,0,5,2,7,1,1,3,5883,25,1
"6550","성곡동","성곡동제1투","대통령선거","경기도","부천시",3095,1867,736,378,512,108,122,2,1,1,0,0,0,0,2,1862,5,1228
"6551","성곡동","성곡동제2투","대통령선거","경기도","부천시",3209,2137,919,400,508,119,164,2,1,5,0,0,0,2,3,2123,14,1072
"6552","성곡동","성곡동제3투","대통령선거","경기도","부천시",3029,1975,805,380,497,130,135,3,1,1,0,3,3,0,5,1963,12,1054
"6553","성곡동","성곡동제4투","대통령선거","경기도","부천시",2800,1801,733,359,441,106,140,2,1,4,0,0,3,2,2,1793,8,999
"6554","성곡동","성곡동제5투","대통령선거","경기도","부천시",2354,1605,675,301,411,98,102,4,0,1,0,1,0,0,3,1596,9,749
"6555","성곡동","성곡동제6투","대통령선거","경기도","부천시",2887,1892,728,451,491,87,114,3,2,2,0,3,0,0,3,1884,8,995
"6556","성곡동","성곡동제7투","대통령선거","경기도","부천시",1944,1439,599,361,307,86,78,3,1,0,0,2,0,0,0,1437,2,505
"6557","성곡동","성곡동제8투","대통령선거","경기도","부천시",2668,1746,707,326,466,95,134,2,0,3,0,1,1,2,0,1737,9,922
"6558","성곡동","성곡동제9투","대통령선거","경기도","부천시",2383,1816,741,393,457,116,99,1,0,2,0,0,1,0,0,1810,6,567
"6559","성곡동","성곡동제10투","대통령선거","경기도","부천시",3515,2789,1242,475,671,194,196,2,0,0,0,3,0,1,0,2784,5,726
"6560","고강본동","관내사전투표","대통령선거","경기도","부천시",3254,3254,1466,587,769,190,215,3,3,6,0,5,0,0,1,3245,9,0
"6561","고강본동","고강본동제1투","대통령선거","경기도","부천시",3728,2236,934,438,559,125,166,3,2,2,1,0,0,0,1,2231,5,1492
"6562","고강본동","고강본동제2투","대통령선거","경기도","부천시",3132,1889,740,362,511,116,135,1,0,3,0,7,0,1,5,1881,8,1243
"6563","고강본동","고강본동제3투","대통령선거","경기도","부천시",3480,2255,887,445,610,130,158,4,1,0,1,1,1,1,5,2244,11,1225
"6564","고강본동","고강본동제4투","대통령선거","경기도","부천시",3817,2521,1063,514,617,140,177,1,0,1,0,2,0,0,3,2518,3,1296
"6565","고강본동","고강본동제5투","대통령선거","경기도","부천시",3646,2337,1006,420,590,129,170,3,0,3,0,4,0,0,3,2328,9,1309
"6566","고강본동","고강본동제6투","대통령선거","경기도","부천시",2207,1484,562,328,412,81,94,2,0,2,0,0,0,0,0,1481,3,723
"6567","고강1동","관내사전투표","대통령선거","경기도","부천시",2775,2775,1338,439,621,154,198,2,1,2,0,6,2,0,2,2765,10,0
"6568","고강1동","고강1동제1투","대통령선거","경기도","부천시",2295,1311,505,295,342,67,91,3,0,1,0,0,0,0,1,1305,6,984
"6569","고강1동","고강1동제2투","대통령선거","경기도","부천시",2900,1799,785,325,443,109,127,1,0,2,1,1,0,0,2,1796,3,1101
"6570","고강1동","고강1동제3투","대통령선거","경기도","부천시",2482,1753,687,367,441,112,125,4,0,3,0,2,1,1,1,1744,9,729
"6571","고강1동","고강1동제4투","대통령선거","경기도","부천시",2866,1905,764,388,488,107,134,5,0,3,1,4,0,0,3,1897,8,961
"6572","오정동","관내사전투표","대통령선거","경기도","부천시",3172,3172,1516,511,687,180,251,6,0,4,1,6,0,0,1,3163,9,0
"6573","오정동","오정동제1투","대통령선거","경기도","부천시",3874,2419,1006,472,602,154,168,1,0,1,1,1,1,0,1,2408,11,1455
"6574","오정동","오정동제2투","대통령선거","경기도","부천시",4406,3317,1412,615,807,233,225,4,0,4,0,0,0,2,2,3304,13,1089
"6575","오정동","오정동제3투","대통령선거","경기도","부천시",3251,2181,853,493,537,121,157,3,1,0,0,0,0,3,0,2168,13,1070
"6576","오정동","오정동제4투","대통령선거","경기도","부천시",3271,2155,837,439,582,114,162,0,0,0,0,5,0,2,1,2142,13,1116
"6577","오정동","오정동제5투","대통령선거","경기도","부천시",324,229,55,85,64,11,9,1,0,0,0,0,0,0,0,225,4,95
"6578","원종1동","관내사전투표","대통령선거","경기도","부천시",3099,3099,1535,494,652,170,212,9,0,4,1,2,0,3,6,3088,11,0
"6579","원종1동","원종1동제1투","대통령선거","경기도","부천시",3089,1905,754,379,512,101,146,3,1,0,0,2,2,0,1,1901,4,1184
"6580","원종1동","원종1동제2투","대통령선거","경기도","부천시",3411,2445,1004,512,598,155,151,0,0,1,0,5,1,1,4,2432,13,966
"6581","원종1동","원종1동제3투","대통령선거","경기도","부천시",2937,1900,786,381,457,109,148,3,2,4,1,2,1,0,0,1894,6,1037
"6582","원종1동","원종1동제4투","대통령선거","경기도","부천시",3094,1967,780,422,498,116,136,5,0,1,0,1,0,0,4,1963,4,1127
"6583","원종1동","원종1동제5투","대통령선거","경기도","부천시",3006,1817,760,377,459,109,98,4,0,2,0,0,1,0,1,1811,6,1189
"6584","원종2동","관내사전투표","대통령선거","경기도","부천시",2373,2373,1173,352,484,124,205,3,3,2,1,5,1,2,4,2359,14,0
"6585","원종2동","원종2동제1투","대통령선거","경기도","부천시",3533,2205,871,424,611,118,162,2,0,1,2,3,0,0,1,2195,10,1328
"6586","원종2동","원종2동제2투","대통령선거","경기도","부천시",3468,2369,993,396,596,177,188,6,0,1,0,2,0,0,4,2363,6,1099
"6587","원종2동","원종2동제3투","대통령선거","경기도","부천시",2471,1715,724,308,435,119,118,4,0,1,0,0,0,1,0,1710,5,756
"6588","원종2동","원종2동제4투","대통령선거","경기도","부천시",2938,1823,786,338,463,105,115,3,0,0,0,3,0,1,1,1815,8,1115
"6589","원종2동","원종2동제5투","대통령선거","경기도","부천시",3432,2317,961,430,637,111,155,0,1,3,2,1,1,1,2,2305,12,1115
"6590","신흥동","관내사전투표","대통령선거","경기도","부천시",1482,1482,727,248,307,71,110,3,1,1,1,2,0,1,2,1474,8,0
"6591","신흥동","신흥동제1투","대통령선거","경기도","부천시",2446,1340,528,290,352,82,78,0,0,1,0,0,1,0,1,1333,7,1106
"6592","신흥동","신흥동제2투","대통령선거","경기도","부천시",4504,3092,1316,542,809,169,235,3,0,2,1,0,0,1,3,3081,11,1412
"6593","신흥동","신흥동제3투","대통령선거","경기도","부천시",2670,1654,644,320,476,89,104,1,0,5,0,3,0,0,3,1645,9,1016
"6594","신흥동","신흥동제4투","대통령선거","경기도","부천시",1983,1160,429,283,325,60,56,1,0,0,0,0,0,1,0,1155,5,823
"6595","신흥동","신흥동제5투","대통령선거","경기도","부천시",1925,1218,455,280,304,75,96,0,0,1,0,2,0,0,0,1213,5,707
"6596","잘못 투입·구분된 투표지","잘못 투입·구분된 투표지","대통령선거","경기도","부천시",0,2,1,0,1,0,0,0,0,0,0,0,0,0,0,2,0,-2
"6597","거소·선상투표","거소·선상투표","대통령선거","경기도","광명시",441,418,143,78,126,24,16,1,1,2,1,0,0,3,2,397,21,23
"6598","관외사전투표","관외사전투표","대통령선거","경기도","광명시",20650,20648,10061,2659,4635,1502,1566,30,5,18,3,19,4,9,35,20546,102,2
"6599","재외투표","재외투표","대통령선거","경기도","광명시",1827,1417,843,106,211,64,178,3,0,2,1,0,1,0,1,1410,7,410
"6600","광명1동","관내사전투표","대통령선거","경기도","광명시",1662,1662,768,313,373,87,106,2,1,1,0,1,0,1,1,1654,8,0
"6601","광명1동","광명1동제1투","대통령선거","경기도","광명시",3271,2075,850,401,534,134,131,4,0,1,2,3,0,0,2,2062,13,1196
"6602","광명1동","광명1동제2투","대통령선거","경기도","광명시",2905,1870,750,434,467,105,103,1,0,2,0,1,0,0,1,1864,6,1035
"6603","광명1동","광명1동제3투","대통령선거","경기도","광명시",2968,1977,868,395,446,125,125,1,1,2,1,2,1,1,3,1971,6,991
"6604","광명2동","관내사전투표","대통령선거","경기도","광명시",1741,1741,784,331,407,105,104,1,1,0,0,1,0,0,2,1736,5,0
"6605","광명2동","광명2동제1투","대통령선거","경기도","광명시",2513,1516,572,349,409,89,82,0,0,4,0,0,1,0,1,1507,9,997
"6606","광명2동","광명2동제2투","대통령선거","경기도","광명시",2706,1781,711,378,482,98,101,0,0,1,0,2,0,0,2,1775,6,925
"6607","광명2동","광명2동제3투","대통령선거","경기도","광명시",2180,1511,626,309,388,82,98,0,2,1,1,0,1,0,1,1509,2,669
"6608","광명3동","관내사전투표","대통령선거","경기도","광명시",1872,1872,815,395,431,89,124,3,1,1,0,0,1,2,3,1865,7,0
"6609","광명3동","광명3동제1투","대통령선거","경기도","광명시",2475,1531,586,362,400,60,106,5,1,0,0,0,2,0,3,1525,6,944
"6610","광명3동","광명3동제2투","대통령선거","경기도","광명시",1863,1227,475,258,352,46,83,3,0,1,0,2,0,0,0,1220,7,636
"6611","광명3동","광명3동제3투","대통령선거","경기도","광명시",2503,1784,753,373,472,88,85,2,0,0,1,1,0,0,0,1775,9,719
"6612","광명4동","관내사전투표","대통령선거","경기도","광명시",2842,2842,1324,491,652,152,190,11,0,3,0,1,1,0,4,2829,13,0
"6613","광명4동","광명4동제1투","대통령선거","경기도","광명시",2878,1781,725,376,442,99,118,4,1,2,2,1,1,0,1,1772,9,1097
"6614","광명4동","광명4동제2투","대통령선거","경기도","광명시",2675,1806,743,362,483,102,102,2,0,0,0,1,0,0,1,1796,10,869
"6615","광명4동","광명4동제3투","대통령선거","경기도","광명시",4447,3459,1334,795,939,191,175,5,0,4,1,5,0,3,1,3453,6,988
"6616","광명5동","관내사전투표","대통령선거","경기도","광명시",2388,2388,1122,431,515,127,172,2,0,3,3,1,1,3,0,2380,8,0
"6617","광명5동","광명5동제1투","대통령선거","경기도","광명시",3229,2078,831,453,555,104,114,2,0,2,2,3,0,1,3,2070,8,1151
"6618","광명5동","광명5동제2투","대통령선거","경기도","광명시",3254,2492,1050,483,627,156,163,0,0,1,2,1,0,0,2,2485,7,762
"6619","광명5동","광명5동제3투","대통령선거","경기도","광명시",2935,1964,755,440,517,110,127,4,0,1,0,0,0,1,2,1957,7,971
"6620","광명6동","관내사전투표","대통령선거","경기도","광명시",2062,2062,987,377,456,101,125,6,0,0,0,1,1,0,2,2056,6,0
"6621","광명6동","광명6동제1투","대통령선거","경기도","광명시",2545,1946,830,320,531,138,120,0,0,1,0,0,1,0,0,1941,5,599
"6622","광명6동","광명6동제2투","대통령선거","경기도","광명시",3867,2716,1072,587,709,139,188,7,2,1,0,2,1,1,1,2710,6,1151
"6623","광명6동","광명6동제3투","대통령선거","경기도","광명시",2541,1767,694,383,496,76,98,1,0,2,1,2,0,0,5,1758,9,774
"6624","광명6동","광명6동제4투","대통령선거","경기도","광명시",521,347,91,151,75,11,16,1,0,0,0,0,0,0,1,346,1,174
"6625","광명7동","관내사전투표","대통령선거","경기도","광명시",3128,3128,1389,578,731,190,216,2,3,2,0,2,1,0,4,3118,10,0
"6626","광명7동","광명7동제1투","대통령선거","경기도","광명시",2186,1411,555,308,383,79,80,1,0,0,0,1,0,0,2,1409,2,775
"6627","광명7동","광명7동제2투","대통령선거","경기도","광명시",1982,1235,466,271,348,68,68,8,0,0,0,0,0,1,1,1231,4,747
"6628","광명7동","광명7동제3투","대통령선거","경기도","광명시",2037,1388,577,277,357,85,79,2,0,2,0,1,1,0,2,1383,5,649
"6629","광명7동","광명7동제4투","대통령선거","경기도","광명시",1910,1207,463,272,337,54,70,0,0,0,1,0,0,1,3,1201,6,703
"6630","광명7동","광명7동제5투","대통령선거","경기도","광명시",2321,1719,661,340,479,119,108,4,0,1,1,3,0,0,0,1716,3,602
"6631","광명7동","광명7동제6투","대통령선거","경기도","광명시",2798,2028,841,380,557,94,141,3,0,1,0,1,1,1,1,2021,7,770
"6632","철산1동","관내사전투표","대통령선거","경기도","광명시",2644,2644,1320,390,533,193,187,4,1,3,1,2,0,2,0,2636,8,0
"6633","철산1동","철산1동제1투","대통령선거","경기도","광명시",2787,2164,1012,342,503,152,140,2,0,1,0,2,0,1,1,2156,8,623
"6634","철산1동","철산1동제2투","대통령선거","경기도","광명시",1513,1041,435,241,227,70,58,1,0,0,1,0,0,2,1,1036,5,472
"6635","철산1동","철산1동제3투","대통령선거","경기도","광명시",2926,2287,1026,378,520,190,160,3,0,0,1,1,0,0,1,2280,7,639
"6636","철산2동","관내사전투표","대통령선거","경기도","광명시",2344,2344,1024,435,544,155,170,3,0,1,4,4,1,1,0,2342,2,0
"6637","철산2동","철산2동제1투","대통령선거","경기도","광명시",3177,2448,1117,449,533,158,171,3,0,4,1,2,0,0,3,2441,7,729
"6638","철산2동","철산2동제2투","대통령선거","경기도","광명시",2403,1641,692,306,398,121,117,3,0,0,0,1,0,0,0,1638,3,762
"6639","철산2동","철산2동제3투","대통령선거","경기도","광명시",1872,1163,484,248,298,56,67,2,0,0,0,0,1,0,0,1156,7,709
"6640","철산2동","철산2동제4투","대통령선거","경기도","광명시",2526,1596,654,316,414,93,105,2,0,1,0,2,0,0,1,1588,8,930
"6641","철산3동","관내사전투표","대통령선거","경기도","광명시",5200,5200,2551,766,1100,413,344,5,0,4,1,1,0,2,1,5188,12,0
"6642","철산3동","철산3동제1투","대통령선거","경기도","광명시",2301,1952,834,338,490,147,134,1,0,1,0,3,0,1,0,1949,3,349
"6643","철산3동","철산3동제2투","대통령선거","경기도","광명시",2273,1887,792,402,429,135,118,1,1,0,0,1,0,1,1,1881,6,386
"6644","철산3동","철산3동제3투","대통령선거","경기도","광명시",1847,1321,569,267,308,65,96,4,1,2,0,3,1,1,0,1317,4,526
"6645","철산3동","철산3동제4투","대통령선거","경기도","광명시",3167,2394,1052,478,555,160,138,4,0,1,0,0,0,0,0,2388,6,773
"6646","철산3동","철산3동제5투","대통령선거","경기도","광명시",1993,1535,686,300,365,85,88,2,1,2,0,0,0,0,1,1530,5,458
"6647","철산3동","철산3동제6투","대통령선거","경기도","광명시",3324,2842,1189,551,697,198,190,7,0,1,1,1,0,1,2,2838,4,482
"6648","철산3동","철산3동제7투","대통령선거","경기도","광명시",1833,1567,719,236,372,132,104,0,0,1,0,1,0,0,0,1565,2,266
"6649","철산3동","철산3동제8투","대통령선거","경기도","광명시",2323,2005,894,371,482,151,105,1,0,0,0,1,0,0,0,2005,0,318
"6650","철산3동","철산3동제9투","대통령선거","경기도","광명시",2485,2083,874,380,517,178,126,3,0,0,0,2,0,0,0,2080,3,402
"6651","철산4동","관내사전투표","대통령선거","경기도","광명시",2445,2445,1223,362,520,144,184,0,0,0,0,4,3,0,1,2441,4,0
"6652","철산4동","철산4동제1투","대통령선거","경기도","광명시",2388,1453,572,318,373,82,93,2,1,2,0,0,0,0,1,1444,9,935
"6653","철산4동","철산4동제2투","대통령선거","경기도","광명시",1729,1376,699,191,304,88,86,2,0,0,0,0,1,1,2,1374,2,353
"6654","철산4동","철산4동제3투","대통령선거","경기도","광명시",2323,1943,866,362,453,116,134,3,0,2,0,1,0,0,2,1939,4,380
"6655","철산4동","철산4동제4투","대통령선거","경기도","광명시",2283,1837,914,251,429,122,111,2,0,0,0,1,0,0,1,1831,6,446
"6656","하안1동","관내사전투표","대통령선거","경기도","광명시",3231,3231,1662,496,666,206,195,1,0,0,1,0,0,0,0,3227,4,0
"6657","하안1동","하안1동제1투","대통령선거","경기도","광명시",2197,1614,694,309,407,99,97,4,0,0,1,0,0,0,1,1612,2,583
"6658","하안1동","하안1동제2투","대통령선거","경기도","광명시",2843,2240,1001,406,551,125,138,4,0,0,0,3,2,1,1,2232,8,603
"6659","하안1동","하안1동제3투","대통령선거","경기도","광명시",3415,2237,848,540,584,122,123,5,0,1,0,1,3,0,1,2228,9,1178
"6660","하안1동","하안1동제4투","대통령선거","경기도","광명시",2684,2290,1046,397,557,141,141,2,0,0,0,0,0,0,1,2285,5,394
"6661","하안1동","하안1동제5투","대통령선거","경기도","광명시",2552,2128,1033,311,476,161,145,0,1,0,0,0,0,0,1,2128,0,424
"6662","하안1동","하안1동제6투","대통령선거","경기도","광명시",2550,2212,1011,353,529,148,161,3,0,0,1,0,1,0,0,2207,5,338
"6663","하안2동","관내사전투표","대통령선거","경기도","광명시",2463,2463,1287,336,502,163,162,4,1,1,0,1,0,1,0,2458,5,0
"6664","하안2동","하안2동제1투","대통령선거","경기도","광명시",1936,1392,609,229,352,104,89,1,0,0,1,0,1,0,2,1388,4,544
"6665","하안2동","하안2동제2투","대통령선거","경기도","광명시",2059,1624,766,253,354,104,135,3,0,1,0,2,0,0,0,1618,6,435
"6666","하안2동","하안2동제3투","대통령선거","경기도","광명시",2476,1817,854,294,414,115,130,3,0,0,0,2,0,1,0,1813,4,659
"6667","하안2동","하안2동제4투","대통령선거","경기도","광명시",2562,1939,918,306,446,128,123,5,0,3,0,1,1,0,2,1933,6,623
"6668","하안3동","관내사전투표","대통령선거","경기도","광명시",3758,3758,1912,569,815,199,238,1,0,0,1,2,1,4,2,3744,14,0
"6669","하안3동","하안3동제1투","대통령선거","경기도","광명시",2786,2069,986,317,493,135,127,0,0,3,0,1,0,0,2,2064,5,717
"6670","하안3동","하안3동제2투","대통령선거","경기도","광명시",1627,1178,571,171,281,73,75,1,0,4,0,1,0,1,0,1178,0,449
"6671","하안3동","하안3동제3투","대통령선거","경기도","광명시",2183,1700,830,260,380,116,111,0,0,1,1,0,0,0,1,1700,0,483
"6672","하안3동","하안3동제4투","대통령선거","경기도","광명시",2284,1853,876,293,405,141,133,2,0,1,0,0,0,0,0,1851,2,431
"6673","하안3동","하안3동제5투","대통령선거","경기도","광명시",1861,1555,742,246,366,123,67,6,0,1,1,1,0,0,1,1554,1,306
"6674","하안3동","하안3동제6투","대통령선거","경기도","광명시",1378,862,284,244,233,39,48,0,1,0,0,1,1,0,3,854,8,516
"6675","하안3동","하안3동제7투","대통령선거","경기도","광명시",1282,841,306,213,223,35,43,2,0,2,1,1,1,1,5,833,8,441
"6676","하안4동","관내사전투표","대통령선거","경기도","광명시",2661,2661,1399,318,517,222,192,7,0,0,0,1,0,1,0,2657,4,0
"6677","하안4동","하안4동제1투","대통령선거","경기도","광명시",2552,2027,950,308,476,148,130,7,0,2,1,1,0,1,1,2025,2,525
"6678","하안4동","하안4동제2투","대통령선거","경기도","광명시",2368,1895,923,269,477,103,117,1,0,1,0,2,0,0,1,1894,1,473
"6679","하안4동","하안4동제3투","대통령선거","경기도","광명시",2580,2045,1020,281,457,146,135,1,0,0,0,0,0,1,1,2042,3,535
"6680","소하1동","관내사전투표","대통령선거","경기도","광명시",4350,4350,2158,693,917,261,293,4,2,4,1,4,1,0,1,4339,11,0
"6681","소하1동","소하1동제1투","대통령선거","경기도","광명시",2628,1935,884,306,477,127,132,4,0,3,0,0,0,0,0,1933,2,693
"6682","소하1동","소하1동제2투","대통령선거","경기도","광명시",2157,1757,783,295,420,113,129,2,0,0,0,5,0,0,0,1747,10,400
"6683","소하1동","소하1동제3투","대통령선거","경기도","광명시",2519,1976,925,335,444,126,130,3,1,2,0,1,0,1,1,1969,7,543
"6684","소하1동","소하1동제4투","대통령선거","경기도","광명시",3129,2311,1089,370,550,141,137,7,0,3,2,1,0,1,3,2304,7,818
"6685","소하1동","소하1동제5투","대통령선거","경기도","광명시",2725,2121,927,440,489,135,118,3,0,2,0,0,0,1,0,2115,6,604
"6686","소하1동","소하1동제6투","대통령선거","경기도","광명시",1973,1613,718,275,402,114,95,2,0,0,0,1,1,0,1,1609,4,360
"6687","소하1동","소하1동제7투","대통령선거","경기도","광명시",3095,2438,1012,461,630,168,152,4,0,3,0,1,0,1,2,2434,4,657
"6688","소하2동","관내사전투표","대통령선거","경기도","광명시",4732,4732,2334,763,959,287,348,4,0,4,1,5,0,3,6,4714,18,0
"6689","소하2동","소하2동제1투","대통령선거","경기도","광명시",1605,1021,282,304,305,52,72,0,0,1,0,2,1,0,0,1019,2,584
"6690","소하2동","소하2동제2투","대통령선거","경기도","광명시",1997,1379,601,244,347,82,96,5,0,0,0,0,1,0,1,1377,2,618
"6691","소하2동","소하2동제3투","대통령선거","경기도","광명시",1983,1309,523,283,329,86,80,0,0,1,0,1,0,2,0,1305,4,674
"6692","소하2동","소하2동제4투","대통령선거","경기도","광명시",3303,2514,993,576,624,141,162,0,0,4,1,3,1,1,2,2508,6,789
"6693","소하2동","소하2동제5투","대통령선거","경기도","광명시",851,598,263,111,132,49,41,0,0,0,0,0,1,0,1,598,0,253
"6694","소하2동","소하2동제6투","대통령선거","경기도","광명시",2839,2019,817,423,498,131,133,1,0,1,2,2,0,2,0,2010,9,820
"6695","소하2동","소하2동제7투","대통령선거","경기도","광명시",2451,1906,830,329,481,118,141,3,0,0,0,0,0,0,1,1903,3,545
"6696","소하2동","소하2동제8투","대통령선거","경기도","광명시",2413,1938,851,323,467,138,147,2,1,0,0,2,0,1,1,1933,5,475
"6697","소하2동","소하2동제9투","대통령선거","경기도","광명시",2455,1817,742,408,442,94,115,2,1,1,0,1,1,0,2,1809,8,638
"6698","학온동","관내사전투표","대통령선거","경기도","광명시",314,314,115,93,69,19,17,0,0,0,0,0,0,0,0,313,1,0
"6699","학온동","학온동제1투","대통령선거","경기도","광명시",864,586,107,235,177,38,23,2,0,1,0,0,0,0,1,584,2,278
"6700","학온동","학온동제2투","대통령선거","경기도","광명시",816,568,164,201,152,22,25,2,0,0,0,1,0,0,1,568,0,248
"6701","잘못 투입·구분된 투표지","잘못 투입·구분된 투표지","대통령선거","경기도","광명시",0,0,0,0,0,0,0,0,0,0,0,0,0,0,0,0,0,0
"6702","거소·선상투표","거소·선상투표","대통령선거","경기도","평택시",1269,1233,390,215,371,140,44,2,4,2,1,1,2,0,17,1189,44,36
"6703","관외사전투표","관외사전투표","대통령선거","경기도","평택시",27722,27716,12064,4458,6061,2302,2401,29,14,23,11,29,15,4,70,27481,235,6
"6704","재외투표","재외투표","대통령선거","경기도","평택시",1711,1295,791,93,212,42,135,4,2,0,1,1,0,1,3,1285,10,416
"6705","팽성읍","관내사전투표","대통령선거","경기도","평택시",3103,3103,1235,784,657,214,190,4,0,4,1,3,0,2,4,3098,5,0
"6706","팽성읍","팽성읍제1투","대통령선거","경기도","평택시",2861,1841,520,595,468,142,100,2,0,0,1,1,1,1,2,1833,8,1020
"6707","팽성읍","팽성읍제2투","대통령선거","경기도","평택시",2936,1916,661,533,418,146,136,4,1,4,0,2,2,0,1,1908,8,1020
"6708","팽성읍","팽성읍제3투","대통령선거","경기도","평택시",4299,1725,571,498,399,126,111,3,0,1,0,1,2,1,4,1717,8,2574
"6709","팽성읍","팽성읍제4투","대통령선거","경기도","평택시",1521,857,230,327,187,46,55,0,0,3,0,1,1,0,1,851,6,664
"6710","팽성읍","팽성읍제5투","대통령선거","경기도","평택시",1880,1265,276,562,307,65,36,3,0,3,0,2,2,2,2,1260,5,615
"6711","팽성읍","팽성읍제6투","대통령선거","경기도","평택시",1466,867,239,352,172,50,45,1,0,0,1,2,2,0,1,865,2,599
"6712","팽성읍","팽성읍제7투","대통령선거","경기도","평택시",2513,1344,367,473,347,74,61,4,0,2,0,1,2,0,4,1335,9,1169
"6713","팽성읍","팽성읍제8투","대통령선거","경기도","평택시",2574,1477,419,564,346,79,56,2,0,3,1,1,0,1,1,1473,4,1097
"6714","안중읍","관내사전투표","대통령선거","경기도","평택시",4931,4931,2307,809,980,349,445,2,1,1,0,7,0,0,4,4905,26,0
"6715","안중읍","안중읍제1투","대통령선거","경기도","평택시",2468,1290,415,376,336,74,75,1,0,2,0,0,0,0,3,1282,8,1178
"6716","안중읍","안중읍제2투","대통령선거","경기도","평택시",3016,1693,489,549,404,104,126,1,0,1,1,4,2,4,1,1686,7,1323
"6717","안중읍","안중읍제3투","대통령선거","경기도","평택시",1659,1073,381,244,260,86,90,3,0,1,0,3,1,1,0,1070,3,586
"6718","안중읍","안중읍제4투","대통령선거","경기도","평택시",2156,1293,533,265,313,70,93,2,0,3,0,3,2,1,1,1286,7,863
"6719","안중읍","안중읍제5투","대통령선거","경기도","평택시",1919,1377,612,240,325,78,111,1,1,0,0,2,0,1,2,1373,4,542
"6720","안중읍","안중읍제6투","대통령선거","경기도","평택시",3297,1982,799,420,460,130,167,1,0,0,0,2,0,0,2,1981,1,1315
"6721","안중읍","안중읍제7투","대통령선거","경기도","평택시",3801,2932,1380,403,632,174,319,4,0,2,1,7,0,2,5,2929,3,869
"6722","안중읍","안중읍제8투","대통령선거","경기도","평택시",2399,1857,883,239,403,130,186,0,1,1,0,6,2,0,0,1851,6,542
"6723","안중읍","안중읍제9투","대통령선거","경기도","평택시",2917,2180,988,318,453,149,259,0,0,0,0,4,0,0,5,2176,4,737
"6724","포승읍","관내사전투표","대통령선거","경기도","평택시",2928,2928,1348,532,602,195,217,2,0,7,0,9,2,2,3,2919,9,0
"6725","포승읍","포승읍제1투","대통령선거","경기도","평택시",2263,1193,394,373,280,56,85,1,0,1,0,1,0,0,0,1191,2,1070
"6726","포승읍","포승읍제2투","대통령선거","경기도","평택시",1228,756,210,257,193,38,41,3,0,0,1,1,1,1,1,747,9,472
"6727","포승읍","포승읍제3투","대통령선거","경기도","평택시",1802,1022,380,260,245,58,68,2,0,2,1,2,1,2,1,1022,0,780
"6728","포승읍","포승읍제4투","대통령선거","경기도","평택시",1948,1113,411,308,249,61,68,2,0,4,0,1,0,0,0,1104,9,835
"6729","포승읍","포승읍제5투","대통령선거","경기도","평택시",4114,2271,1024,347,551,157,168,4,0,0,0,5,3,1,1,2261,10,1843
"6730","포승읍","포승읍제6투","대통령선거","경기도","평택시",1892,1176,371,361,288,53,90,1,0,0,0,4,0,0,1,1169,7,716
"6731","포승읍","포승읍제7투","대통령선거","경기도","평택시",2351,1341,458,263,359,158,88,2,0,0,0,2,2,0,2,1334,7,1010
"6732","진위면","관내사전투표","대통령선거","경기도","평택시",1457,1457,552,367,306,76,130,3,0,2,4,2,1,3,2,1448,9,0
"6733","진위면","진위면제1투","대통령선거","경기도","평택시",2227,1291,317,470,346,68,70,1,0,1,0,2,3,2,4,1284,7,936
"6734","진위면","진위면제2투","대통령선거","경기도","평택시",1368,845,228,319,196,54,42,1,0,1,0,0,0,0,1,842,3,523
"6735","진위면","진위면제3투","대통령선거","경기도","평택시",2687,1743,669,385,445,110,117,1,0,3,0,1,0,0,6,1737,6,944
"6736","진위면","진위면제4투","대통령선거","경기도","평택시",1907,1185,409,272,300,80,102,3,1,1,1,5,0,4,2,1180,5,722
"6737","서탄면","관내사전투표","대통령선거","경기도","평택시",505,505,162,175,110,21,30,1,0,0,0,0,0,1,3,503,2,0
"6738","서탄면","서탄면제1투","대통령선거","경기도","평택시",1177,742,203,270,197,36,30,1,0,2,0,0,1,0,1,741,1,435
"6739","서탄면","서탄면제2투","대통령선거","경기도","평택시",1005,594,140,244,143,37,22,0,0,1,0,0,2,0,2,591,3,411
"6740","서탄면","서탄면제3투","대통령선거","경기도","평택시",553,345,94,141,72,16,19,0,0,0,0,1,0,0,1,344,1,208
"6741","고덕면","관내사전투표","대통령선거","경기도","평택시",839,839,346,195,174,54,61,2,0,1,0,2,1,0,1,837,2,0
"6742","고덕면","고덕면제1투","대통령선거","경기도","평택시",505,274,62,113,66,19,12,0,0,0,0,0,0,0,0,272,2,231
"6743","고덕면","고덕면제2투","대통령선거","경기도","평택시",1692,1015,226,375,288,64,50,0,0,3,3,1,0,0,0,1010,5,677
"6744","고덕면","고덕면제3투","대통령선거","경기도","평택시",3803,2475,1010,505,581,155,203,1,1,2,0,5,1,0,3,2467,8,1328
"6745","고덕면","고덕면제4투","대통령선거","경기도","평택시",1303,817,184,324,214,54,35,2,1,0,0,0,0,0,0,814,3,486
"6746","오성면","관내사전투표","대통령선거","경기도","평택시",1296,1296,491,326,299,74,95,1,0,0,1,4,0,0,0,1291,5,0
"6747","오성면","오성면제1투","대통령선거","경기도","평택시",2692,1572,453,509,376,103,114,2,0,2,0,3,2,1,2,1567,5,1120
"6748","오성면","오성면제2투","대통령선거","경기도","평택시",1495,967,210,375,269,48,53,0,0,1,2,0,0,1,3,962,5,528
"6749","오성면","오성면제3투","대통령선거","경기도","평택시",509,335,78,131,92,21,8,0,0,0,0,0,1,1,0,332,3,174
"6750","현덕면","관내사전투표","대통령선거","경기도","평택시",874,874,338,221,175,64,64,1,0,2,2,2,1,0,0,870,4,0
"6751","현덕면","현덕면제1투","대통령선거","경기도","평택시",1872,1117,302,427,248,63,65,2,0,0,1,0,0,1,2,1111,6,755
"6752","현덕면","현덕면제2투","대통령선거","경기도","평택시",928,588,126,256,135,33,30,1,0,1,0,0,2,1,2,587,1,340
"6753","현덕면","현덕면제3투","대통령선거","경기도","평택시",1271,783,185,307,213,35,33,1,1,1,1,0,0,1,1,779,4,488
"6754","중앙동","관내사전투표","대통령선거","경기도","평택시",4590,4590,2020,952,886,367,322,6,0,3,1,8,2,1,6,4574,16,0
"6755","중앙동","중앙동제1투","대통령선거","경기도","평택시",2536,1289,445,349,312,83,91,1,0,1,1,0,2,0,0,1285,4,1247
"6756","중앙동","중앙동제2투","대통령선거","경기도","평택시",1613,934,305,316,194,57,56,1,0,0,0,2,0,0,0,931,3,679
"6757","중앙동","중앙동제3투","대통령선거","경기도","평택시",3406,2395,798,633,570,182,194,3,0,0,0,1,0,0,4,2385,10,1011
"6758","중앙동","중앙동제4투","대통령선거","경기도","평택시",2853,2073,597,630,537,162,128,4,0,1,0,2,0,1,1,2063,10,780
"6759","중앙동","중앙동제5투","대통령선거","경기도","평택시",3099,2319,947,435,566,160,183,3,1,1,0,7,0,0,5,2308,11,780
"6760","중앙동","중앙동제6투","대통령선거","경기도","평택시",2865,2057,855,347,527,178,134,1,0,1,0,4,0,1,1,2049,8,808
"6761","중앙동","중앙동제7투","대통령선거","경기도","평택시",2782,2199,885,412,555,168,166,2,1,1,1,1,1,0,1,2194,5,583
"6762","중앙동","중앙동제8투","대통령선거","경기도","평택시",2947,2109,852,406,543,161,135,2,0,2,0,2,1,0,1,2105,4,838
"6763","중앙동","중앙동제9투","대통령선거","경기도","평택시",2953,2065,809,444,495,141,148,4,1,2,0,2,1,1,6,2054,11,888
"6764","중앙동","중앙동제10투","대통령선거","경기도","평택시",3241,2160,694,572,553,158,155,3,0,3,0,6,1,1,5,2151,9,1081
"6765","서정동","관내사전투표","대통령선거","경기도","평택시",3524,3524,1408,811,761,225,281,8,0,5,0,9,0,0,2,3510,14,0
"6766","서정동","서정동제1투","대통령선거","경기도","평택시",3994,1898,672,467,493,118,124,4,0,3,2,5,1,0,1,1890,8,2096
"6767","서정동","서정동제2투","대통령선거","경기도","평택시",3448,2207,759,578,532,167,147,8,1,0,0,1,1,2,3,2199,8,1241
"6768","서정동","서정동제3투","대통령선거","경기도","평택시",2166,1268,367,395,347,67,76,3,0,4,1,3,1,0,1,1265,3,898
"6769","서정동","서정동제4투","대통령선거","경기도","평택시",1861,1040,318,332,252,52,71,5,0,2,1,0,1,3,0,1037,3,821
"6770","서정동","서정동제5투","대통령선거","경기도","평택시",3241,1829,581,469,496,132,134,0,0,1,0,3,1,1,0,1818,11,1412
"6771","서정동","서정동제6투","대통령선거","경기도","평택시",2522,1386,427,355,360,98,127,6,0,3,1,1,1,0,1,1380,6,1136
"6772","서정동","서정동제7투","대통령선거","경기도","평택시",2739,1708,589,376,472,133,128,3,0,0,0,3,0,0,0,1704,4,1031
"6773","송탄동","관내사전투표","대통령선거","경기도","평택시",2012,2012,877,440,400,140,141,2,1,2,0,3,0,0,1,2007,5,0
"6774","송탄동","송탄동제1투","대통령선거","경기도","평택시",2595,1583,494,462,395,103,111,1,0,3,0,0,1,1,2,1573,10,1012
"6775","송탄동","송탄동제2투","대통령선거","경기도","평택시",2989,2036,697,532,503,145,142,0,0,0,0,8,2,0,3,2032,4,953
"6776","송탄동","송탄동제3투","대통령선거","경기도","평택시",3522,2793,1155,459,705,233,224,5,0,1,0,1,2,1,2,2788,5,729
"6777","지산동","관내사전투표","대통령선거","경기도","평택시",2126,2126,887,430,458,134,194,3,0,3,1,3,1,1,0,2115,11,0
"6778","지산동","지산동제1투","대통령선거","경기도","평택시",4210,2006,675,530,513,123,145,3,0,1,1,0,1,2,3,1997,9,2204
"6779","지산동","지산동제2투","대통령선거","경기도","평택시",3134,2208,878,466,512,143,192,7,1,2,0,1,1,2,0,2205,3,926
"6780","송북동","관내사전투표","대통령선거","경기도","평택시",3172,3172,1238,842,663,188,211,2,2,3,1,2,0,1,6,3159,13,0
"6781","송북동","송북동제1투","대통령선거","경기도","평택시",2163,1224,389,343,321,69,91,2,0,1,0,0,0,1,1,1218,6,939
"6782","송북동","송북동제2투","대통령선거","경기도","평택시",3254,1897,566,618,460,121,112,0,1,0,1,2,1,3,3,1888,9,1357
"6783","송북동","송북동제3투","대통령선거","경기도","평택시",3168,2201,698,621,545,148,170,1,0,0,0,0,1,0,3,2187,14,967
"6784","송북동","송북동제4투","대통령선거","경기도","평택시",2585,1688,587,413,420,121,130,1,1,4,0,1,1,0,2,1681,7,897
"6785","송북동","송북동제5투","대통령선거","경기도","평택시",3008,2020,741,416,539,138,175,1,0,0,0,2,1,0,1,2014,6,988
"6786","신장1동","관내사전투표","대통령선거","경기도","평택시",1047,1047,395,273,223,89,61,1,0,2,0,1,0,0,1,1046,1,0
"6787","신장1동","신장1동제1투","대통령선거","경기도","평택시",2115,894,235,310,237,53,49,1,0,1,0,0,1,0,1,888,6,1221
"6788","신장1동","신장1동제2투","대통령선거","경기도","평택시",2096,1181,365,262,358,104,83,1,0,2,0,0,1,1,2,1179,2,915
"6789","신장2동","관내사전투표","대통령선거","경기도","평택시",903,903,284,261,227,57,55,3,0,4,0,3,0,2,1,897,6,0
"6790","신장2동","신장2동제1투","대통령선거","경기도","평택시",2496,1117,272,441,279,61,50,4,0,1,0,1,0,0,1,1110,7,1379
"6791","신장2동","신장2동제2투","대통령선거","경기도","평택시",2117,1181,322,387,318,73,70,0,0,4,0,0,0,0,0,1174,7,936
"6792","신평동","관내사전투표","대통령선거","경기도","평택시",2643,2643,1037,668,555,168,190,3,2,5,0,5,3,0,2,2638,5,0
"6793","신평동","신평동제1투","대통령선거","경기도","평택시",2200,1269,439,356,300,84,73,3,0,3,1,4,0,0,0,1263,6,931
"6794","신평동","신평동제2투","대통령선거","경기도","평택시",1833,916,259,309,233,49,56,2,0,1,0,1,0,0,0,910,6,917
"6795","신평동","신평동제3투","대통령선거","경기도","평택시",3359,1979,577,630,493,127,122,6,1,2,0,7,2,1,2,1970,9,1380
"6796","신평동","신평동제4투","대통령선거","경기도","평택시",3778,2101,771,483,524,142,163,3,1,0,1,1,2,2,1,2094,7,1677
"6797","신평동","신평동제5투","대통령선거","경기도","평택시",1716,937,334,221,222,71,75,2,0,1,1,3,1,1,0,932,5,779
"6798","신평동","신평동제6투","대통령선거","경기도","평택시",580,395,99,154,97,23,19,0,0,1,0,0,0,0,0,393,2,185
"6799","신평동","신평동제7투","대통령선거","경기도","평택시",2308,1805,687,405,414,157,134,2,0,0,0,1,0,0,2,1802,3,503
"6800","원평동","관내사전투표","대통령선거","경기도","평택시",1950,1950,774,453,432,127,145,1,0,3,1,2,0,1,4,1943,7,0
"6801","원평동","원평동제1투","대통령선거","경기도","평택시",3077,1638,514,487,424,99,96,2,1,0,1,3,0,2,1,1630,8,1439
"6802","원평동","원평동제2투","대통령선거","경기도","평택시",2799,1914,809,391,429,130,141,2,0,2,1,2,0,0,2,1909,5,885
"6803","원평동","원평동제3투","대통령선거","경기도","평택시",1633,1133,339,380,266,81,56,2,0,1,0,1,1,1,0,1128,5,500
"6804","원평동","원평동제4투","대통령선거","경기도","평택시",653,403,101,136,115,21,24,1,0,0,0,0,2,0,0,400,3,250
"6805","통복동","관내사전투표","대통령선거","경기도","평택시",1304,1304,541,288,284,72,104,3,0,1,0,1,0,0,2,1296,8,0
"6806","통복동","통복동제1투","대통령선거","경기도","평택시",1871,1193,366,372,295,88,63,1,1,0,0,1,0,0,2,1189,4,678
"6807","통복동","통복동제2투","대통령선거","경기도","평택시",1266,741,190,321,157,34,33,1,0,0,1,0,0,0,0,737,4,525
"6808","비전1동","관내사전투표","대통령선거","경기도","평택시",3544,3544,1607,655,697,235,317,10,1,1,1,8,0,0,3,3535,9,0
"6809","비전1동","비전1동제1투","대통령선거","경기도","평택시",3023,1915,680,496,465,141,120,1,1,2,0,0,1,0,1,1908,7,1108
"6810","비전1동","비전1동제2투","대통령선거","경기도","평택시",1592,935,296,331,198,52,52,0,0,1,0,1,0,0,0,931,4,657
"6811","비전1동","비전1동제3투","대통령선거","경기도","평택시",2854,2134,764,420,603,185,140,5,0,2,1,1,1,0,1,2123,11,720
"6812","비전1동","비전1동제4투","대통령선거","경기도","평택시",1537,1166,394,317,290,77,75,4,0,0,1,1,0,0,1,1160,6,371
"6813","비전1동","비전1동제5투","대통령선거","경기도","평택시",1251,856,232,315,196,55,52,0,0,1,0,1,1,0,0,853,3,395
"6814","비전1동","비전1동제6투","대통령선거","경기도","평택시",3917,2462,894,551,640,176,179,2,0,2,0,8,0,1,2,2455,7,1455
"6815","비전1동","비전1동제7투","대통령선거","경기도","평택시",2860,1951,834,300,493,159,155,1,0,3,0,0,0,1,3,1949,2,909
"6816","비전1동","비전1동제8투","대통령선거","경기도","평택시",4167,2545,1169,346,612,192,208,2,1,0,0,3,1,0,2,2536,9,1622
"6817","비전1동","비전1동제9투","대통령선거","경기도","평택시",3078,2212,977,355,491,151,213,3,0,2,0,5,0,1,5,2203,9,866
"6818","비전1동","비전1동제10투","대통령선거","경기도","평택시",3040,2386,1155,290,551,195,189,0,1,0,0,0,0,0,3,2384,2,654
"6819","비전1동","비전1동제11투","대통령선거","경기도","평택시",1700,1378,683,167,318,92,114,0,2,0,1,0,0,0,0,1377,1,322
"6820","비전2동","관내사전투표","대통령선거","경기도","평택시",7956,7956,3582,1410,1593,683,631,6,4,6,5,4,0,2,3,7929,27,0
"6821","비전2동","비전2동제1투","대통령선거","경기도","평택시",2303,1499,545,401,375,93,76,4,0,1,0,3,0,0,0,1498,1,804
"6822","비전2동","비전2동제2투","대통령선거","경기도","평택시",1988,1327,406,422,317,87,79,4,0,1,0,3,0,1,2,1322,5,661
"6823","비전2동","비전2동제3투","대통령선거","경기도","평택시",2471,1455,399,454,393,88,100,2,0,3,1,4,1,2,1,1448,7,1016
"6824","비전2동","비전2동제4투","대통령선거","경기도","평택시",2723,1635,611,340,430,117,132,0,0,0,0,0,1,0,3,1634,1,1088
"6825","비전2동","비전2동제5투","대통령선거","경기도","평택시",2883,1858,784,341,425,135,149,4,0,0,1,7,0,2,3,1851,7,1025
"6826","비전2동","비전2동제6투","대통령선거","경기도","평택시",2111,1580,647,337,363,109,111,3,0,0,0,1,0,3,2,1576,4,531
"6827","비전2동","비전2동제7투","대통령선거","경기도","평택시",1886,1434,571,308,326,109,110,2,0,0,0,3,0,0,1,1430,4,452
"6828","비전2동","비전2동제8투","대통령선거","경기도","평택시",2825,1990,731,508,483,124,127,6,1,0,0,2,2,1,3,1988,2,835
"6829","비전2동","비전2동제9투","대통령선거","경기도","평택시",3910,2868,1181,582,672,211,198,2,0,2,0,7,1,0,2,2858,10,1042
"6830","비전2동","비전2동제10투","대통령선거","경기도","평택시",2033,1608,569,409,398,117,109,0,0,0,0,0,1,0,0,1603,5,425
"6831","비전2동","비전2동제11투","대통령선거","경기도","평택시",3181,2555,1028,498,608,244,159,4,0,0,0,6,1,0,0,2548,7,626
"6832","비전2동","비전2동제12투","대통령선거","경기도","평택시",4118,2914,1325,426,682,237,229,0,0,1,0,3,0,0,7,2910,4,1204
"6833","비전2동","비전2동제13투","대통령선거","경기도","평택시",2186,1785,851,246,382,164,136,0,0,0,0,2,0,0,4,1785,0,401
"6834","세교동","관내사전투표","대통령선거","경기도","평택시",3862,3861,1749,683,826,271,306,3,0,1,1,3,1,0,5,3849,12,1
"6835","세교동","세교동제1투","대통령선거","경기도","평택시",3449,2315,847,553,582,151,169,1,0,0,0,4,1,1,2,2311,4,1134
"6836","세교동","세교동제2투","대통령선거","경기도","평택시",1426,876,261,292,219,46,49,3,0,1,0,0,1,1,0,873,3,550
"6837","세교동","세교동제3투","대통령선거","경기도","평택시",596,398,89,167,105,23,11,0,1,2,0,0,0,0,0,398,0,198
"6838","세교동","세교동제4투","대통령선거","경기도","평택시",1621,949,269,314,233,56,67,1,0,2,1,1,1,0,3,948,1,672
"6839","세교동","세교동제5투","대통령선거","경기도","평택시",2732,1911,736,340,488,158,175,2,0,2,0,2,1,1,2,1907,4,821
"6840","세교동","세교동제6투","대통령선거","경기도","평택시",3257,2294,883,423,602,174,185,2,1,1,0,6,1,0,1,2279,15,963
"6841","청북읍","관내사전투표","대통령선거","경기도","평택시",2163,2163,970,391,455,162,170,2,0,0,0,2,1,0,0,2153,10,0
"6842","청북읍","청북읍제1투","대통령선거","경기도","평택시",1816,963,240,420,202,48,41,2,1,1,1,1,0,0,1,958,5,853
"6843","청북읍","청북읍제2투","대통령선거","경기도","평택시",1603,940,246,326,245,75,40,0,0,2,0,2,1,0,0,937,3,663
"6844","청북읍","청북읍제3투","대통령선거","경기도","평택시",1008,666,155,291,149,34,26,0,0,2,0,0,0,1,2,660,6,342
"6845","청북읍","청북읍제4투","대통령선거","경기도","평택시",3095,2060,1021,202,492,147,176,6,0,2,0,6,0,0,0,2052,8,1035
"6846","청북읍","청북읍제5투","대통령선거","경기도","평택시",3677,2624,1264,332,622,187,204,3,2,0,0,2,0,1,1,2618,6,1053
"6847","청북읍","청북읍제6투","대통령선거","경기도","평택시",3134,2343,1078,304,546,205,198,1,2,0,0,0,0,1,2,2337,6,791
"6848","잘못 투입·구분된 투표지","잘못 투입·구분된 투표지","대통령선거","경기도","평택시",0,0,0,0,0,0,0,0,0,0,0,0,0,0,0,0,0,0
"6849","거소·선상투표","거소·선상투표","대통령선거","경기도","양주시",639,561,181,64,138,31,15,10,8,3,9,6,4,4,5,478,83,78
"6850","관외사전투표","관외사전투표","대통령선거","경기도","양주시",13123,13123,5800,2423,2672,992,1054,20,2,11,1,14,5,3,37,13034,89,0
"6851","재외투표","재외투표","대통령선거","경기도","양주시",805,638,407,44,95,21,62,6,0,0,0,0,0,0,1,636,2,167
"6852","백석읍","관내사전투표","대통령선거","경기도","양주시",2904,2904,1113,675,678,198,211,3,1,2,1,2,0,1,2,2887,17,0
"6853","백석읍","백석읍제1투","대통령선거","경기도","양주시",3120,1782,556,566,444,92,99,2,0,4,0,1,2,3,1,1770,12,1338
"6854","백석읍","백석읍제2투","대통령선거","경기도","양주시",2752,1718,523,515,465,93,99,2,2,1,1,2,1,1,1,1706,12,1034
"6855","백석읍","백석읍제3투","대통령선거","경기도","양주시",1937,1183,295,463,302,52,60,2,0,0,1,0,1,0,1,1177,6,754
"6856","백석읍","백석읍제4투","대통령선거","경기도","양주시",3399,2250,692,606,648,135,153,2,0,0,2,0,2,0,3,2243,7,1149
"6857","백석읍","백석읍제5투","대통령선거","경기도","양주시",2169,1326,419,416,332,66,78,2,0,0,0,3,0,2,1,1319,7,843
"6858","백석읍","백석읍제6투","대통령선거","경기도","양주시",2323,1587,560,362,443,100,112,0,0,1,1,1,0,0,0,1580,7,736
"6859","백석읍","백석읍제7투","대통령선거","경기도","양주시",2237,1598,555,358,467,97,105,4,0,0,0,2,0,1,2,1591,7,639
"6860","은현면","관내사전투표","대통령선거","경기도","양주시",786,786,288,258,156,45,32,2,0,0,1,3,0,1,0,786,0,0
"6861","은현면","은현면제1투","대통령선거","경기도","양주시",1229,735,174,308,163,47,31,1,0,1,1,0,0,2,2,730,5,494
"6862","은현면","은현면제2투","대통령선거","경기도","양주시",1805,1048,276,428,226,69,45,0,0,0,0,0,0,0,0,1044,4,757
"6863","은현면","은현면제3투","대통령선거","경기도","양주시",843,504,124,199,123,27,26,0,0,0,1,0,0,1,0,501,3,339
"6864","은현면","은현면제4투","대통령선거","경기도","양주시",781,491,106,216,107,27,28,0,0,0,0,0,1,0,1,486,5,290
"6865","남면","관내사전투표","대통령선거","경기도","양주시",977,977,376,274,193,60,68,0,1,0,0,0,0,0,3,975,2,0
"6866","남면","남면제1투","대통령선거","경기도","양주시",2045,1156,313,408,272,76,68,0,1,2,0,0,3,1,1,1145,11,889
"6867","남면","남면제2투","대통령선거","경기도","양주시",740,460,104,209,107,18,18,1,0,0,0,0,0,0,1,458,2,280
"6868","남면","남면제3투","대통령선거","경기도","양주시",1543,924,249,390,188,44,44,3,0,0,0,1,0,0,1,920,4,619
"6869","남면","남면제4투","대통령선거","경기도","양주시",674,444,113,194,91,25,13,3,0,0,0,0,1,0,2,442,2,230
"6870","광적면","관내사전투표","대통령선거","경기도","양주시",2426,2426,835,741,555,128,129,2,0,4,0,4,1,5,3,2407,19,0
"6871","광적면","광적면제1투","대통령선거","경기도","양주시",3795,1984,654,554,528,112,114,3,0,1,0,0,0,0,3,1969,15,1811
"6872","광적면","광적면제2투","대통령선거","경기도","양주시",1955,1142,352,365,290,59,65,1,0,1,0,1,0,1,1,1136,6,813
"6873","광적면","광적면제3투","대통령선거","경기도","양주시",311,210,41,91,49,11,13,0,0,0,0,1,1,1,0,208,2,101
"6874","광적면","광적면제4투","대통령선거","경기도","양주시",1153,742,186,293,170,44,40,0,0,1,0,1,2,1,1,739,3,411
"6875","장흥면","관내사전투표","대통령선거","경기도","양주시",1275,1275,420,396,286,98,60,4,0,0,4,1,0,0,1,1270,5,0
"6876","장흥면","장흥면제1투","대통령선거","경기도","양주시",2957,1836,497,710,424,73,107,3,0,1,4,1,2,0,2,1824,12,1121
"6877","장흥면","장흥면제2투","대통령선거","경기도","양주시",1204,809,237,279,194,48,44,2,0,1,0,0,0,0,0,805,4,395
"6878","장흥면","장흥면제3투","대통령선거","경기도","양주시",2290,1515,478,520,368,63,65,3,0,2,1,3,0,1,3,1507,8,775
"6879","양주1동","관내사전투표","대통령선거","경기도","양주시",1051,1051,423,234,220,74,89,1,0,3,1,1,0,0,2,1048,3,0
"6880","양주1동","양주1동제1투","대통령선거","경기도","양주시",1481,915,226,378,226,39,37,1,0,2,1,1,0,0,2,913,2,566
"6881","양주1동","양주1동제2투","대통령선거","경기도","양주시",876,617,153,240,146,35,37,2,0,1,0,0,0,0,0,614,3,259
"6882","양주1동","양주1동제3투","대통령선거","경기도","양주시",2011,1310,400,395,346,73,88,2,0,0,0,0,0,1,3,1308,2,701
"6883","양주2동","관내사전투표","대통령선거","경기도","양주시",6054,6054,2898,1116,1205,371,420,5,3,1,0,7,1,3,6,6036,18,0
"6884","양주2동","양주2동제1투","대통령선거","경기도","양주시",3139,2125,827,469,524,159,132,3,0,1,0,1,2,0,2,2120,5,1014
"6885","양주2동","양주2동제2투","대통령선거","경기도","양주시",3354,2342,966,525,545,150,133,5,0,2,1,1,0,1,7,2336,6,1012
"6886","양주2동","양주2동제3투","대통령선거","경기도","양주시",3287,2323,966,521,549,131,134,1,1,1,0,5,0,1,4,2314,9,964
"6887","양주2동","양주2동제4투","대통령선거","경기도","양주시",2705,1955,821,444,429,112,126,1,0,1,3,5,1,1,2,1946,9,750
"6888","양주2동","양주2동제5투","대통령선거","경기도","양주시",3746,2776,1234,522,640,182,175,2,0,6,2,2,2,0,4,2771,5,970
"6889","양주2동","양주2동제6투","대통령선거","경기도","양주시",3002,2114,808,520,527,113,121,3,0,5,1,1,1,1,0,2101,13,888
"6890","양주2동","양주2동제7투","대통령선거","경기도","양주시",2865,2008,865,386,471,145,123,2,2,0,3,2,0,1,0,2000,8,857
"6891","양주2동","양주2동제8투","대통령선거","경기도","양주시",3093,1881,659,475,497,106,121,3,1,2,2,0,2,0,2,1870,11,1212
"6892","양주2동","양주2동제9투","대통령선거","경기도","양주시",3004,1979,840,337,498,138,150,5,0,2,0,2,2,0,1,1975,4,1025
"6893","양주2동","양주2동제10투","대통령선거","경기도","양주시",1975,1458,725,206,322,85,111,5,0,2,0,1,0,0,0,1457,1,517
"6894","회천1동","관내사전투표","대통령선거","경기도","양주시",1555,1555,633,342,352,110,106,1,0,0,0,3,0,2,1,1550,5,0
"6895","회천1동","회천1동제1투","대통령선거","경기도","양주시",2875,1875,672,466,493,128,107,1,0,0,0,1,0,1,1,1870,5,1000
"6896","회천1동","회천1동제2투","대통령선거","경기도","양주시",2639,1671,580,448,424,103,101,1,0,3,1,0,0,1,3,1665,6,968
"6897","회천1동","회천1동제3투","대통령선거","경기도","양주시",883,543,121,233,140,26,20,0,0,0,1,0,0,0,1,542,1,340
"6898","회천2동","관내사전투표","대통령선거","경기도","양주시",3291,3291,1461,667,671,222,239,4,1,3,0,1,2,1,3,3275,16,0
"6899","회천2동","회천2동제1투","대통령선거","경기도","양주시",3259,1932,738,412,504,119,141,5,3,2,0,2,1,0,1,1928,4,1327
"6900","회천2동","회천2동제2투","대통령선거","경기도","양주시",3253,1897,707,469,459,126,120,1,0,2,1,0,1,2,3,1891,6,1356
"6901","회천2동","회천2동제3투","대통령선거","경기도","양주시",2029,1330,473,307,356,79,100,1,0,1,0,0,2,2,1,1322,8,699
"6902","회천2동","회천2동제4투","대통령선거","경기도","양주시",2830,1894,693,464,490,100,133,0,0,2,0,1,1,1,3,1888,6,936
"6903","회천2동","회천2동제5투","대통령선거","경기도","양주시",2841,2059,837,476,470,119,136,5,2,1,0,3,0,0,2,2051,8,782
"6904","회천2동","회천2동제6투","대통령선거","경기도","양주시",3783,2389,839,588,630,136,178,1,0,0,0,0,2,1,4,2379,10,1394
"6905","회천3동","관내사전투표","대통령선거","경기도","양주시",4142,4142,1862,819,819,297,311,5,1,4,0,2,2,0,3,4125,17,0
"6906","회천3동","회천3동제1투","대통령선거","경기도","양주시",2081,1389,489,366,340,99,77,3,1,0,1,1,1,1,2,1381,8,692
"6907","회천3동","회천3동제2투","대통령선거","경기도","양주시",3107,2020,826,400,495,140,141,3,0,2,0,3,1,0,1,2012,8,1087
"6908","회천3동","회천3동제3투","대통령선거","경기도","양주시",3200,2050,799,438,517,135,147,1,1,2,0,3,0,1,0,2044,6,1150
"6909","회천3동","회천3동제4투","대통령선거","경기도","양주시",2185,1624,565,459,399,86,105,0,1,0,0,2,0,0,0,1617,7,561
"6910","회천3동","회천3동제5투","대통령선거","경기도","양주시",2626,1759,654,353,453,138,144,0,2,3,1,2,0,1,2,1753,6,867
"6911","회천3동","회천3동제6투","대통령선거","경기도","양주시",3069,2170,831,523,539,144,126,0,0,1,1,0,0,0,1,2166,4,899
"6912","회천4동","관내사전투표","대통령선거","경기도","양주시",1758,1758,793,321,378,130,121,3,0,2,1,1,0,1,4,1755,3,0
"6913","회천4동","회천4동제1투","대통령선거","경기도","양주시",2293,1403,539,384,317,71,76,3,0,1,1,0,0,0,4,1396,7,890
"6914","회천4동","회천4동제2투","대통령선거","경기도","양주시",3610,2294,900,520,559,144,149,4,0,1,0,4,1,3,2,2287,7,1316
"6915","회천4동","회천4동제3투","대통령선거","경기도","양주시",1759,1257,539,191,345,86,88,0,0,2,0,0,0,0,2,1253,4,502
"6916","잘못 투입·구분된 투표지","잘못 투입·구분된 투표지","대통령선거","경기도","양주시",0,0,0,0,0,0,0,0,0,0,0,0,0,0,0,0,0,0
"6917","거소·선상투표","거소·선상투표","대통령선거","경기도","동두천시",218,203,50,55,64,7,10,2,0,0,0,1,0,0,2,191,12,15
"6918","관외사전투표","관외사전투표","대통령선거","경기도","동두천시",5027,5027,2212,807,1080,413,437,7,3,2,2,4,1,2,13,4983,44,0
"6919","재외투표","재외투표","대통령선거","경기도","동두천시",387,244,129,28,39,12,32,1,0,2,0,0,0,0,0,243,1,143
"6920","생연1동","관내사전투표","대통령선거","경기도","동두천시",1020,1020,387,264,223,58,77,1,0,2,0,1,0,1,1,1015,5,0
"6921","생연1동","생연1동제1투","대통령선거","경기도","동두천시",3043,1597,474,564,357,86,94,5,0,4,0,1,2,1,0,1588,9,1446
"6922","생연1동","생연1동제2투","대통령선거","경기도","동두천시",1809,1071,340,391,215,54,66,0,0,1,0,0,0,1,2,1070,1,738
"6923","생연2동","관내사전투표","대통령선거","경기도","동두천시",1292,1292,488,351,283,71,89,1,0,1,1,1,0,1,2,1289,3,0
"6924","생연2동","생연2동제1투","대통령선거","경기도","동두천시",1110,622,155,242,159,25,33,0,0,1,0,2,1,1,0,619,3,488
"6925","생연2동","생연2동제2투","대통령선거","경기도","동두천시",1679,1028,299,337,281,39,56,0,0,1,0,0,2,1,3,1019,9,651
"6926","생연2동","생연2동제3투","대통령선거","경기도","동두천시",1159,688,189,292,140,31,28,1,1,1,0,1,1,0,1,686,2,471
"6927","생연2동","생연2동제4투","대통령선거","경기도","동두천시",2285,1588,535,419,416,90,107,4,0,1,2,0,0,1,1,1576,12,697
"6928","생연2동","생연2동제5투","대통령선거","경기도","동두천시",1655,1128,403,303,266,68,78,0,0,4,0,1,0,0,0,1123,5,527
"6929","중앙동","관내사전투표","대통령선거","경기도","동두천시",1121,1121,378,406,203,52,63,3,0,1,1,3,1,1,2,1114,7,0
"6930","중앙동","중앙동제1투","대통령선거","경기도","동두천시",2425,1221,327,456,308,57,59,1,0,2,0,2,0,1,2,1215,6,1204
"6931","중앙동","중앙동제2투","대통령선거","경기도","동두천시",1644,895,240,342,223,36,42,1,2,0,0,0,2,2,0,890,5,749
"6932","보산동","관내사전투표","대통령선거","경기도","동두천시",535,535,193,179,99,34,27,1,0,0,1,0,0,1,0,535,0,0
"6933","보산동","보산동투표소","대통령선거","경기도","동두천시",2326,1174,310,445,296,54,59,0,0,1,1,0,1,1,1,1169,5,1152
"6934","불현동","관내사전투표","대통령선거","경기도","동두천시",2867,2867,1223,743,535,135,203,5,0,2,0,4,1,3,2,2856,11,0
"6935","불현동","불현동제1투","대통령선거","경기도","동두천시",3606,2336,732,708,583,121,165,4,0,1,0,2,0,0,4,2320,16,1270
"6936","불현동","불현동제2투","대통령선거","경기도","동두천시",2812,1340,407,432,318,92,81,3,1,0,1,1,0,0,0,1336,4,1472
"6937","불현동","불현동제3투","대통령선거","경기도","동두천시",2016,1184,372,354,307,49,87,2,0,1,0,0,0,0,3,1175,9,832
"6938","불현동","불현동제4투","대통령선거","경기도","동두천시",3424,2180,714,615,520,150,163,1,1,1,0,0,0,0,2,2167,13,1244
"6939","불현동","불현동제5투","대통령선거","경기도","동두천시",3540,2209,779,606,551,128,122,3,0,2,1,1,1,0,3,2197,12,1331
"6940","불현동","불현동제6투","대통령선거","경기도","동두천시",1286,744,193,281,175,31,47,2,1,0,0,2,0,2,3,737,7,542
"6941","불현동","불현동제7투","대통령선거","경기도","동두천시",750,446,110,197,93,23,16,0,0,0,0,0,0,1,3,443,3,304
"6942","송내동","관내사전투표","대통령선거","경기도","동두천시",3562,3562,1710,654,685,215,270,5,0,1,1,3,1,1,4,3550,12,0
"6943","송내동","송내동제1투","대통령선거","경기도","동두천시",4402,2776,1057,635,676,185,202,2,0,2,0,3,0,3,2,2767,9,1626
"6944","송내동","송내동제2투","대통령선거","경기도","동두천시",3123,2245,890,473,544,152,174,4,1,1,0,1,0,0,2,2242,3,878
"6945","송내동","송내동제3투","대통령선거","경기도","동두천시",3557,2245,837,561,537,143,153,3,0,1,0,1,1,1,3,2241,4,1312
"6946","송내동","송내동제4투","대통령선거","경기도","동두천시",3875,2548,887,662,625,178,168,4,0,7,1,4,0,2,1,2539,9,1327
"6947","송내동","송내동제5투","대통령선거","경기도","동두천시",601,382,92,161,92,14,20,0,0,0,1,0,0,0,0,380,2,219
"6948","소요동","관내사전투표","대통령선거","경기도","동두천시",833,833,309,233,172,49,56,3,0,0,1,5,1,0,0,829,4,0
"6949","소요동","소요동제1투","대통령선거","경기도","동두천시",1352,681,199,257,161,32,25,1,0,2,1,0,0,0,1,679,2,671
"6950","소요동","소요동제2투","대통령선거","경기도","동두천시",2169,1336,399,436,316,70,94,11,0,2,0,1,0,0,3,1332,4,833
"6951","소요동","소요동제3투","대통령선거","경기도","동두천시",548,360,102,154,77,10,13,1,0,0,0,1,0,0,0,358,2,188
"6952","소요동","소요동제4투","대통령선거","경기도","동두천시",1508,1025,256,398,266,46,46,0,1,1,1,0,0,1,3,1019,6,483
"6953","소요동","소요동제5투","대통령선거","경기도","동두천시",1132,721,185,271,162,31,34,1,0,0,2,3,4,1,3,697,24,411
"6954","상패동","관내사전투표","대통령선거","경기도","동두천시",721,721,293,183,147,47,47,1,0,0,0,1,0,0,0,719,2,0
"6955","상패동","상패동제1투","대통령선거","경기도","동두천시",2517,1427,369,526,375,71,73,2,0,0,0,0,1,2,2,1421,6,1090
"6956","상패동","상패동제2투","대통령선거","경기도","동두천시",753,463,125,161,119,28,27,0,0,1,0,1,0,1,0,463,0,290
"6957","상패동","상패동제3투","대통령선거","경기도","동두천시",646,402,95,151,120,14,19,0,0,1,0,0,0,1,0,401,1,244
"6958","잘못 투입·구분된 투표지","잘못 투입·구분된 투표지","대통령선거","경기도","동두천시",0,0,0,0,0,0,0,0,0,0,0,0,0,0,0,0,0,0
"6959","거소·선상투표","거소·선상투표","대통령선거","경기도","안산시상록구",582,561,204,91,185,36,15,1,1,0,3,2,0,0,1,539,22,21
"6960","관외사전투표","관외사전투표","대통령선거","경기도","안산시상록구",23679,23671,11196,2952,5440,1750,1950,51,12,13,8,21,13,9,51,23466,205,8
"6961","재외투표","재외투표","대통령선거","경기도","안산시상록구",1570,1231,783,69,167,48,157,2,0,0,1,0,0,1,1,1229,2,339
"6962","일동","관내사전투표","대통령선거","경기도","안산시상록구",3940,3940,1932,598,873,214,288,5,2,7,0,2,4,0,3,3928,12,0
"6963","일동","일동제1투","대통령선거","경기도","안산시상록구",4342,2448,996,480,629,126,196,2,3,2,0,1,2,2,1,2440,8,1894
"6964","일동","일동제2투","대통령선거","경기도","안산시상록구",3879,2401,962,484,640,138,160,2,0,3,1,2,0,0,3,2395,6,1478
"6965","일동","일동제3투","대통령선거","경기도","안산시상록구",5094,3253,1378,593,829,181,246,3,0,3,1,2,0,0,2,3238,15,1841
"6966","일동","일동제4투","대통령선거","경기도","안산시상록구",4070,2601,1100,519,618,144,191,3,0,1,1,4,1,1,2,2585,16,1469
"6967","이동","관내사전투표","대통령선거","경기도","안산시상록구",3011,3011,1590,395,617,171,218,2,1,8,0,0,0,1,1,3004,7,0
"6968","이동","이동제1투","대통령선거","경기도","안산시상록구",2804,1747,684,375,449,105,119,0,1,2,0,1,0,1,2,1739,8,1057
"6969","이동","이동제2투","대통령선거","경기도","안산시상록구",3205,1748,762,323,442,90,113,3,0,1,0,2,0,1,3,1740,8,1457
"6970","이동","이동제3투","대통령선거","경기도","안산시상록구",3546,1979,836,338,511,132,150,0,0,4,0,1,2,0,2,1976,3,1567
"6971","이동","이동제4투","대통령선거","경기도","안산시상록구",2697,1525,686,268,358,110,96,1,1,0,0,0,0,0,2,1522,3,1172
"6972","이동","이동제5투","대통령선거","경기도","안산시상록구",4374,2751,1189,515,660,162,206,3,0,1,1,1,2,0,1,2741,10,1623
"6973","이동","이동제6투","대통령선거","경기도","안산시상록구",2237,1768,717,360,438,128,117,0,0,2,0,0,1,0,1,1764,4,469
"6974","사1동","관내사전투표","대통령선거","경기도","안산시상록구",5357,5357,2647,689,1179,356,444,5,2,7,1,6,0,1,2,5339,18,0
"6975","사1동","사1동제1투","대통령선거","경기도","안산시상록구",3083,1789,815,276,435,108,139,1,0,0,1,1,1,1,2,1780,9,1294
"6976","사1동","사1동제2투","대통령선거","경기도","안산시상록구",4400,2776,1133,480,763,176,199,3,0,5,0,4,0,3,4,2770,6,1624
"6977","사1동","사1동제3투","대통령선거","경기도","안산시상록구",3166,1743,731,294,435,130,142,3,0,0,1,2,0,0,2,1740,3,1423
"6978","사1동","사1동제4투","대통령선거","경기도","안산시상록구",2627,2016,871,453,459,114,98,2,0,5,1,0,1,0,1,2005,11,611
"6979","사1동","사1동제5투","대통령선거","경기도","안산시상록구",2445,2030,1009,238,470,128,171,5,0,1,0,3,1,0,0,2026,4,415
"6980","사1동","사1동제6투","대통령선거","경기도","안산시상록구",3750,2239,981,389,579,120,152,2,0,2,2,3,1,1,1,2233,6,1511
"6981","사1동","사1동제7투","대통령선거","경기도","안산시상록구",3004,1935,820,375,450,134,142,1,0,4,0,2,2,0,0,1930,5,1069
"6982","사1동","사1동제8투","대통령선거","경기도","안산시상록구",2162,1430,643,241,352,83,98,2,0,2,1,1,0,0,1,1424,6,732
"6983","사2동","관내사전투표","대통령선거","경기도","안산시상록구",4264,4264,1951,719,956,288,308,5,0,2,0,4,1,1,5,4240,24,0
"6984","사2동","사2동제1투","대통령선거","경기도","안산시상록구",2125,1665,600,358,455,138,104,3,0,0,0,3,0,0,0,1661,4,460
"6985","사2동","사2동제2투","대통령선거","경기도","안산시상록구",3006,2237,883,468,551,179,139,0,1,0,2,1,0,2,3,2229,8,769
"6986","사2동","사2동제3투","대통령선거","경기도","안산시상록구",2246,1737,678,372,454,119,104,3,0,1,0,1,0,0,1,1733,4,509
"6987","사2동","사2동제4투","대통령선거","경기도","안산시상록구",4874,3041,1349,480,773,162,254,3,0,3,1,6,2,1,1,3035,6,1833
"6988","사2동","사2동제5투","대통령선거","경기도","안산시상록구",4707,2904,1283,432,751,181,235,1,0,7,0,1,2,0,3,2896,8,1803
"6989","사2동","사2동제6투","대통령선거","경기도","안산시상록구",4076,2717,1154,458,711,183,191,3,0,3,0,3,2,2,0,2710,7,1359
"6990","사3동","관내사전투표","대통령선거","경기도","안산시상록구",2680,2680,1243,482,591,185,169,1,0,1,0,3,0,0,0,2675,5,0
"6991","사3동","사3동제1투","대통령선거","경기도","안산시상록구",3994,2773,1082,590,652,245,183,4,0,2,1,1,0,0,2,2762,11,1221
"6992","사3동","사3동제2투","대통령선거","경기도","안산시상록구",3183,2481,1056,444,641,179,158,0,0,0,0,0,0,0,2,2480,1,702
"6993","사3동","사3동제3투","대통령선거","경기도","안산시상록구",3706,2869,1110,610,768,204,161,9,0,0,3,0,0,1,1,2867,2,837
"6994","본오1동","관내사전투표","대통령선거","경기도","안산시상록구",4195,4195,2079,638,922,227,297,5,0,5,2,2,3,0,4,4184,11,0
"6995","본오1동","본오1동제1투","대통령선거","경기도","안산시상록구",3596,2174,884,434,555,128,149,0,0,1,1,1,2,1,2,2158,16,1422
"6996","본오1동","본오1동제2투","대통령선거","경기도","안산시상록구",3458,2023,871,326,543,106,159,3,0,4,0,2,2,1,0,2017,6,1435
"6997","본오1동","본오1동제3투","대통령선거","경기도","안산시상록구",3459,2007,821,374,522,113,157,1,0,1,2,2,1,4,1,1999,8,1452
"6998","본오1동","본오1동제4투","대통령선거","경기도","안산시상록구",3338,2058,873,323,567,112,161,4,0,1,0,1,0,2,4,2048,10,1280
"6999","본오1동","본오1동제5투","대통령선거","경기도","안산시상록구",3981,2422,1078,403,576,130,196,5,1,4,2,6,2,2,3,2408,14,1559
"7000","본오1동","본오1동제6투","대통령선거","경기도","안산시상록구",3446,1941,831,332,493,127,146,0,0,1,0,1,0,1,0,1932,9,1505
"7001","본오1동","본오1동제7투","대통령선거","경기도","안산시상록구",3286,1975,866,300,515,110,157,2,1,3,0,3,1,2,1,1961,14,1311
"7002","본오1동","본오1동제8투","대통령선거","경기도","안산시상록구",2296,1467,495,377,391,98,91,2,1,1,1,1,2,1,0,1461,6,829
"7003","본오2동","관내사전투표","대통령선거","경기도","안산시상록구",3959,3959,2010,542,855,216,302,3,1,5,1,3,1,2,5,3946,13,0
"7004","본오2동","본오2동제1투","대통령선거","경기도","안산시상록구",3042,1730,716,316,468,93,121,0,1,1,1,1,0,1,3,1722,8,1312
"7005","본오2동","본오2동제2투","대통령선거","경기도","안산시상록구",2654,1595,631,307,450,88,103,1,0,1,0,5,2,1,2,1591,4,1059
"7006","본오2동","본오2동제3투","대통령선거","경기도","안산시상록구",4001,2382,1012,433,629,129,157,3,2,3,0,1,2,1,6,2378,4,1619
"7007","본오2동","본오2동제4투","대통령선거","경기도","안산시상록구",2448,1866,764,363,484,133,107,4,0,0,0,3,0,0,1,1859,7,582
"7008","본오2동","본오2동제5투","대통령선거","경기도","안산시상록구",4144,3212,1389,624,732,205,237,6,2,1,0,5,0,0,2,3203,9,932
"7009","본오2동","본오2동제6투","대통령선거","경기도","안산시상록구",2606,2081,830,389,569,125,141,6,1,1,1,3,0,0,1,2067,14,525
"7010","본오3동","관내사전투표","대통령선거","경기도","안산시상록구",4429,4429,2172,635,914,284,383,10,0,7,1,4,2,1,2,4415,14,0
"7011","본오3동","본오3동제1투","대통령선거","경기도","안산시상록구",2652,1608,655,303,407,99,132,2,0,2,0,1,0,0,2,1603,5,1044
"7012","본오3동","본오3동제2투","대통령선거","경기도","안산시상록구",2283,1850,767,312,484,140,127,4,0,3,1,2,1,1,2,1844,6,433
"7013","본오3동","본오3동제3투","대통령선거","경기도","안산시상록구",4243,2803,1221,487,698,175,200,5,1,3,0,1,1,0,1,2793,10,1440
"7014","본오3동","본오3동제4투","대통령선거","경기도","안산시상록구",3613,2151,907,417,525,140,150,2,0,5,0,0,0,0,1,2147,4,1462
"7015","본오3동","본오3동제5투","대통령선거","경기도","안산시상록구",1718,1363,542,276,339,93,97,3,0,1,0,1,0,4,2,1358,5,355
"7016","부곡동","관내사전투표","대통령선거","경기도","안산시상록구",3090,3090,1476,471,717,173,233,0,1,1,0,0,3,1,1,3077,13,0
"7017","부곡동","부곡동제1투","대통령선거","경기도","안산시상록구",4299,2670,1003,576,708,152,195,3,1,4,0,5,2,2,5,2656,14,1629
"7018","부곡동","부곡동제2투","대통령선거","경기도","안산시상록구",3819,2240,836,438,651,140,152,2,2,2,0,3,1,0,2,2229,11,1579
"7019","부곡동","부곡동제3투","대통령선거","경기도","안산시상록구",3106,2024,866,338,525,129,147,0,0,1,1,0,2,0,2,2011,13,1082
"7020","부곡동","부곡동제4투","대통령선거","경기도","안산시상록구",3932,2588,1002,481,701,172,209,1,1,1,0,4,0,0,4,2576,12,1344
"7021","월피동","관내사전투표","대통령선거","경기도","안산시상록구",4495,4495,2200,633,1003,249,384,3,1,3,1,2,2,1,4,4486,9,0
"7022","월피동","월피동제1투","대통령선거","경기도","안산시상록구",4060,2302,892,441,627,143,178,1,1,6,0,1,1,2,2,2295,7,1758
"7023","월피동","월피동제2투","대통령선거","경기도","안산시상록구",4403,2774,1072,572,729,173,200,6,0,2,0,0,1,2,5,2762,12,1629
"7024","월피동","월피동제3투","대통령선거","경기도","안산시상록구",3654,2484,1082,470,562,150,202,3,0,3,0,0,1,0,4,2477,7,1170
"7025","월피동","월피동제4투","대통령선거","경기도","안산시상록구",3142,2195,994,380,506,137,159,2,0,2,2,1,0,1,2,2186,9,947
"7026","월피동","월피동제5투","대통령선거","경기도","안산시상록구",2781,2170,935,363,531,148,178,0,0,1,0,0,1,1,1,2159,11,611
"7027","월피동","월피동제6투","대통령선거","경기도","안산시상록구",2997,2360,1056,367,577,173,176,1,0,3,0,0,1,1,2,2357,3,637
"7028","월피동","월피동제7투","대통령선거","경기도","안산시상록구",3821,2518,1022,447,688,156,184,1,1,2,0,0,2,1,4,2508,10,1303
"7029","월피동","월피동제8투","대통령선거","경기도","안산시상록구",3674,2232,936,428,554,124,177,0,0,3,1,1,1,0,2,2227,5,1442
"7030","성포동","관내사전투표","대통령선거","경기도","안산시상록구",3769,3769,1772,631,796,258,291,5,1,1,0,1,0,0,1,3757,12,0
"7031","성포동","성포동제1투","대통령선거","경기도","안산시상록구",2285,1696,630,416,424,112,97,1,0,3,0,4,0,1,1,1689,7,589
"7032","성포동","성포동제2투","대통령선거","경기도","안산시상록구",3248,2467,1009,500,629,150,160,6,0,2,0,2,0,0,1,2459,8,781
"7033","성포동","성포동제3투","대통령선거","경기도","안산시상록구",3179,2516,996,568,623,163,148,7,0,2,0,1,1,2,1,2512,4,663
"7034","성포동","성포동제4투","대통령선거","경기도","안산시상록구",3734,2918,1127,651,709,212,200,6,0,2,0,2,0,0,1,2910,8,816
"7035","성포동","성포동제5투","대통령선거","경기도","안산시상록구",3711,2830,1324,430,649,191,220,2,0,3,1,1,1,1,2,2825,5,881
"7036","반월동","관내사전투표","대통령선거","경기도","안산시상록구",2837,2837,1274,561,652,136,195,2,1,2,1,0,0,1,1,2826,11,0
"7037","반월동","반월동제1투","대통령선거","경기도","안산시상록구",3582,2465,879,581,659,142,181,1,0,3,1,4,0,0,3,2454,11,1117
"7038","반월동","반월동제2투","대통령선거","경기도","안산시상록구",3339,2606,1172,507,541,193,176,6,0,0,0,2,0,0,0,2597,9,733
"7039","반월동","반월동제3투","대통령선거","경기도","안산시상록구",3034,1936,733,513,468,89,117,3,0,2,0,1,1,0,0,1927,9,1098
"7040","반월동","반월동제4투","대통령선거","경기도","안산시상록구",1748,1303,464,359,317,81,72,1,3,0,0,0,0,1,3,1301,2,445
"7041","반월동","반월동제5투","대통령선거","경기도","안산시상록구",913,596,196,164,149,44,39,0,0,2,0,1,0,0,0,595,1,317
"7042","안산동","관내사전투표","대통령선거","경기도","안산시상록구",1342,1342,567,296,325,55,83,3,0,2,0,0,1,0,2,1334,8,0
"7043","안산동","안산동제1투","대통령선거","경기도","안산시상록구",2893,1860,683,483,482,104,91,0,1,1,0,0,0,1,3,1849,11,1033
"7044","안산동","안산동제2투","대통령선거","경기도","안산시상록구",3550,2373,898,539,646,139,131,1,0,1,0,0,1,2,4,2362,11,1177
"7045","잘못 투입·구분된 투표지","잘못 투입·구분된 투표지","대통령선거","경기도","안산시상록구",0,1,0,0,0,1,0,0,0,0,0,0,0,0,0,1,0,-1
"7046","거소·선상투표","거소·선상투표","대통령선거","경기도","안산시단원구",649,604,179,172,154,31,22,1,0,0,5,3,1,1,5,574,30,45
"7047","관외사전투표","관외사전투표","대통령선거","경기도","안산시단원구",19207,19200,8842,2561,4510,1385,1629,23,5,16,5,21,14,12,35,19058,142,7
"7048","재외투표","재외투표","대통령선거","경기도","안산시단원구",1137,870,544,60,144,23,95,2,0,0,0,0,0,0,1,869,1,267
"7049","와동","관내사전투표","대통령선거","경기도","안산시단원구",4117,4117,2019,608,891,214,346,8,0,5,0,1,4,0,2,4098,19,0
"7050","와동","와동제1투","대통령선거","경기도","안산시단원구",3212,1868,715,344,556,103,132,2,0,2,2,3,4,1,0,1864,4,1344
"7051","와동","와동제2투","대통령선거","경기도","안산시단원구",4099,2621,1097,469,684,129,200,11,1,4,0,1,1,1,5,2603,18,1478
"7052","와동","와동제3투","대통령선거","경기도","안산시단원구",3674,2463,1005,435,659,164,174,2,2,4,1,2,0,0,5,2453,10,1211
"7053","와동","와동제4투","대통령선거","경기도","안산시단원구",3947,2314,944,426,599,150,172,3,0,3,1,2,3,0,3,2306,8,1633
"7054","와동","와동제5투","대통령선거","경기도","안산시단원구",3421,1577,633,316,400,89,126,3,0,2,2,1,1,0,1,1574,3,1844
"7055","와동","와동제6투","대통령선거","경기도","안산시단원구",2875,1618,702,273,402,94,125,0,1,1,3,2,2,3,3,1611,7,1257
"7056","와동","와동제7투","대통령선거","경기도","안산시단원구",4134,2326,942,412,623,128,197,4,0,1,0,1,1,0,5,2314,12,1808
"7057","와동","와동제8투","대통령선거","경기도","안산시단원구",3566,1998,906,345,481,98,147,1,0,2,1,2,2,0,1,1986,12,1568
"7058","고잔1동","관내사전투표","대통령선거","경기도","안산시단원구",3625,3625,1736,537,794,231,294,3,0,6,0,6,1,1,2,3611,14,0
"7059","고잔1동","고잔1동제1투","대통령선거","경기도","안산시단원구",3013,2017,811,404,521,113,146,4,1,2,1,5,2,1,1,2012,5,996
"7060","고잔1동","고잔1동제2투","대통령선거","경기도","안산시단원구",2069,1464,562,326,362,97,107,0,0,2,0,1,0,0,1,1458,6,605
"7061","고잔1동","고잔1동제3투","대통령선거","경기도","안산시단원구",1941,1243,513,232,302,97,77,3,0,1,0,3,0,2,4,1234,9,698
"7062","고잔1동","고잔1동제4투","대통령선거","경기도","안산시단원구",2632,1813,758,357,447,105,130,2,1,1,0,1,0,0,6,1808,5,819
"7063","고잔1동","고잔1동제5투","대통령선거","경기도","안산시단원구",3327,2184,893,421,533,134,182,1,0,3,0,2,0,1,3,2173,11,1143
"7064","고잔2동","관내사전투표","대통령선거","경기도","안산시단원구",3799,3799,1880,542,787,278,289,5,0,1,0,1,0,0,2,3785,14,0
"7065","고잔2동","고잔2동제1투","대통령선거","경기도","안산시단원구",3558,2547,1094,460,602,174,197,1,0,0,0,4,3,1,2,2538,9,1011
"7066","고잔2동","고잔2동제2투","대통령선거","경기도","안산시단원구",2452,1320,621,191,311,85,105,1,0,1,0,2,0,1,0,1318,2,1132
"7067","고잔2동","고잔2동제3투","대통령선거","경기도","안산시단원구",3024,2178,962,401,490,156,159,0,1,0,0,1,0,0,1,2171,7,846
"7068","고잔2동","고잔2동제4투","대통령선거","경기도","안산시단원구",3365,2331,930,434,583,177,183,1,0,7,0,1,1,0,2,2319,12,1034
"7069","호수동","관내사전투표","대통령선거","경기도","안산시단원구",5274,5274,2650,708,1100,372,413,4,0,4,1,1,1,3,3,5260,14,0
"7070","호수동","호수동제1투","대통령선거","경기도","안산시단원구",2695,2031,934,291,497,166,133,0,0,0,0,1,0,0,3,2025,6,664
"7071","호수동","호수동제2투","대통령선거","경기도","안산시단원구",2296,1870,732,406,499,124,102,2,0,0,0,0,0,0,1,1866,4,426
"7072","호수동","호수동제3투","대통령선거","경기도","안산시단원구",2948,1838,786,362,439,138,110,1,1,0,0,1,0,0,0,1838,0,1110
"7073","호수동","호수동제4투","대통령선거","경기도","안산시단원구",2944,2182,841,478,552,165,135,2,0,0,1,1,0,0,0,2175,7,762
"7074","호수동","호수동제5투","대통령선거","경기도","안산시단원구",3449,2795,1215,449,719,226,174,2,0,1,0,2,1,1,1,2791,4,654
"7075","호수동","호수동제6투","대통령선거","경기도","안산시단원구",3558,2907,1174,512,811,216,183,5,0,1,1,1,1,0,0,2905,2,651
"7076","호수동","호수동제7투","대통령선거","경기도","안산시단원구",3000,2254,955,395,573,156,160,2,0,0,0,0,0,1,3,2245,9,746
"7077","호수동","호수동제8투","대통령선거","경기도","안산시단원구",3291,2728,1152,550,639,189,185,2,1,2,0,1,2,0,1,2724,4,563
"7078","호수동","호수동제9투","대통령선거","경기도","안산시단원구",2083,1663,628,359,470,104,90,2,0,0,0,2,0,0,0,1655,8,420
"7079","호수동","호수동제10투","대통령선거","경기도","안산시단원구",3164,2644,1210,397,672,187,163,4,0,1,1,0,0,0,0,2635,9,520
"7080","원곡본동","관내사전투표","대통령선거","경기도","안산시단원구",2320,2320,1177,395,469,117,145,3,0,2,0,3,1,1,1,2314,6,0
"7081","원곡본동","원곡본동제1투","대통령선거","경기도","안산시단원구",1576,609,246,188,134,25,11,0,0,0,0,1,0,2,0,607,2,967
"7082","원곡본동","원곡본동제2투","대통령선거","경기도","안산시단원구",1421,617,250,194,134,17,14,3,0,0,0,0,0,0,0,612,5,804
"7083","원곡본동","원곡본동제3투","대통령선거","경기도","안산시단원구",2792,1336,574,355,279,46,67,2,1,2,0,0,0,1,2,1329,7,1456
"7084","원곡본동","원곡본동제4투","대통령선거","경기도","안산시단원구",2572,1865,705,411,476,126,137,3,0,0,0,0,0,0,0,1858,7,707
"7085","원곡본동","원곡본동제5투","대통령선거","경기도","안산시단원구",2710,2105,911,395,495,131,160,3,0,0,1,0,2,0,2,2100,5,605
"7086","원곡본동","원곡본동제6투","대통령선거","경기도","안산시단원구",2404,1235,510,245,322,65,82,3,0,1,0,0,1,2,0,1231,4,1169
"7087","원곡본동","원곡본동제7투","대통령선거","경기도","안산시단원구",2353,1647,703,303,409,101,107,0,0,2,2,5,1,1,3,1637,10,706
"7088","원곡본동","원곡본동제8투","대통령선거","경기도","안산시단원구",3113,2047,871,407,497,121,140,0,1,0,0,3,0,0,2,2042,5,1066
"7089","원곡본동","원곡본동제9투","대통령선거","경기도","안산시단원구",2746,2071,954,321,505,153,127,1,0,1,0,0,2,0,3,2067,4,675
"7090","원곡1동","관내사전투표","대통령선거","경기도","안산시단원구",1596,1596,664,372,391,67,80,2,1,1,1,2,1,1,4,1587,9,0
"7091","원곡1동","원곡1동제1투","대통령선거","경기도","안산시단원구",1584,706,264,192,184,31,31,1,1,0,0,0,0,0,0,704,2,878
"7092","원곡1동","원곡1동제2투","대통령선거","경기도","안산시단원구",2270,1328,487,333,354,63,75,0,1,0,2,0,3,0,4,1322,6,942
"7093","원곡2동","관내사전투표","대통령선거","경기도","안산시단원구",2382,2382,1086,425,558,131,164,1,1,0,1,1,1,2,1,2372,10,0
"7094","원곡2동","원곡2동제1투","대통령선거","경기도","안산시단원구",2602,1894,778,346,496,133,129,2,0,1,0,0,0,1,2,1888,6,708
"7095","원곡2동","원곡2동제2투","대통령선거","경기도","안산시단원구",2731,2050,826,450,481,129,151,4,0,0,0,1,0,1,0,2043,7,681
"7096","원곡2동","원곡2동제3투","대통령선거","경기도","안산시단원구",2922,2104,811,463,574,131,111,2,1,1,2,0,0,0,5,2101,3,818
"7097","원곡2동","원곡2동제4투","대통령선거","경기도","안산시단원구",1471,1086,439,238,277,56,71,1,1,0,0,1,0,0,0,1084,2,385
"7098","초지동","관내사전투표","대통령선거","경기도","안산시단원구",5769,5770,2898,791,1163,427,457,2,0,5,0,7,1,3,3,5757,13,-1
"7099","초지동","초지동제1투","대통령선거","경기도","안산시단원구",1992,1326,507,266,376,76,89,2,0,3,0,1,0,0,1,1321,5,666
"7100","초지동","초지동제2투","대통령선거","경기도","안산시단원구",2089,1696,670,336,437,140,103,0,0,0,1,0,0,0,0,1687,9,393
"7101","초지동","초지동제3투","대통령선거","경기도","안산시단원구",2292,1690,725,273,433,129,120,6,0,1,0,0,0,0,0,1687,3,602
"7102","초지동","초지동제4투","대통령선거","경기도","안산시단원구",2190,1703,710,249,460,140,136,1,0,1,0,1,0,0,0,1698,5,487
"7103","초지동","초지동제5투","대통령선거","경기도","안산시단원구",2019,1323,577,204,352,100,82,2,0,0,1,0,0,0,2,1320,3,696
"7104","초지동","초지동제6투","대통령선거","경기도","안산시단원구",2591,1814,756,339,473,109,115,3,0,0,0,6,2,1,3,1807,7,777
"7105","초지동","초지동제7투","대통령선거","경기도","안산시단원구",3052,2149,920,401,555,116,134,3,0,1,0,4,2,1,4,2141,8,903
"7106","초지동","초지동제8투","대통령선거","경기도","안산시단원구",3108,2294,1055,334,565,161,167,2,0,5,0,0,0,2,1,2292,2,814
"7107","초지동","초지동제9투","대통령선거","경기도","안산시단원구",2817,2084,935,319,526,136,159,1,1,0,0,2,1,1,0,2081,3,733
"7108","초지동","초지동제10투","대통령선거","경기도","안산시단원구",2411,1554,719,240,375,112,96,2,0,2,0,1,0,0,1,1548,6,857
"7109","선부1동","관내사전투표","대통령선거","경기도","안산시단원구",1702,1702,804,255,374,121,137,2,0,0,0,2,1,1,0,1697,5,0
"7110","선부1동","선부1동제1투","대통령선거","경기도","안산시단원구",2026,1190,475,235,309,69,89,2,0,2,0,0,2,0,2,1185,5,836
"7111","선부1동","선부1동제2투","대통령선거","경기도","안산시단원구",1930,1364,533,283,343,83,110,1,1,0,0,1,2,0,4,1361,3,566
"7112","선부1동","선부1동제3투","대통령선거","경기도","안산시단원구",2156,1479,651,249,354,85,132,1,0,0,0,1,0,1,1,1475,4,677
"7113","선부1동","선부1동제4투","대통령선거","경기도","안산시단원구",2218,1496,594,350,379,88,66,4,1,1,1,1,2,1,1,1489,7,722
"7114","선부2동","관내사전투표","대통령선거","경기도","안산시단원구",2464,2464,1130,413,606,144,156,2,1,3,1,0,2,1,2,2461,3,0
"7115","선부2동","선부2동제1투","대통령선거","경기도","안산시단원구",2756,1429,569,293,400,75,81,1,0,2,0,0,0,0,3,1424,5,1327
"7116","선부2동","선부2동제2투","대통령선거","경기도","안산시단원구",2570,1642,651,314,450,96,118,1,0,2,0,0,0,0,2,1634,8,928
"7117","선부2동","선부2동제3투","대통령선거","경기도","안산시단원구",3607,2100,800,413,555,144,158,6,1,7,1,0,0,3,4,2092,8,1507
"7118","선부2동","선부2동제4투","대통령선거","경기도","안산시단원구",3596,2089,856,392,582,107,130,2,0,4,1,1,2,0,1,2078,11,1507
"7119","선부2동","선부2동제5투","대통령선거","경기도","안산시단원구",2255,1231,453,296,328,62,80,5,1,1,0,1,0,0,0,1227,4,1024
"7120","선부3동","관내사전투표","대통령선거","경기도","안산시단원구",3039,3038,1467,492,655,183,220,0,0,2,2,1,0,1,2,3025,13,1
"7121","선부3동","선부3동제1투","대통령선거","경기도","안산시단원구",2995,1646,734,247,440,98,112,1,0,0,0,2,1,1,3,1639,7,1349
"7122","선부3동","선부3동제2투","대통령선거","경기도","안산시단원구",3126,1774,736,375,459,88,109,1,0,1,0,1,0,1,2,1773,1,1352
"7123","선부3동","선부3동제3투","대통령선거","경기도","안산시단원구",3051,1681,708,254,473,96,126,2,1,3,0,1,0,2,4,1670,11,1370
"7124","선부3동","선부3동제4투","대통령선거","경기도","안산시단원구",4104,3225,1348,587,835,192,238,3,1,4,0,3,0,0,2,3213,12,879
"7125","선부3동","선부3동제5투","대통령선거","경기도","안산시단원구",3128,2173,984,356,523,129,166,1,0,2,0,1,0,3,1,2166,7,955
"7126","선부3동","선부3동제6투","대통령선거","경기도","안산시단원구",4034,3031,1250,592,768,182,210,2,0,4,2,1,0,0,6,3017,14,1003
"7127","선부3동","선부3동제7투","대통령선거","경기도","안산시단원구",2230,1621,696,253,398,125,135,0,0,4,2,2,1,0,1,1617,4,609
"7128","대부동","관내사전투표","대통령선거","경기도","안산시단원구",923,923,270,347,232,36,28,0,0,2,0,1,0,0,1,917,6,0
"7129","대부동","대부동제1투","대통령선거","경기도","안산시단원구",1968,1095,282,437,262,55,49,0,0,2,1,1,0,0,0,1089,6,873
"7130","대부동","대부동제2투","대통령선거","경기도","안산시단원구",1593,976,199,458,233,52,22,5,0,0,0,1,0,1,0,971,5,617
"7131","대부동","대부동제3투","대통령선거","경기도","안산시단원구",1937,1200,288,553,265,41,37,2,1,1,1,0,0,2,4,1195,5,737
"7132","잘못 투입·구분된 투표지","잘못 투입·구분된 투표지","대통령선거","경기도","안산시단원구",0,0,0,0,0,0,0,0,0,0,0,0,0,0,0,0,0,0
"7133","거소·선상투표","거소·선상투표","대통령선거","경기도","고양시덕양구",884,825,260,131,255,53,61,5,2,3,2,1,6,2,6,787,38,59
"7134","관외사전투표","관외사전투표","대통령선거","경기도","고양시덕양구",32048,32042,14818,4661,6445,2195,3629,32,6,20,22,24,14,8,27,31901,141,6
"7135","재외투표","재외투표","대통령선거","경기도","고양시덕양구",3145,2466,1468,178,335,109,357,10,1,0,0,0,0,1,1,2460,6,679
"7136","주교동","관내사전투표","대통령선거","경기도","고양시덕양구",2632,2632,1105,519,518,159,300,5,0,2,0,2,0,2,5,2617,15,0
"7137","주교동","주교동제1투","대통령선거","경기도","고양시덕양구",2251,1349,444,347,325,69,149,1,1,2,1,1,1,1,0,1342,7,902
"7138","주교동","주교동제2투","대통령선거","경기도","고양시덕양구",3354,2031,663,486,507,111,239,3,0,0,0,1,1,0,4,2015,16,1323
"7139","주교동","주교동제3투","대통령선거","경기도","고양시덕양구",2661,1573,558,354,380,78,191,2,0,1,0,0,1,0,2,1567,6,1088
"7140","주교동","주교동제4투","대통령선거","경기도","고양시덕양구",2977,1863,647,447,429,77,240,9,0,4,1,1,0,1,0,1856,7,1114
"7141","원신동","관내사전투표","대통령선거","경기도","고양시덕양구",1359,1359,615,237,267,75,159,0,0,1,0,2,0,0,0,1356,3,0
"7142","원신동","원신동제1투","대통령선거","경기도","고양시덕양구",1653,1273,513,217,285,99,154,0,0,1,0,0,0,0,0,1269,4,380
"7143","원신동","원신동제2투","대통령선거","경기도","고양시덕양구",848,568,138,194,124,42,64,1,0,0,0,0,0,0,3,566,2,280
"7144","원신동","원신동제3투","대통령선거","경기도","고양시덕양구",3728,2693,1090,542,616,139,286,3,0,2,1,0,1,2,4,2686,7,1035
"7145","원신동","원신동제4투","대통령선거","경기도","고양시덕양구",2470,1994,927,292,420,119,232,0,0,0,1,1,0,0,0,1992,2,476
"7146","원신동","원신동제5투","대통령선거","경기도","고양시덕양구",3091,2323,1032,378,494,130,273,2,0,1,2,1,0,1,1,2315,8,768
"7147","흥도동","관내사전투표","대통령선거","경기도","고양시덕양구",2691,2691,1254,389,487,154,393,3,0,0,0,2,0,2,0,2684,7,0
"7148","흥도동","흥도동제1투","대통령선거","경기도","고양시덕양구",1140,690,150,257,157,31,92,3,0,0,0,0,0,0,0,690,0,450
"7149","흥도동","흥도동제2투","대통령선거","경기도","고양시덕양구",2140,1525,605,340,361,75,135,2,0,0,1,1,1,0,0,1521,4,615
"7150","흥도동","흥도동제3투","대통령선거","경기도","고양시덕양구",3866,3011,1288,537,639,141,396,0,0,0,2,2,0,0,1,3006,5,855
"7151","흥도동","흥도동제4투","대통령선거","경기도","고양시덕양구",3185,2582,1249,308,492,159,365,0,0,1,0,0,0,0,0,2574,8,603
"7152","흥도동","흥도동제5투","대통령선거","경기도","고양시덕양구",988,757,362,93,129,77,93,0,0,0,1,1,0,0,0,756,1,231
"7153","흥도동","흥도동제6투","대통령선거","경기도","고양시덕양구",2838,2139,876,418,486,116,224,6,0,3,2,2,0,0,1,2134,5,699
"7154","흥도동","흥도동제7투","대통령선거","경기도","고양시덕양구",3176,2519,1009,495,585,157,258,1,0,1,1,3,0,1,2,2513,6,657
"7155","흥도동","흥도동제8투","대통령선거","경기도","고양시덕양구",2065,1759,850,226,355,89,229,0,0,1,2,1,0,0,2,1755,4,306
"7156","성사1동","관내사전투표","대통령선거","경기도","고양시덕양구",3434,3434,1529,631,700,187,360,6,0,1,2,3,1,0,1,3421,13,0
"7157","성사1동","성사1동제1투","대통령선거","경기도","고양시덕양구",3027,1822,644,431,439,80,206,6,0,4,3,0,2,0,0,1815,7,1205
"7158","성사1동","성사1동제2투","대통령선거","경기도","고양시덕양구",3161,1941,667,459,473,113,205,3,0,5,3,1,2,1,1,1933,8,1220
"7159","성사1동","성사1동제3투","대통령선거","경기도","고양시덕양구",3255,1946,682,448,465,95,231,7,2,2,0,0,1,0,3,1936,10,1309
"7160","성사1동","성사1동제4투","대통령선거","경기도","고양시덕양구",3343,2712,1090,543,644,172,245,7,0,3,1,0,0,1,0,2706,6,631
"7161","성사1동","성사1동제5투","대통령선거","경기도","고양시덕양구",2856,2310,915,439,494,160,290,3,0,2,2,0,1,0,1,2307,3,546
"7162","성사2동","관내사전투표","대통령선거","경기도","고양시덕양구",1937,1937,862,349,354,121,238,1,0,1,1,3,0,0,2,1932,5,0
"7163","성사2동","성사2동제1투","대통령선거","경기도","고양시덕양구",2415,1695,662,377,345,115,187,1,0,0,1,0,0,1,1,1690,5,720
"7164","성사2동","성사2동제2투","대통령선거","경기도","고양시덕양구",2454,1811,638,461,377,102,219,2,0,1,0,0,0,1,2,1803,8,643
"7165","성사2동","성사2동제3투","대통령선거","경기도","고양시덕양구",2512,1924,743,426,433,101,212,1,1,0,3,0,0,0,0,1920,4,588
"7166","효자동","관내사전투표","대통령선거","경기도","고양시덕양구",335,335,107,75,77,45,26,0,0,2,0,1,0,1,0,334,1,0
"7167","효자동","효자동제1투","대통령선거","경기도","고양시덕양구",385,96,19,39,26,6,6,0,0,0,0,0,0,0,0,96,0,289
"7168","효자동","효자동제2투","대통령선거","경기도","고양시덕양구",1168,796,218,271,211,47,40,0,0,1,2,0,0,0,2,792,4,372
"7169","신도동","관내사전투표","대통령선거","경기도","고양시덕양구",3790,3790,1703,697,756,229,374,8,0,2,1,3,0,1,2,3776,14,0
"7170","신도동","신도동제1투","대통령선거","경기도","고양시덕양구",2596,1509,465,514,348,61,108,2,0,1,1,1,0,1,1,1503,6,1087
"7171","신도동","신도동제2투","대통령선거","경기도","고양시덕양구",520,354,105,112,84,15,36,0,0,0,1,0,0,0,0,353,1,166
"7172","신도동","신도동제3투","대통령선거","경기도","고양시덕양구",1895,1498,612,335,315,112,120,1,0,0,0,0,0,1,0,1496,2,397
"7173","신도동","신도동제4투","대통령선거","경기도","고양시덕양구",3123,2568,1202,382,597,186,193,3,0,0,0,1,0,0,1,2565,3,555
"7174","신도동","신도동제5투","대통령선거","경기도","고양시덕양구",3754,2711,1138,562,600,162,222,3,1,3,2,4,2,0,3,2702,9,1043
"7175","창릉동","관내사전투표","대통령선거","경기도","고양시덕양구",1532,1532,748,257,287,96,136,0,0,2,2,0,0,0,1,1529,3,0
"7176","창릉동","창릉동제1투","대통령선거","경기도","고양시덕양구",1425,864,274,273,206,46,57,2,0,0,0,0,0,1,1,860,4,561
"7177","창릉동","창릉동제2투","대통령선거","경기도","고양시덕양구",1679,1123,292,425,267,68,55,6,0,0,3,0,0,0,2,1118,5,556
"7178","창릉동","창릉동제3투","대통령선거","경기도","고양시덕양구",2043,1598,751,268,331,117,126,2,0,0,1,0,0,1,0,1597,1,445
"7179","창릉동","창릉동제4투","대통령선거","경기도","고양시덕양구",2631,2273,1060,379,497,155,170,6,0,0,1,1,1,0,1,2271,2,358
"7180","고양동","관내사전투표","대통령선거","경기도","고양시덕양구",4612,4612,1854,973,935,270,552,8,1,4,3,0,0,0,0,4600,12,0
"7181","고양동","고양동제1투","대통령선거","경기도","고양시덕양구",2458,1524,489,386,372,86,179,0,0,0,0,4,0,1,1,1518,6,934
"7182","고양동","고양동제2투","대통령선거","경기도","고양시덕양구",2902,1743,574,424,401,86,242,2,0,1,3,1,1,1,0,1736,7,1159
"7183","고양동","고양동제3투","대통령선거","경기도","고양시덕양구",2986,2037,728,464,463,111,253,2,1,1,0,1,0,0,0,2024,13,949
"7184","고양동","고양동제4투","대통령선거","경기도","고양시덕양구",3626,2060,738,481,480,106,229,7,1,1,4,0,0,2,2,2051,9,1566
"7185","고양동","고양동제5투","대통령선거","경기도","고양시덕양구",1763,1126,310,390,260,42,112,3,0,2,1,1,1,0,0,1122,4,637
"7186","고양동","고양동제6투","대통령선거","경기도","고양시덕양구",2848,1970,777,376,490,98,216,6,0,0,1,2,0,0,0,1966,4,878
"7187","고양동","고양동제7투","대통령선거","경기도","고양시덕양구",2611,1892,781,362,386,133,222,0,0,0,1,1,0,0,0,1886,6,719
"7188","관산동","관내사전투표","대통령선거","경기도","고양시덕양구",3710,3709,1502,787,766,179,451,7,1,4,2,1,0,1,1,3702,7,1
"7189","관산동","관산동제1투","대통령선거","경기도","고양시덕양구",2191,1208,375,292,311,47,175,1,0,0,0,1,0,1,0,1203,5,983
"7190","관산동","관산동제2투","대통령선거","경기도","고양시덕양구",2598,1816,576,511,435,75,205,3,1,0,0,1,0,1,2,1810,6,782
"7191","관산동","관산동제3투","대통령선거","경기도","고양시덕양구",3792,2603,936,595,604,128,320,2,1,2,1,1,2,1,1,2594,9,1189
"7192","관산동","관산동제4투","대통령선거","경기도","고양시덕양구",2689,1712,507,528,407,70,181,1,0,4,1,1,2,1,1,1704,8,977
"7193","관산동","관산동제5투","대통령선거","경기도","고양시덕양구",3359,1984,629,501,481,88,266,3,1,2,1,2,1,1,2,1978,6,1375
"7194","관산동","관산동제6투","대통령선거","경기도","고양시덕양구",3263,1874,635,407,483,100,230,3,0,1,1,5,1,0,1,1867,7,1389
"7195","관산동","관산동제7투","대통령선거","경기도","고양시덕양구",5200,3312,1127,815,812,159,374,7,1,2,1,0,1,1,3,3303,9,1888
"7196","능곡동","관내사전투표","대통령선거","경기도","고양시덕양구",3244,3244,1396,653,701,215,256,4,0,1,1,2,0,3,2,3234,10,0
"7197","능곡동","능곡동제1투","대통령선거","경기도","고양시덕양구",2647,1667,604,420,390,129,115,4,1,2,0,0,0,0,1,1666,1,980
"7198","능곡동","능곡동제2투","대통령선거","경기도","고양시덕양구",2522,1643,618,357,381,124,155,0,0,0,0,1,1,1,1,1639,4,879
"7199","능곡동","능곡동제3투","대통령선거","경기도","고양시덕양구",2653,1702,621,390,435,98,141,5,0,0,1,3,1,0,1,1696,6,951
"7200","능곡동","능곡동제4투","대통령선거","경기도","고양시덕양구",1553,1063,343,349,211,42,109,2,2,0,1,1,0,0,1,1061,2,490
"7201","능곡동","능곡동제5투","대통령선거","경기도","고양시덕양구",2542,1768,659,411,412,126,142,5,0,0,2,5,0,1,0,1763,5,774
"7202","화정1동","관내사전투표","대통령선거","경기도","고양시덕양구",8467,8466,3743,1378,1601,610,1074,19,2,0,5,5,1,4,2,8444,22,1
"7203","화정1동","화정1동제1투","대통령선거","경기도","고양시덕양구",2660,2144,847,382,455,150,298,3,0,0,0,4,0,0,0,2139,5,516
"7204","화정1동","화정1동제2투","대통령선거","경기도","고양시덕양구",2733,2055,838,400,430,140,234,5,0,0,2,0,0,0,2,2051,4,678
"7205","화정1동","화정1동제3투","대통령선거","경기도","고양시덕양구",2926,2197,913,406,475,149,239,4,0,0,0,1,0,0,2,2189,8,729
"7206","화정1동","화정1동제4투","대통령선거","경기도","고양시덕양구",2390,1851,703,383,420,111,221,3,0,2,1,1,0,2,0,1847,4,539
"7207","화정1동","화정1동제5투","대통령선거","경기도","고양시덕양구",3093,2402,834,647,510,174,227,2,0,0,0,2,0,0,0,2396,6,691
"7208","화정1동","화정1동제6투","대통령선거","경기도","고양시덕양구",2636,1631,629,350,332,102,207,6,0,0,0,0,2,0,0,1628,3,1005
"7209","화정1동","화정1동제7투","대통령선거","경기도","고양시덕양구",2246,1309,512,256,287,73,166,3,0,0,3,1,1,0,0,1302,7,937
"7210","화정1동","화정1동제8투","대통령선거","경기도","고양시덕양구",2560,2032,696,531,469,130,192,5,0,0,1,1,0,0,0,2025,7,528
"7211","화정1동","화정1동제9투","대통령선거","경기도","고양시덕양구",2487,1690,712,316,356,115,177,2,1,0,0,0,1,0,1,1681,9,797
"7212","화정2동","관내사전투표","대통령선거","경기도","고양시덕양구",4937,4937,2515,614,882,307,600,4,0,1,3,1,0,1,1,4929,8,0
"7213","화정2동","화정2동제1투","대통령선거","경기도","고양시덕양구",2985,2089,926,354,417,114,264,4,0,2,0,3,0,0,0,2084,5,896
"7214","화정2동","화정2동제2투","대통령선거","경기도","고양시덕양구",3080,2366,1082,363,490,151,269,1,0,0,0,2,0,1,1,2360,6,714
"7215","화정2동","화정2동제3투","대통령선거","경기도","고양시덕양구",3120,2385,1044,371,504,177,281,0,0,0,0,1,0,0,1,2379,6,735
"7216","화정2동","화정2동제4투","대통령선거","경기도","고양시덕양구",2740,2201,961,418,423,148,243,2,0,0,0,0,0,1,0,2196,5,539
"7217","화정2동","화정2동제5투","대통령선거","경기도","고양시덕양구",2896,2373,1045,385,490,160,284,1,1,0,1,1,0,0,0,2368,5,523
"7218","화정2동","화정2동제6투","대통령선거","경기도","고양시덕양구",2216,1855,782,358,373,136,200,0,0,0,1,0,0,0,0,1850,5,361
"7219","화정2동","화정2동제7투","대통령선거","경기도","고양시덕양구",2799,2191,972,351,457,135,259,0,0,2,2,2,1,0,3,2184,7,608
"7220","행주동","관내사전투표","대통령선거","경기도","고양시덕양구",2231,2231,946,454,483,139,187,3,0,2,0,5,2,1,3,2225,6,0
"7221","행주동","행주동제1투","대통령선거","경기도","고양시덕양구",2310,1186,437,264,291,76,109,2,0,2,0,0,1,1,1,1184,2,1124
"7222","행주동","행주동제2투","대통령선거","경기도","고양시덕양구",2790,1647,593,362,396,100,178,2,0,1,0,3,1,3,3,1642,5,1143
"7223","행주동","행주동제3투","대통령선거","경기도","고양시덕양구",2772,1610,661,326,369,104,138,6,0,1,0,1,1,2,0,1609,1,1162
"7224","행주동","행주동제4투","대통령선거","경기도","고양시덕양구",2772,1781,677,407,426,107,146,4,0,1,2,1,1,1,3,1776,5,991
"7225","행주동","행주동제5투","대통령선거","경기도","고양시덕양구",1017,701,177,261,159,38,62,1,0,0,0,0,0,0,0,698,3,316
"7226","행주동","행주동제6투","대통령선거","경기도","고양시덕양구",2427,1681,654,384,394,115,124,4,0,0,0,1,0,0,1,1677,4,746
"7227","행신1동","관내사전투표","대통령선거","경기도","고양시덕양구",3589,3589,1818,480,678,227,357,12,0,1,0,3,0,2,3,3581,8,0
"7228","행신1동","행신1동제1투","대통령선거","경기도","고양시덕양구",2693,1927,835,345,417,126,179,4,0,1,2,3,0,0,0,1912,15,766
"7229","행신1동","행신1동제2투","대통령선거","경기도","고양시덕양구",3094,2396,1015,457,569,149,192,3,0,1,0,0,1,0,2,2389,7,698
"7230","행신1동","행신1동제3투","대통령선거","경기도","고양시덕양구",2679,1961,765,391,496,129,164,2,0,1,0,2,1,0,1,1952,9,718
"7231","행신1동","행신1동제4투","대통령선거","경기도","고양시덕양구",3009,2327,1002,386,587,181,160,0,0,1,0,2,0,0,1,2320,7,682
"7232","행신1동","행신1동제5투","대통령선거","경기도","고양시덕양구",2845,2246,938,466,464,174,192,4,0,1,0,1,0,0,1,2241,5,599
"7233","행신2동","관내사전투표","대통령선거","경기도","고양시덕양구",6163,6160,3090,886,1102,417,621,5,2,2,3,10,1,3,5,6147,13,3
"7234","행신2동","행신2동제1투","대통령선거","경기도","고양시덕양구",3166,2180,857,456,535,146,171,6,0,0,1,0,1,2,2,2177,3,986
"7235","행신2동","행신2동제2투","대통령선거","경기도","고양시덕양구",2317,1776,748,344,372,141,159,5,0,1,0,1,0,1,0,1772,4,541
"7236","행신2동","행신2동제3투","대통령선거","경기도","고양시덕양구",3259,2494,983,562,539,202,192,2,2,1,1,1,0,1,2,2488,6,765
"7237","행신2동","행신2동제4투","대통령선거","경기도","고양시덕양구",2996,2276,1099,327,490,152,199,1,0,0,0,2,0,2,2,2274,2,720
"7238","행신2동","행신2동제5투","대통령선거","경기도","고양시덕양구",2934,2227,1051,383,436,143,198,2,0,2,1,0,0,1,0,2217,10,707
"7239","행신2동","행신2동제6투","대통령선거","경기도","고양시덕양구",2529,2016,981,296,406,148,168,3,1,1,1,2,0,1,1,2009,7,513
"7240","행신2동","행신2동제7투","대통령선거","경기도","고양시덕양구",2681,2033,947,325,447,144,157,3,0,0,1,1,0,0,2,2027,6,648
"7241","행신2동","행신2동제8투","대통령선거","경기도","고양시덕양구",396,293,103,100,53,16,19,0,0,0,0,0,0,0,1,292,1,103
"7242","행신3동","관내사전투표","대통령선거","경기도","고양시덕양구",6049,6049,3026,885,1115,396,593,8,0,2,3,6,1,0,1,6036,13,0
"7243","행신3동","행신3동제1투","대통령선거","경기도","고양시덕양구",3596,2629,1203,435,567,177,223,2,0,0,2,6,1,2,1,2619,10,967
"7244","행신3동","행신3동제2투","대통령선거","경기도","고양시덕양구",3133,2516,1221,373,542,148,227,1,0,0,0,1,0,1,1,2515,1,617
"7245","행신3동","행신3동제3투","대통령선거","경기도","고양시덕양구",3199,2582,1069,477,577,197,245,2,0,0,0,1,0,1,3,2572,10,617
"7246","행신3동","행신3동제4투","대통령선거","경기도","고양시덕양구",3054,2500,1100,419,539,187,242,2,0,3,0,1,0,0,0,2493,7,554
"7247","행신3동","행신3동제5투","대통령선거","경기도","고양시덕양구",3220,2358,879,554,549,154,210,2,0,1,0,2,0,0,0,2351,7,862
"7248","행신3동","행신3동제6투","대통령선거","경기도","고양시덕양구",3603,2303,927,475,523,167,188,4,1,3,0,4,0,1,2,2295,8,1300
"7249","행신3동","행신3동제7투","대통령선거","경기도","고양시덕양구",2441,1401,525,299,317,85,163,2,1,2,1,2,0,1,0,1398,3,1040
"7250","행신3동","행신3동제8투","대통령선거","경기도","고양시덕양구",3880,2995,1377,506,622,204,274,4,1,0,2,0,0,1,1,2992,3,885
"7251","행신3동","행신3동제9투","대통령선거","경기도","고양시덕양구",3248,2543,1199,410,552,159,205,6,0,2,0,2,1,0,1,2537,6,705
"7252","화전동","관내사전투표","대통령선거","경기도","고양시덕양구",980,978,358,196,251,86,73,1,0,2,1,1,0,1,1,971,7,2
"7253","화전동","화전동제1투","대통령선거","경기도","고양시덕양구",2673,1538,489,450,363,115,103,0,0,1,0,3,1,0,8,1533,5,1135
"7254","화전동","화전동제2투","대통령선거","경기도","고양시덕양구",943,609,195,209,135,30,34,2,0,0,0,0,0,2,0,607,2,334
"7255","대덕동","관내사전투표","대통령선거","경기도","고양시덕양구",481,481,187,128,97,31,32,0,0,0,0,3,0,0,0,478,3,0
"7256","대덕동","대덕동제1투","대통령선거","경기도","고양시덕양구",910,512,150,136,153,43,26,1,0,0,0,0,0,0,2,511,1,398
"7257","대덕동","대덕동제2투","대통령선거","경기도","고양시덕양구",986,664,199,207,166,46,42,1,0,0,0,0,0,0,0,661,3,322
"7258","잘못 투입·구분된 투표지","잘못 투입·구분된 투표지","대통령선거","경기도","고양시덕양구",0,5,2,2,0,0,1,0,0,0,0,0,0,0,0,5,0,-5
"7259","거소·선상투표","거소·선상투표","대통령선거","경기도","고양시일산동구",494,473,205,61,135,19,19,0,2,3,2,0,1,0,3,450,23,21
"7260","관외사전투표","관외사전투표","대통령선거","경기도","고양시일산동구",22559,22557,10366,3284,4726,1834,2111,34,6,9,3,11,7,7,21,22419,138,2
"7261","재외투표","재외투표","대통령선거","경기도","고양시일산동구",2723,2190,1306,151,337,97,284,7,1,0,0,0,0,1,1,2185,5,533
"7262","식사동","관내사전투표","대통령선거","경기도","고양시일산동구",3844,3844,1835,592,716,295,389,4,0,0,0,2,0,2,4,3839,5,0
"7263","식사동","식사동제1투","대통령선거","경기도","고양시일산동구",4027,2779,1173,453,702,215,224,2,0,1,0,3,0,0,1,2774,5,1248
"7264","식사동","식사동제2투","대통령선거","경기도","고양시일산동구",2732,2129,771,520,512,136,181,1,1,0,1,0,0,0,0,2123,6,603
"7265","식사동","식사동제3투","대통령선거","경기도","고양시일산동구",2246,1736,682,380,375,157,134,0,0,2,0,0,0,1,1,1732,4,510
"7266","식사동","식사동제4투","대통령선거","경기도","고양시일산동구",2695,2160,910,399,488,196,159,4,0,2,0,0,0,1,0,2159,1,535
"7267","식사동","식사동제5투","대통령선거","경기도","고양시일산동구",2807,1947,683,501,465,147,144,1,0,2,0,0,0,1,1,1945,2,860
"7268","식사동","식사동제6투","대통령선거","경기도","고양시일산동구",3767,2938,1123,668,674,273,191,4,0,0,1,1,0,0,0,2935,3,829
"7269","중산동","관내사전투표","대통령선거","경기도","고양시일산동구",5736,5736,2527,1036,1204,422,517,4,1,3,0,1,2,0,3,5720,16,0
"7270","중산동","중산동제1투","대통령선거","경기도","고양시일산동구",2657,1597,667,313,373,124,113,2,1,0,1,0,0,1,1,1596,1,1060
"7271","중산동","중산동제2투","대통령선거","경기도","고양시일산동구",2795,1826,747,335,466,136,129,1,0,2,0,1,1,0,4,1822,4,969
"7272","중산동","중산동제3투","대통령선거","경기도","고양시일산동구",3035,2284,837,515,542,184,189,6,1,1,1,1,1,0,2,2280,4,751
"7273","중산동","중산동제4투","대통령선거","경기도","고양시일산동구",2731,1777,675,408,413,144,126,2,0,0,0,2,0,1,1,1772,5,954
"7274","중산동","중산동제5투","대통령선거","경기도","고양시일산동구",2720,1812,681,474,406,133,111,3,0,0,0,0,0,0,0,1808,4,908
"7275","중산동","중산동제6투","대통령선거","경기도","고양시일산동구",3440,2397,909,496,668,121,188,5,0,1,0,0,0,0,2,2390,7,1043
"7276","중산동","중산동제7투","대통령선거","경기도","고양시일산동구",4350,3181,1395,589,741,179,251,4,1,2,0,6,1,0,1,3170,11,1169
"7277","중산동","중산동제8투","대통령선거","경기도","고양시일산동구",4274,3148,1416,549,708,202,254,2,0,3,3,0,0,0,2,3139,9,1126
"7278","정발산동","관내사전투표","대통령선거","경기도","고양시일산동구",4184,4184,2028,676,794,275,386,6,0,3,0,3,0,2,3,4176,8,0
"7279","정발산동","정발산동제1투","대통령선거","경기도","고양시일산동구",2882,1917,787,355,454,138,167,3,0,2,0,1,0,2,2,1911,6,965
"7280","정발산동","정발산동제2투","대통령선거","경기도","고양시일산동구",2588,1769,705,368,428,112,149,2,0,0,1,1,0,0,0,1766,3,819
"7281","정발산동","정발산동제3투","대통령선거","경기도","고양시일산동구",2894,2000,857,353,474,140,166,1,1,0,0,0,0,2,1,1995,5,894
"7282","정발산동","정발산동제4투","대통령선거","경기도","고양시일산동구",1755,1332,527,283,304,106,103,5,0,0,0,0,0,0,0,1328,4,423
"7283","정발산동","정발산동제5투","대통령선거","경기도","고양시일산동구",2875,1948,758,409,451,154,167,3,0,0,0,2,0,0,0,1944,4,927
"7284","정발산동","정발산동제6투","대통령선거","경기도","고양시일산동구",2912,2182,835,510,490,175,151,9,0,2,1,0,0,0,1,2174,8,730
"7285","풍산동","관내사전투표","대통령선거","경기도","고양시일산동구",5917,5917,2924,924,1121,417,504,4,0,3,0,8,0,1,3,5909,8,0
"7286","풍산동","풍산동제1투","대통령선거","경기도","고양시일산동구",4412,3054,1347,535,707,221,232,0,0,3,1,1,0,0,1,3048,6,1358
"7287","풍산동","풍산동제2투","대통령선거","경기도","고양시일산동구",2652,2054,943,325,447,165,167,2,0,0,0,2,0,0,1,2052,2,598
"7288","풍산동","풍산동제3투","대통령선거","경기도","고양시일산동구",2634,1893,730,413,464,125,148,1,0,1,3,1,1,0,0,1887,6,741
"7289","풍산동","풍산동제4투","대통령선거","경기도","고양시일산동구",3538,2424,1101,415,601,121,171,3,0,3,0,0,0,1,3,2419,5,1114
"7290","풍산동","풍산동제5투","대통령선거","경기도","고양시일산동구",2585,2061,970,329,453,152,151,1,0,0,0,0,0,0,1,2057,4,524
"7291","풍산동","풍산동제6투","대통령선거","경기도","고양시일산동구",2694,1956,843,354,472,118,157,2,0,3,0,0,0,0,1,1950,6,738
"7292","풍산동","풍산동제7투","대통령선거","경기도","고양시일산동구",3221,2360,926,514,583,152,175,2,1,1,0,0,0,0,2,2356,4,861
"7293","백석1동","관내사전투표","대통령선거","경기도","고양시일산동구",4289,4289,2204,559,770,329,407,7,0,0,0,2,0,1,0,4279,10,0
"7294","백석1동","백석1동제1투","대통령선거","경기도","고양시일산동구",2069,1317,538,263,317,88,100,3,0,2,0,1,0,1,0,1313,4,752
"7295","백석1동","백석1동제2투","대통령선거","경기도","고양시일산동구",2621,1966,849,326,489,138,151,9,0,0,0,0,0,0,0,1962,4,655
"7296","백석1동","백석1동제3투","대통령선거","경기도","고양시일산동구",2710,2141,991,344,458,178,162,1,0,0,1,1,0,0,0,2136,5,569
"7297","백석1동","백석1동제4투","대통령선거","경기도","고양시일산동구",2942,2288,992,448,494,172,168,0,0,1,2,3,0,0,1,2281,7,654
"7298","백석1동","백석1동제5투","대통령선거","경기도","고양시일산동구",2932,1974,878,339,439,144,161,8,0,0,0,0,1,0,0,1970,4,958
"7299","백석1동","백석1동제6투","대통령선거","경기도","고양시일산동구",2364,1675,690,353,375,127,120,2,0,3,0,0,0,0,2,1672,3,689
"7300","백석1동","백석1동제7투","대통령선거","경기도","고양시일산동구",4028,3154,1357,508,735,310,222,7,0,0,3,1,0,2,1,3146,8,874
"7301","백석2동","관내사전투표","대통령선거","경기도","고양시일산동구",3970,3970,2052,579,731,242,341,4,0,1,1,5,3,3,1,3963,7,0
"7302","백석2동","백석2동제1투","대통령선거","경기도","고양시일산동구",2733,1932,822,383,439,155,125,1,0,1,1,0,0,0,0,1927,5,801
"7303","백석2동","백석2동제2투","대통령선거","경기도","고양시일산동구",2948,2038,832,402,503,128,160,3,1,1,1,0,0,0,0,2031,7,910
"7304","백석2동","백석2동제3투","대통령선거","경기도","고양시일산동구",3834,2393,940,505,572,185,171,3,1,2,2,2,0,2,0,2385,8,1441
"7305","백석2동","백석2동제4투","대통령선거","경기도","고양시일산동구",4131,2683,1281,404,529,204,251,2,2,1,0,0,1,1,1,2677,6,1448
"7306","마두1동","관내사전투표","대통령선거","경기도","고양시일산동구",6918,6918,3440,952,1309,544,633,11,0,1,3,1,0,3,4,6901,17,0
"7307","마두1동","마두1동제1투","대통령선거","경기도","고양시일산동구",3217,2405,1030,466,551,172,177,3,0,0,1,0,0,2,0,2402,3,812
"7308","마두1동","마두1동제2투","대통령선거","경기도","고양시일산동구",3020,2483,1053,479,525,264,153,5,0,0,0,0,0,0,2,2481,2,537
"7309","마두1동","마두1동제3투","대통령선거","경기도","고양시일산동구",3072,2208,876,459,511,163,192,1,1,1,1,0,0,1,0,2206,2,864
"7310","마두1동","마두1동제4투","대통령선거","경기도","고양시일산동구",2670,2157,969,372,459,180,171,2,0,0,0,0,0,0,0,2153,4,513
"7311","마두1동","마두1동제5투","대통령선거","경기도","고양시일산동구",2533,1850,695,449,408,140,139,9,0,0,0,0,0,4,2,1846,4,683
"7312","마두2동","관내사전투표","대통령선거","경기도","고양시일산동구",2617,2617,1217,419,545,206,213,6,0,2,0,3,0,1,2,2614,3,0
"7313","마두2동","마두2동제1투","대통령선거","경기도","고양시일산동구",2453,1973,736,482,425,179,145,2,0,0,0,1,0,0,0,1970,3,480
"7314","마두2동","마두2동제2투","대통령선거","경기도","고양시일산동구",2589,2040,788,484,448,189,116,0,0,5,0,0,0,0,4,2034,6,549
"7315","마두2동","마두2동제3투","대통령선거","경기도","고양시일산동구",1684,1168,505,241,241,83,89,2,0,1,0,0,0,0,0,1162,6,516
"7316","마두2동","마두2동제4투","대통령선거","경기도","고양시일산동구",2769,2259,834,526,529,206,148,2,0,0,2,1,0,0,0,2248,11,510
"7317","장항1동","관내사전투표","대통령선거","경기도","고양시일산동구",574,574,221,172,126,21,29,0,0,0,0,0,0,0,0,569,5,0
"7318","장항1동","장항1동투표소","대통령선거","경기도","고양시일산동구",1966,1235,325,475,302,50,73,1,0,0,0,1,0,0,2,1229,6,731
"7319","장항2동","관내사전투표","대통령선거","경기도","고양시일산동구",3875,3875,1874,663,713,296,316,6,1,1,0,2,0,1,0,3873,2,0
"7320","장항2동","장항2동제1투","대통령선거","경기도","고양시일산동구",3336,2364,1055,455,528,178,133,6,0,0,0,4,0,0,1,2360,4,972
"7321","장항2동","장항2동제2투","대통령선거","경기도","고양시일산동구",2687,2176,733,593,504,201,130,7,0,1,1,1,0,0,0,2171,5,511
"7322","장항2동","장항2동제3투","대통령선거","경기도","고양시일산동구",3316,1810,771,335,399,158,137,3,0,0,0,1,0,2,1,1807,3,1506
"7323","장항2동","장항2동제4투","대통령선거","경기도","고양시일산동구",3371,1894,917,295,380,131,164,2,0,0,0,0,0,0,2,1891,3,1477
"7324","장항2동","장항2동제5투","대통령선거","경기도","고양시일산동구",3879,2034,1010,302,377,157,178,4,1,0,0,1,0,0,0,2030,4,1845
"7325","고봉동","관내사전투표","대통령선거","경기도","고양시일산동구",1589,1589,588,434,350,72,127,4,0,1,3,2,1,1,2,1585,4,0
"7326","고봉동","고봉동제1투","대통령선거","경기도","고양시일산동구",4496,2469,859,643,589,159,206,0,0,0,0,0,0,2,3,2461,8,2027
"7327","고봉동","고봉동제2투","대통령선거","경기도","고양시일산동구",3529,1936,563,655,450,99,129,6,2,6,2,5,3,4,1,1925,11,1593
"7328","고봉동","고봉동제3투","대통령선거","경기도","고양시일산동구",4364,2880,947,729,752,156,263,6,1,4,1,1,1,0,6,2867,13,1484
"7329","잘못 투입·구분된 투표지","잘못 투입·구분된 투표지","대통령선거","경기도","고양시일산동구",0,1,1,0,0,0,0,0,0,0,0,0,0,0,0,1,0,-1
"7330","거소·선상투표","거소·선상투표","대통령선거","경기도","고양시일산서구",442,426,144,63,160,29,15,2,1,0,0,0,4,0,1,419,7,16
"7331","관외사전투표","관외사전투표","대통령선거","경기도","고양시일산서구",21916,21912,10406,3030,4467,1740,2036,26,6,7,5,10,3,5,42,21783,129,4
"7332","재외투표","재외투표","대통령선거","경기도","고양시일산서구",2692,2129,1303,140,312,85,265,10,1,0,0,4,1,1,0,2122,7,563
"7333","일산1동","관내사전투표","대통령선거","경기도","고양시일산서구",4569,4569,2086,922,913,283,346,4,0,3,0,0,0,0,3,4560,9,0
"7334","일산1동","일산1동제1투","대통령선거","경기도","고양시일산서구",2659,1728,757,313,393,125,137,1,0,0,1,0,0,0,0,1727,1,931
"7335","일산1동","일산1동제2투","대통령선거","경기도","고양시일산서구",3068,2074,893,395,503,106,160,3,1,2,1,1,0,1,2,2068,6,994
"7336","일산1동","일산1동제3투","대통령선거","경기도","고양시일산서구",2371,1607,677,313,387,101,116,0,1,1,1,4,0,0,1,1602,5,764
"7337","일산1동","일산1동제4투","대통령선거","경기도","고양시일산서구",3034,2111,924,384,494,123,176,2,0,1,0,0,0,0,0,2104,7,923
"7338","일산1동","일산1동제5투","대통령선거","경기도","고양시일산서구",2979,2220,909,470,491,162,169,6,1,0,0,0,0,2,0,2210,10,759
"7339","일산1동","일산1동제6투","대통령선거","경기도","고양시일산서구",2721,2002,908,352,442,141,148,1,0,1,0,0,1,0,1,1995,7,719
"7340","일산2동","관내사전투표","대통령선거","경기도","고양시일산서구",2980,2980,1309,572,645,193,239,6,0,1,3,3,0,1,1,2973,7,0
"7341","일산2동","일산2동제1투","대통령선거","경기도","고양시일산서구",2413,1566,591,342,378,124,117,1,2,1,1,1,0,0,0,1558,8,847
"7342","일산2동","일산2동제2투","대통령선거","경기도","고양시일산서구",3322,2723,1139,551,602,223,198,2,0,1,0,1,1,0,0,2718,5,599
"7343","일산2동","일산2동제3투","대통령선거","경기도","고양시일산서구",2333,1647,633,425,385,83,104,2,0,4,1,2,0,1,1,1641,6,686
"7344","일산2동","일산2동제4투","대통령선거","경기도","고양시일산서구",1786,968,349,267,219,43,80,3,1,1,0,0,0,0,0,963,5,818
"7345","일산2동","일산2동제5투","대통령선거","경기도","고양시일산서구",3144,2038,733,505,498,142,145,1,0,0,2,2,0,2,1,2031,7,1106
"7346","일산3동","관내사전투표","대통령선거","경기도","고양시일산서구",5532,5532,2958,669,1004,421,451,8,0,4,2,2,1,1,1,5522,10,0
"7347","일산3동","일산3동제1투","대통령선거","경기도","고양시일산서구",2374,1751,788,280,383,154,144,0,0,0,0,0,0,1,0,1750,1,623
"7348","일산3동","일산3동제2투","대통령선거","경기도","고양시일산서구",3049,2447,1002,483,531,222,202,6,0,0,0,0,0,0,0,2446,1,602
"7349","일산3동","일산3동제3투","대통령선거","경기도","고양시일산서구",3050,2433,1162,407,505,160,189,2,0,1,0,2,0,0,1,2429,4,617
"7350","일산3동","일산3동제4투","대통령선거","경기도","고양시일산서구",2250,1758,799,304,381,137,130,2,0,0,0,1,0,0,0,1754,4,492
"7351","일산3동","일산3동제5투","대통령선거","경기도","고양시일산서구",2961,2456,1260,309,506,198,169,4,0,2,0,1,0,1,0,2450,6,505
"7352","일산3동","일산3동제6투","대통령선거","경기도","고양시일산서구",2300,1890,884,310,409,156,123,1,0,0,0,1,0,0,0,1884,6,410
"7353","일산3동","일산3동제7투","대통령선거","경기도","고양시일산서구",1982,1550,734,227,362,114,106,3,0,0,0,0,0,0,0,1546,4,432
"7354","일산3동","일산3동제8투","대통령선거","경기도","고양시일산서구",2442,1935,874,341,427,141,143,4,0,0,1,0,0,1,0,1932,3,507
"7355","탄현동","관내사전투표","대통령선거","경기도","고양시일산서구",7509,7509,3674,1084,1519,547,646,10,0,3,1,1,2,2,3,7492,17,0
"7356","탄현동","탄현동제1투","대통령선거","경기도","고양시일산서구",2553,1531,625,290,381,100,128,2,0,0,0,1,0,2,0,1529,2,1022
"7357","탄현동","탄현동제2투","대통령선거","경기도","고양시일산서구",2132,1553,661,262,404,96,119,1,0,0,2,1,0,0,1,1547,6,579
"7358","탄현동","탄현동제3투","대통령선거","경기도","고양시일산서구",3061,2127,947,366,486,142,162,5,0,0,0,1,0,1,0,2110,17,934
"7359","탄현동","탄현동제4투","대통령선거","경기도","고양시일산서구",3145,2309,957,455,542,171,174,1,0,1,0,0,0,2,2,2305,4,836
"7360","탄현동","탄현동제5투","대통령선거","경기도","고양시일산서구",3987,3034,1412,502,702,221,189,1,0,2,0,0,0,0,1,3030,4,953
"7361","탄현동","탄현동제6투","대통령선거","경기도","고양시일산서구",3086,2301,960,447,521,177,185,1,1,1,0,4,0,0,1,2298,3,785
"7362","탄현동","탄현동제7투","대통령선거","경기도","고양시일산서구",2945,2063,985,311,463,141,154,4,0,0,0,1,0,1,0,2060,3,882
"7363","탄현동","탄현동제8투","대통령선거","경기도","고양시일산서구",2720,1851,864,304,412,119,147,1,0,0,0,0,0,0,1,1848,3,869
"7364","탄현동","탄현동제9투","대통령선거","경기도","고양시일산서구",4226,3271,1545,513,702,262,234,3,0,1,0,1,1,1,2,3265,6,955
"7365","주엽1동","관내사전투표","대통령선거","경기도","고양시일산서구",5202,5202,2602,832,928,414,394,6,0,4,2,3,0,3,3,5191,11,0
"7366","주엽1동","주엽1동제1투","대통령선거","경기도","고양시일산서구",2651,1866,832,370,398,119,135,3,0,2,1,0,0,1,1,1862,4,785
"7367","주엽1동","주엽1동제2투","대통령선거","경기도","고양시일산서구",2138,1699,736,355,358,143,99,2,0,0,0,0,0,0,1,1694,5,439
"7368","주엽1동","주엽1동제3투","대통령선거","경기도","고양시일산서구",2118,1723,698,355,408,133,117,4,0,1,0,0,0,1,2,1719,4,395
"7369","주엽1동","주엽1동제4투","대통령선거","경기도","고양시일산서구",2559,1970,881,353,439,126,155,6,0,2,0,2,0,1,1,1966,4,589
"7370","주엽1동","주엽1동제5투","대통령선거","경기도","고양시일산서구",1452,1009,445,189,241,58,71,0,0,0,0,1,0,1,0,1006,3,443
"7371","주엽1동","주엽1동제6투","대통령선거","경기도","고양시일산서구",2010,1613,600,422,356,133,91,2,0,2,0,1,0,1,0,1608,5,397
"7372","주엽1동","주엽1동제7투","대통령선거","경기도","고양시일산서구",2316,1840,749,445,381,144,112,0,0,0,0,1,0,0,0,1832,8,476
"7373","주엽1동","주엽1동제8투","대통령선거","경기도","고양시일산서구",1814,1476,632,306,337,112,79,1,0,3,2,0,0,0,0,1472,4,338
"7374","주엽2동","관내사전투표","대통령선거","경기도","고양시일산서구",3970,3969,1929,678,741,284,308,10,0,2,0,0,2,0,2,3956,13,1
"7375","주엽2동","주엽2동제1투","대통령선거","경기도","고양시일산서구",2266,1687,675,405,375,131,96,2,1,0,0,0,0,0,0,1685,2,579
"7376","주엽2동","주엽2동제2투","대통령선거","경기도","고양시일산서구",2201,1763,821,309,365,140,118,5,0,0,0,0,2,0,0,1760,3,438
"7377","주엽2동","주엽2동제3투","대통령선거","경기도","고양시일산서구",1792,1384,596,291,280,116,96,2,0,0,0,1,0,0,0,1382,2,408
"7378","주엽2동","주엽2동제4투","대통령선거","경기도","고양시일산서구",2449,1747,711,355,413,113,142,2,0,3,1,0,1,0,1,1742,5,702
"7379","주엽2동","주엽2동제5투","대통령선거","경기도","고양시일산서구",2052,1580,586,424,372,109,83,2,0,0,1,0,0,0,0,1577,3,472
"7380","주엽2동","주엽2동제6투","대통령선거","경기도","고양시일산서구",2015,1400,574,311,332,73,91,1,1,2,0,0,0,3,2,1390,10,615
"7381","주엽2동","주엽2동제7투","대통령선거","경기도","고양시일산서구",2852,2280,950,529,495,164,130,2,0,2,0,0,0,0,3,2275,5,572
"7382","주엽2동","주엽2동제8투","대통령선거","경기도","고양시일산서구",2742,2040,864,455,443,129,134,7,0,0,1,2,0,0,1,2036,4,702
"7383","대화동","관내사전투표","대통령선거","경기도","고양시일산서구",4855,4855,2324,703,910,402,476,11,0,5,0,5,0,0,3,4839,16,0
"7384","대화동","대화동제1투","대통령선거","경기도","고양시일산서구",3291,2258,906,414,531,180,210,7,0,1,0,2,0,1,2,2254,4,1033
"7385","대화동","대화동제2투","대통령선거","경기도","고양시일산서구",2992,2264,1019,394,474,173,183,9,1,1,0,3,0,1,2,2260,4,728
"7386","대화동","대화동제3투","대통령선거","경기도","고양시일산서구",3511,2719,1181,519,580,188,234,4,0,1,0,3,1,1,2,2714,5,792
"7387","대화동","대화동제4투","대통령선거","경기도","고양시일산서구",1980,1340,507,311,302,110,99,5,0,1,0,1,0,0,1,1337,3,640
"7388","대화동","대화동제5투","대통령선거","경기도","고양시일산서구",2583,1691,718,369,347,106,139,1,0,1,1,3,0,0,2,1687,4,892
"7389","대화동","대화동제6투","대통령선거","경기도","고양시일산서구",3578,2566,1015,543,611,207,176,1,1,0,5,0,0,0,0,2559,7,1012
"7390","대화동","대화동제7투","대통령선거","경기도","고양시일산서구",2506,1540,607,320,350,109,145,0,0,0,0,1,0,3,0,1535,5,966
"7391","송포동","관내사전투표","대통령선거","경기도","고양시일산서구",3561,3561,1683,624,695,278,272,0,0,0,0,2,0,1,1,3556,5,0
"7392","송포동","송포동제1투","대통령선거","경기도","고양시일산서구",3677,2565,819,802,589,170,175,1,0,0,0,0,0,2,1,2559,6,1112
"7393","송포동","송포동제2투","대통령선거","경기도","고양시일산서구",3218,2523,1202,438,510,203,154,4,0,1,0,2,0,3,2,2519,4,695
"7394","송포동","송포동제3투","대통령선거","경기도","고양시일산서구",2793,2156,936,411,481,170,143,6,0,1,1,1,0,0,0,2150,6,637
"7395","송산동","관내사전투표","대통령선거","경기도","고양시일산서구",4018,4018,1895,736,819,240,308,2,0,2,1,2,0,1,3,4009,9,0
"7396","송산동","송산동제1투","대통령선거","경기도","고양시일산서구",2488,1601,640,374,358,113,112,0,1,0,1,2,0,0,0,1601,0,887
"7397","송산동","송산동제2투","대통령선거","경기도","고양시일산서구",3596,2284,854,584,547,138,147,5,1,2,1,0,0,0,1,2280,4,1312
"7398","송산동","송산동제3투","대통령선거","경기도","고양시일산서구",3444,2566,957,613,617,203,167,2,0,0,0,0,0,0,0,2559,7,878
"7399","송산동","송산동제4투","대통령선거","경기도","고양시일산서구",2271,1475,379,567,350,78,89,2,0,1,1,0,0,2,1,1470,5,796
"7400","송산동","송산동제5투","대통령선거","경기도","고양시일산서구",3131,2479,1168,399,549,176,180,1,0,0,1,2,0,1,0,2477,2,652
"7401","송산동","송산동제6투","대통령선거","경기도","고양시일산서구",3664,2926,1333,460,732,207,178,6,0,1,0,0,1,2,1,2921,5,738
"7402","송산동","송산동제7투","대통령선거","경기도","고양시일산서구",3474,2586,1219,409,566,209,172,3,0,1,0,0,1,0,0,2580,6,888
"7403","송산동","송산동제8투","대통령선거","경기도","고양시일산서구",3899,3020,1309,577,724,215,175,6,2,0,1,2,0,1,0,3012,8,879
"7404","송산동","송산동제9투","대통령선거","경기도","고양시일산서구",2207,1368,515,288,330,93,133,3,0,0,0,1,1,1,0,1365,3,839
"7405","잘못 투입·구분된 투표지","잘못 투입·구분된 투표지","대통령선거","경기도","고양시일산서구",0,0,0,0,0,0,0,0,0,0,0,0,0,0,0,0,0,0
"7406","거소·선상투표","거소·선상투표","대통령선거","경기도","의왕시",222,211,65,44,74,7,8,1,2,0,1,1,0,0,0,203,8,11
"7407","관외사전투표","관외사전투표","대통령선거","경기도","의왕시",13258,13258,6210,1975,2726,1135,1070,14,1,3,1,6,4,6,15,13166,92,0
"7408","재외투표","재외투표","대통령선거","경기도","의왕시",1188,934,574,67,134,48,106,4,0,0,0,0,0,0,0,933,1,254
"7409","고천동","관내사전투표","대통령선거","경기도","의왕시",2591,2591,1097,641,492,157,188,1,0,1,1,2,0,1,1,2582,9,0
"7410","고천동","고천동제1투","대통령선거","경기도","의왕시",1720,1025,332,324,254,73,35,2,1,0,1,0,0,2,1,1025,0,695
"7411","고천동","고천동제2투","대통령선거","경기도","의왕시",2464,1749,685,467,370,114,108,2,0,0,0,0,0,1,0,1747,2,715
"7412","고천동","고천동제3투","대통령선거","경기도","의왕시",3098,2391,911,629,515,166,148,5,1,1,0,2,1,1,1,2381,10,707
"7413","부곡동","관내사전투표","대통령선거","경기도","의왕시",3923,3923,1703,789,856,250,294,4,0,6,1,1,0,1,2,3907,16,0
"7414","부곡동","부곡동제1투","대통령선거","경기도","의왕시",2055,1432,517,321,356,119,107,3,0,3,0,0,1,1,2,1430,2,623
"7415","부곡동","부곡동제2투","대통령선거","경기도","의왕시",2162,1538,541,388,380,115,103,1,0,1,0,0,1,0,1,1531,7,624
"7416","부곡동","부곡동제3투","대통령선거","경기도","의왕시",2348,1516,594,337,370,97,110,0,0,0,0,1,1,0,0,1510,6,832
"7417","부곡동","부곡동제4투","대통령선거","경기도","의왕시",2917,2233,910,478,531,150,147,2,0,5,1,0,0,0,0,2224,9,684
"7418","부곡동","부곡동제5투","대통령선거","경기도","의왕시",2881,2035,788,484,499,107,140,2,0,1,0,1,1,0,2,2025,10,846
"7419","부곡동","부곡동제6투","대통령선거","경기도","의왕시",3626,2492,868,673,606,161,156,9,1,5,0,4,1,0,0,2484,8,1134
"7420","오전동","관내사전투표","대통령선거","경기도","의왕시",4028,4028,1817,771,880,278,252,4,0,2,0,6,1,0,4,4015,13,0
"7421","오전동","오전동제1투","대통령선거","경기도","의왕시",2156,1366,518,370,311,85,71,1,0,1,0,0,1,1,1,1360,6,790
"7422","오전동","오전동제2투","대통령선거","경기도","의왕시",2569,1871,724,399,476,118,142,4,0,0,0,1,0,2,2,1868,3,698
"7423","오전동","오전동제3투","대통령선거","경기도","의왕시",2506,1709,597,425,446,123,108,0,2,3,1,1,0,0,2,1708,1,797
"7424","오전동","오전동제4투","대통령선거","경기도","의왕시",2326,1947,747,448,482,142,117,3,0,0,0,2,0,0,1,1942,5,379
"7425","오전동","오전동제5투","대통령선거","경기도","의왕시",2730,2197,955,448,515,144,125,5,0,0,0,1,0,0,1,2194,3,533
"7426","오전동","오전동제6투","대통령선거","경기도","의왕시",2046,1590,649,353,375,102,102,4,0,0,0,0,0,1,1,1587,3,456
"7427","오전동","오전동제7투","대통령선거","경기도","의왕시",3233,2694,1174,522,600,219,165,4,0,0,0,1,0,0,2,2687,7,539
"7428","오전동","오전동제8투","대통령선거","경기도","의왕시",3033,2547,1109,418,615,215,176,2,0,4,0,0,0,0,3,2542,5,486
"7429","오전동","오전동제9투","대통령선거","경기도","의왕시",1635,1181,443,277,289,98,71,0,0,2,0,0,0,0,0,1180,1,454
"7430","오전동","오전동제10투","대통령선거","경기도","의왕시",1840,1341,554,275,343,91,77,0,0,0,0,1,0,0,0,1341,0,499
"7431","내손1동","관내사전투표","대통령선거","경기도","의왕시",2836,2836,1341,523,549,199,203,5,0,1,2,1,1,0,2,2827,9,0
"7432","내손1동","내손1동제1투","대통령선거","경기도","의왕시",2606,1783,772,307,416,127,146,1,0,1,0,3,0,1,2,1776,7,823
"7433","내손1동","내손1동제2투","대통령선거","경기도","의왕시",2466,1991,693,540,475,169,98,5,0,0,0,2,0,1,0,1983,8,475
"7434","내손1동","내손1동제3투","대통령선거","경기도","의왕시",2084,1542,673,281,363,122,97,1,0,1,0,2,1,0,0,1541,1,542
"7435","내손1동","내손1동제4투","대통령선거","경기도","의왕시",3150,2497,1022,461,644,200,152,4,0,0,0,1,0,0,2,2486,11,653
"7436","내손1동","내손1동제5투","대통령선거","경기도","의왕시",2751,2251,915,462,552,173,134,3,1,1,1,0,0,1,0,2243,8,500
"7437","내손2동","관내사전투표","대통령선거","경기도","의왕시",4889,4889,2275,893,1013,336,347,7,0,2,1,1,0,1,1,4877,12,0
"7438","내손2동","내손2동제1투","대통령선거","경기도","의왕시",2806,2318,1124,343,514,186,140,2,0,0,1,0,0,3,0,2313,5,488
"7439","내손2동","내손2동제2투","대통령선거","경기도","의왕시",2682,2071,944,361,462,158,133,1,1,2,1,0,0,1,0,2064,7,611
"7440","내손2동","내손2동제3투","대통령선거","경기도","의왕시",2544,1736,658,418,418,96,132,5,0,0,0,2,0,1,2,1732,4,808
"7441","내손2동","내손2동제4투","대통령선거","경기도","의왕시",2251,1433,556,342,331,103,96,1,1,0,0,1,0,0,0,1431,2,818
"7442","내손2동","내손2동제5투","대통령선거","경기도","의왕시",2409,1669,633,377,398,138,107,6,1,0,0,1,0,0,2,1663,6,740
"7443","내손2동","내손2동제6투","대통령선거","경기도","의왕시",1689,1114,431,249,284,68,65,2,0,3,1,0,2,0,0,1105,9,575
"7444","내손2동","내손2동제7투","대통령선거","경기도","의왕시",2939,2450,1032,449,590,217,151,4,0,0,1,1,0,2,0,2447,3,489
"7445","내손2동","내손2동제8투","대통령선거","경기도","의왕시",1865,1573,605,331,405,132,94,2,0,0,0,1,1,0,0,1571,2,292
"7446","청계동","관내사전투표","대통령선거","경기도","의왕시",2827,2827,1374,553,546,170,175,2,0,2,0,2,0,0,1,2825,2,0
"7447","청계동","청계동제1투","대통령선거","경기도","의왕시",1940,1308,466,380,304,92,54,1,0,0,0,1,1,0,1,1300,8,632
"7448","청계동","청계동제2투","대통령선거","경기도","의왕시",2010,1555,715,295,321,108,108,1,0,0,0,3,0,1,1,1553,2,455
"7449","청계동","청계동제3투","대통령선거","경기도","의왕시",1696,1271,513,254,320,83,84,2,0,0,1,1,0,2,6,1266,5,425
"7450","청계동","청계동제4투","대통령선거","경기도","의왕시",3171,2313,903,538,564,172,123,1,0,0,0,1,0,1,1,2304,9,858
"7451","청계동","청계동제5투","대통령선거","경기도","의왕시",3411,2687,1142,538,638,212,137,6,1,3,1,2,0,0,3,2683,4,724
"7452","잘못 투입·구분된 투표지","잘못 투입·구분된 투표지","대통령선거","경기도","의왕시",0,0,0,0,0,0,0,0,0,0,0,0,0,0,0,0,0,0
"7453","거소·선상투표","거소·선상투표","대통령선거","경기도","구리시",213,208,78,25,78,13,8,0,0,0,0,1,0,1,0,204,4,5
"7454","관외사전투표","관외사전투표","대통령선거","경기도","구리시",12584,12579,5773,1923,2800,927,1015,12,2,4,2,13,5,4,18,12498,81,5
"7455","재외투표","재외투표","대통령선거","경기도","구리시",1085,839,514,61,114,39,108,1,0,0,0,0,0,0,0,837,2,246
"7456","갈매동","관내사전투표","대통령선거","경기도","구리시",2328,2328,1134,397,507,125,150,0,0,1,0,1,1,0,2,2318,10,0
"7457","갈매동","갈매동제1투","대통령선거","경기도","구리시",711,395,114,166,89,11,11,0,0,0,0,1,0,2,0,394,1,316
"7458","갈매동","갈매동제2투","대통령선거","경기도","구리시",2395,1763,797,285,419,139,119,1,0,0,0,1,0,0,0,1761,2,632
"7459","갈매동","갈매동제3투","대통령선거","경기도","구리시",3249,2203,870,491,559,144,125,4,0,1,1,1,0,1,0,2197,6,1046
"7460","갈매동","갈매동제4투","대통령선거","경기도","구리시",1705,1307,533,223,349,111,86,2,0,0,0,0,1,0,0,1305,2,398
"7461","동구동","관내사전투표","대통령선거","경기도","구리시",4209,4209,2015,726,829,289,322,7,0,3,0,5,0,0,3,4199,10,0
"7462","동구동","동구동제1투","대통령선거","경기도","구리시",1611,1036,409,254,230,80,61,0,0,0,0,0,0,0,0,1034,2,575
"7463","동구동","동구동제2투","대통령선거","경기도","구리시",1022,658,143,288,146,38,35,0,0,0,0,0,1,0,2,653,5,364
"7464","동구동","동구동제3투","대통령선거","경기도","구리시",2936,2273,932,505,527,139,155,3,0,2,0,0,0,2,2,2267,6,663
"7465","동구동","동구동제4투","대통령선거","경기도","구리시",2338,1875,836,343,413,151,118,3,0,0,1,0,1,1,0,1867,8,463
"7466","동구동","동구동제5투","대통령선거","경기도","구리시",2351,1815,730,391,459,108,118,1,0,1,0,0,0,1,2,1811,4,536
"7467","동구동","동구동제6투","대통령선거","경기도","구리시",2379,1811,826,306,415,126,127,6,0,1,0,0,0,0,1,1808,3,568
"7468","동구동","동구동제7투","대통령선거","경기도","구리시",2363,1853,750,351,471,121,145,0,0,3,1,2,1,1,1,1847,6,510
"7469","동구동","동구동제8투","대통령선거","경기도","구리시",2181,1836,747,407,426,136,108,4,0,1,0,1,0,0,1,1831,5,345
"7470","동구동","동구동제9투","대통령선거","경기도","구리시",2523,2008,930,347,446,119,155,1,1,0,1,1,0,2,0,2003,5,515
"7471","동구동","동구동제10투","대통령선거","경기도","구리시",3032,2460,1014,547,553,173,158,4,0,0,1,3,0,0,0,2453,7,572
"7472","동구동","동구동제11투","대통령선거","경기도","구리시",2450,1998,830,395,489,140,128,2,0,4,2,1,1,1,2,1995,3,452
"7473","인창동","관내사전투표","대통령선거","경기도","구리시",3181,3181,1505,557,642,221,230,6,1,2,0,4,1,0,1,3170,11,0
"7474","인창동","인창동제1투","대통령선거","경기도","구리시",2721,1726,637,429,415,112,122,0,1,2,1,3,0,0,1,1723,3,995
"7475","인창동","인창동제2투","대통령선거","경기도","구리시",2818,1930,765,404,490,133,124,1,0,0,0,1,2,1,1,1922,8,888
"7476","인창동","인창동제3투","대통령선거","경기도","구리시",2447,1598,550,430,401,78,118,8,1,2,0,1,0,0,1,1590,8,849
"7477","인창동","인창동제4투","대통령선거","경기도","구리시",2647,2034,877,390,471,150,141,0,0,0,0,0,0,0,0,2029,5,613
"7478","인창동","인창동제5투","대통령선거","경기도","구리시",2195,1773,785,356,360,136,129,2,0,1,0,0,1,0,0,1770,3,422
"7479","인창동","인창동제6투","대통령선거","경기도","구리시",2632,2117,845,487,488,134,148,2,0,0,1,2,0,1,1,2109,8,515
"7480","교문1동","관내사전투표","대통령선거","경기도","구리시",2216,2216,1002,454,473,127,146,0,1,0,0,1,0,0,2,2206,10,0
"7481","교문1동","교문1동제1투","대통령선거","경기도","구리시",2757,1609,597,387,403,109,97,1,1,1,0,1,1,1,2,1601,8,1148
"7482","교문1동","교문1동제2투","대통령선거","경기도","구리시",2101,1227,424,366,299,56,75,1,0,0,0,1,0,1,0,1223,4,874
"7483","교문1동","교문1동제3투","대통령선거","경기도","구리시",2391,1553,518,422,408,93,94,6,0,0,0,0,0,2,2,1545,8,838
"7484","교문1동","교문1동제4투","대통령선거","경기도","구리시",2528,1582,505,474,431,74,80,1,0,1,0,3,3,5,1,1578,4,946
"7485","교문1동","교문1동제5투","대통령선거","경기도","구리시",1530,1054,389,271,250,70,62,3,0,0,0,0,0,2,1,1048,6,476
"7486","교문1동","교문1동제6투","대통령선거","경기도","구리시",1009,802,293,195,216,66,30,0,0,0,0,0,0,0,0,800,2,207
"7487","교문2동","관내사전투표","대통령선거","경기도","구리시",2407,2407,1107,433,502,188,157,7,0,0,0,1,1,1,1,2398,9,0
"7488","교문2동","교문2동제1투","대통령선거","경기도","구리시",2332,1775,793,324,391,142,113,6,0,0,0,0,0,0,0,1769,6,557
"7489","교문2동","교문2동제2투","대통령선거","경기도","구리시",2092,1321,506,305,326,93,83,2,0,1,0,0,1,0,0,1317,4,771
"7490","교문2동","교문2동제3투","대통령선거","경기도","구리시",2091,1651,652,363,412,107,104,5,0,1,1,1,0,1,1,1648,3,440
"7491","교문2동","교문2동제4투","대통령선거","경기도","구리시",2250,1894,730,444,461,131,120,3,0,0,1,0,0,0,0,1890,4,356
"7492","교문2동","교문2동제5투","대통령선거","경기도","구리시",2507,1996,753,442,479,167,145,2,0,1,1,0,0,1,1,1992,4,511
"7493","교문2동","교문2동제6투","대통령선거","경기도","구리시",2602,2130,851,483,489,148,153,0,0,0,0,0,0,0,0,2124,6,472
"7494","수택1동","관내사전투표","대통령선거","경기도","구리시",3031,3031,1390,612,664,161,185,2,0,1,0,3,0,1,2,3021,10,0
"7495","수택1동","수택1동제1투","대통령선거","경기도","구리시",3576,2097,799,539,515,122,105,2,0,1,1,3,0,1,1,2089,8,1479
"7496","수택1동","수택1동제2투","대통령선거","경기도","구리시",2155,1173,371,355,304,64,66,3,0,0,0,3,1,0,2,1169,4,982
"7497","수택1동","수택1동제3투","대통령선거","경기도","구리시",2989,1636,561,469,375,91,120,1,0,3,0,0,0,0,0,1620,16,1353
"7498","수택1동","수택1동제4투","대통령선거","경기도","구리시",3510,2471,844,674,611,150,179,4,0,0,0,0,0,0,2,2464,7,1039
"7499","수택1동","수택1동제5투","대통령선거","경기도","구리시",2856,2014,841,413,497,114,133,5,0,2,1,2,0,1,2,2011,3,842
"7500","수택2동","관내사전투표","대통령선거","경기도","구리시",2236,2236,931,487,496,119,176,5,0,2,0,6,0,2,2,2226,10,0
"7501","수택2동","수택2동제1투","대통령선거","경기도","구리시",2774,1673,614,420,404,97,124,1,0,0,0,5,1,0,4,1670,3,1101
"7502","수택2동","수택2동제2투","대통령선거","경기도","구리시",2651,1825,658,476,449,109,121,2,0,0,0,0,0,2,1,1818,7,826
"7503","수택2동","수택2동제3투","대통령선거","경기도","구리시",2906,1779,631,499,424,108,99,0,0,2,0,3,1,1,0,1768,11,1127
"7504","수택2동","수택2동제4투","대통령선거","경기도","구리시",2099,1350,476,383,345,66,71,0,0,1,0,0,0,0,1,1343,7,749
"7505","수택2동","수택2동제5투","대통령선거","경기도","구리시",2744,1842,742,378,474,101,126,5,0,1,0,1,1,0,3,1832,10,902
"7506","수택2동","수택2동제6투","대통령선거","경기도","구리시",1613,1020,367,235,263,72,71,5,2,0,0,0,1,1,1,1018,2,593
"7507","수택2동","수택2동제7투","대통령선거","경기도","구리시",2908,2047,746,439,553,135,152,7,0,1,1,1,1,3,2,2041,6,861
"7508","수택3동","관내사전투표","대통령선거","경기도","구리시",4179,4179,1933,716,836,325,338,4,1,4,0,6,1,3,2,4169,10,0
"7509","수택3동","수택3동제1투","대통령선거","경기도","구리시",2759,1931,866,324,479,133,126,1,0,0,0,0,0,0,1,1930,1,828
"7510","수택3동","수택3동제2투","대통령선거","경기도","구리시",2720,2159,865,556,469,128,132,3,1,0,0,0,1,0,1,2156,3,561
"7511","수택3동","수택3동제3투","대통령선거","경기도","구리시",3489,2825,1156,602,690,211,154,2,0,1,0,1,0,1,2,2820,5,664
"7512","수택3동","수택3동제4투","대통령선거","경기도","구리시",2614,1519,616,388,333,87,78,1,1,0,1,1,2,2,3,1513,6,1095
"7513","수택3동","수택3동제5투","대통령선거","경기도","구리시",2214,1632,715,301,391,110,107,2,1,0,0,0,0,0,0,1627,5,582
"7514","잘못 투입·구분된 투표지","잘못 투입·구분된 투표지","대통령선거","경기도","구리시",0,0,0,0,0,0,0,0,0,0,0,0,0,0,0,0,0,0
"7515","거소·선상투표","거소·선상투표","대통령선거","경기도","남양주시",941,889,306,151,284,60,24,7,4,4,4,1,3,2,6,856,33,52
"7516","관외사전투표","관외사전투표","대통령선거","경기도","남양주시",41543,41531,19158,6596,8911,3085,3315,50,11,20,12,29,10,21,56,41274,257,12
"7517","재외투표","재외투표","대통령선거","경기도","남양주시",3503,2746,1691,196,388,120,320,23,1,2,0,1,0,0,0,2742,4,757
"7518","와부읍","관내사전투표","대통령선거","경기도","남양주시",7642,7642,3681,1423,1440,496,545,13,1,2,2,4,1,3,7,7618,24,0
"7519","와부읍","와부읍제1투","대통령선거","경기도","남양주시",3770,2698,1029,644,638,192,168,4,0,3,0,2,0,2,0,2682,16,1072
"7520","와부읍","와부읍제2투","대통령선거","경기도","남양주시",3109,1772,583,572,392,101,105,1,0,2,0,1,1,2,0,1760,12,1337
"7521","와부읍","와부읍제3투","대통령선거","경기도","남양주시",2792,2173,831,530,498,150,146,3,1,1,0,1,1,2,1,2165,8,619
"7522","와부읍","와부읍제4투","대통령선거","경기도","남양주시",3617,2763,1054,651,659,211,168,7,1,3,0,2,0,1,0,2757,6,854
"7523","와부읍","와부읍제5투","대통령선거","경기도","남양주시",934,671,187,283,128,32,34,2,0,2,0,0,0,2,0,670,1,263
"7524","와부읍","와부읍제6투","대통령선거","경기도","남양주시",762,550,138,241,106,26,33,1,0,0,1,0,1,0,0,547,3,212
"7525","와부읍","와부읍제7투","대통령선거","경기도","남양주시",3234,2585,1041,622,609,159,137,4,1,1,0,1,0,3,2,2580,5,649
"7526","와부읍","와부읍제8투","대통령선거","경기도","남양주시",2769,2172,824,566,501,149,120,2,0,3,0,0,1,1,1,2168,4,597
"7527","와부읍","와부읍제9투","대통령선거","경기도","남양주시",2111,1462,475,488,304,75,106,6,1,1,2,0,0,0,1,1459,3,649
"7528","와부읍","와부읍제10투","대통령선거","경기도","남양주시",2615,2001,842,410,474,122,141,5,0,1,0,0,1,0,2,1998,3,614
"7529","와부읍","와부읍제11투","대통령선거","경기도","남양주시",3468,2817,1154,610,610,244,182,5,0,1,0,0,0,1,1,2808,9,651
"7530","와부읍","와부읍제12투","대통령선거","경기도","남양주시",654,449,123,199,86,18,22,1,0,0,0,0,0,0,0,449,0,205
"7531","와부읍","와부읍제13투","대통령선거","경기도","남양주시",2480,2052,721,608,442,165,105,3,0,0,0,1,1,1,1,2048,4,428
"7532","와부읍","와부읍제14투","대통령선거","경기도","남양주시",2963,2271,871,636,488,158,109,4,1,0,0,1,1,0,1,2270,1,692
"7533","와부읍","와부읍제15투","대통령선거","경기도","남양주시",2310,1934,810,422,421,165,105,1,0,0,1,1,1,0,1,1928,6,376
"7534","와부읍","와부읍제16투","대통령선거","경기도","남양주시",2814,2195,948,458,480,174,118,4,0,1,0,0,0,0,3,2186,9,619
"7535","와부읍","와부읍제17투","대통령선거","경기도","남양주시",1902,1536,671,293,365,106,96,1,0,1,0,2,0,0,0,1535,1,366
"7536","진접읍","관내사전투표","대통령선거","경기도","남양주시",9402,9402,4467,1680,1967,568,655,14,0,3,0,4,3,2,3,9366,36,0
"7537","진접읍","진접읍제1투","대통령선거","경기도","남양주시",4568,2674,1045,599,658,153,192,8,2,2,3,1,1,0,2,2666,8,1894
"7538","진접읍","진접읍제2투","대통령선거","경기도","남양주시",3578,2335,953,527,573,112,155,7,0,2,0,0,0,2,1,2332,3,1243
"7539","진접읍","진접읍제3투","대통령선거","경기도","남양주시",3951,2732,1125,554,671,178,188,3,0,1,0,0,1,0,4,2725,7,1219
"7540","진접읍","진접읍제4투","대통령선거","경기도","남양주시",3226,1903,565,643,494,86,101,4,0,2,1,0,0,0,1,1897,6,1323
"7541","진접읍","진접읍제5투","대통령선거","경기도","남양주시",2741,1685,601,485,381,119,89,2,1,1,1,1,1,0,0,1682,3,1056
"7542","진접읍","진접읍제6투","대통령선거","경기도","남양주시",3854,2388,856,647,575,142,146,2,0,2,1,1,1,3,1,2377,11,1466
"7543","진접읍","진접읍제7투","대통령선거","경기도","남양주시",4522,3051,1113,700,807,195,212,5,0,3,0,2,1,2,5,3045,6,1471
"7544","진접읍","진접읍제8투","대통령선거","경기도","남양주시",4004,2538,859,707,641,148,165,6,0,3,0,1,0,1,2,2533,5,1466
"7545","진접읍","진접읍제9투","대통령선거","경기도","남양주시",3135,1990,604,689,505,81,93,2,0,2,0,2,0,1,1,1980,10,1145
"7546","진접읍","진접읍제10투","대통령선거","경기도","남양주시",3568,2622,1193,511,581,159,162,3,0,1,0,4,1,0,3,2618,4,946
"7547","진접읍","진접읍제11투","대통령선거","경기도","남양주시",3096,2052,770,476,503,141,140,4,0,3,0,2,1,3,3,2046,6,1044
"7548","진접읍","진접읍제12투","대통령선거","경기도","남양주시",5336,3616,1535,699,951,212,196,8,0,2,3,0,1,0,1,3608,8,1720
"7549","진접읍","진접읍제13투","대통령선거","경기도","남양주시",3624,2740,1343,376,627,201,186,0,1,1,0,0,1,0,0,2736,4,884
"7550","진접읍","진접읍제14투","대통령선거","경기도","남양주시",3897,2780,1256,406,720,195,193,3,0,0,0,0,1,1,1,2776,4,1117
"7551","진접읍","진접읍제15투","대통령선거","경기도","남양주시",4256,2581,1015,573,617,156,197,3,0,4,1,1,3,0,2,2572,9,1675
"7552","화도읍","관내사전투표","대통령선거","경기도","남양주시",10632,10632,4875,1977,2266,608,833,11,1,1,3,7,4,6,9,10601,31,0
"7553","화도읍","화도읍제1투","대통령선거","경기도","남양주시",3227,2086,782,470,563,111,148,3,0,0,0,0,0,0,2,2079,7,1141
"7554","화도읍","화도읍제2투","대통령선거","경기도","남양주시",3527,2093,809,399,576,127,168,4,0,1,0,0,0,0,5,2089,4,1434
"7555","화도읍","화도읍제3투","대통령선거","경기도","남양주시",4295,2609,997,670,656,120,147,1,1,2,1,5,1,1,1,2603,6,1686
"7556","화도읍","화도읍제4투","대통령선거","경기도","남양주시",3508,2209,830,528,547,124,155,3,0,4,1,0,1,2,2,2197,12,1299
"7557","화도읍","화도읍제5투","대통령선거","경기도","남양주시",4803,2841,997,750,760,145,165,3,1,3,0,2,0,1,1,2828,13,1962
"7558","화도읍","화도읍제6투","대통령선거","경기도","남양주시",3426,2134,740,548,577,105,140,3,0,3,1,7,1,1,2,2128,6,1292
"7559","화도읍","화도읍제7투","대통령선거","경기도","남양주시",5733,3572,1351,821,928,218,228,7,1,2,2,0,2,0,2,3562,10,2161
"7560","화도읍","화도읍제8투","대통령선거","경기도","남양주시",3201,2141,882,456,553,115,121,2,0,2,0,0,2,0,0,2133,8,1060
"7561","화도읍","화도읍제9투","대통령선거","경기도","남양주시",2871,1898,737,460,436,125,132,0,0,0,0,2,0,0,2,1894,4,973
"7562","화도읍","화도읍제10투","대통령선거","경기도","남양주시",3578,2748,1114,611,678,160,175,3,0,0,1,1,0,1,1,2745,3,830
"7563","화도읍","화도읍제11투","대통령선거","경기도","남양주시",2895,2098,915,377,488,162,140,4,0,4,0,2,0,1,0,2093,5,797
"7564","화도읍","화도읍제12투","대통령선거","경기도","남양주시",2709,1622,444,634,369,77,83,2,0,2,1,0,1,1,1,1615,7,1087
"7565","화도읍","화도읍제13투","대통령선거","경기도","남양주시",1067,686,189,263,175,31,23,0,0,1,0,1,1,0,1,685,1,381
"7566","화도읍","화도읍제14투","대통령선거","경기도","남양주시",2922,1827,768,340,435,104,164,0,0,4,0,2,0,0,2,1819,8,1095
"7567","화도읍","화도읍제15투","대통령선거","경기도","남양주시",4032,2046,807,432,513,136,146,0,0,1,2,2,0,1,0,2040,6,1986
"7568","화도읍","화도읍제16투","대통령선거","경기도","남양주시",3018,1837,757,398,440,92,133,4,1,1,0,3,0,0,1,1830,7,1181
"7569","화도읍","화도읍제17투","대통령선거","경기도","남양주시",2711,1763,699,451,402,99,97,3,1,1,0,1,1,1,1,1757,6,948
"7570","화도읍","화도읍제18투","대통령선거","경기도","남양주시",3164,1888,722,403,478,126,153,1,0,0,0,2,0,0,0,1885,3,1276
"7571","화도읍","화도읍제19투","대통령선거","경기도","남양주시",4058,2783,1196,530,683,166,192,4,0,0,1,2,1,1,2,2778,5,1275
"7572","진건읍","관내사전투표","대통령선거","경기도","남양주시",3515,3515,1526,766,728,207,268,1,1,2,1,1,0,0,3,3504,11,0
"7573","진건읍","진건읍제1투","대통령선거","경기도","남양주시",3028,1760,595,494,451,92,108,3,0,0,2,2,0,2,2,1751,9,1268
"7574","진건읍","진건읍제2투","대통령선거","경기도","남양주시",897,578,157,233,125,27,33,0,0,0,0,0,0,2,0,577,1,319
"7575","진건읍","진건읍제3투","대통령선거","경기도","남양주시",1531,973,218,435,234,44,32,1,2,1,0,1,0,0,0,968,5,558
"7576","진건읍","진건읍제4투","대통령선거","경기도","남양주시",2755,1835,655,426,479,136,124,3,1,0,0,0,0,1,3,1828,7,920
"7577","진건읍","진건읍제5투","대통령선거","경기도","남양주시",3699,2353,868,607,563,165,127,8,0,1,0,1,0,2,3,2345,8,1346
"7578","진건읍","진건읍제6투","대통령선거","경기도","남양주시",3752,2653,1025,627,641,182,161,6,0,0,0,3,0,1,2,2648,5,1099
"7579","진건읍","진건읍제7투","대통령선거","경기도","남양주시",2094,1256,369,403,351,54,61,0,0,2,0,0,0,1,3,1244,12,838
"7580","오남읍","관내사전투표","대통령선거","경기도","남양주시",6564,6564,3099,1178,1394,377,480,3,0,2,0,4,1,0,6,6544,20,0
"7581","오남읍","오남읍제1투","대통령선거","경기도","남양주시",3507,1807,690,510,417,92,79,8,0,1,1,0,0,0,2,1800,7,1700
"7582","오남읍","오남읍제2투","대통령선거","경기도","남양주시",3378,2206,940,461,494,130,164,2,2,4,0,0,1,1,1,2200,6,1172
"7583","오남읍","오남읍제3투","대통령선거","경기도","남양주시",4624,2784,957,733,729,167,183,1,0,3,0,2,0,0,3,2778,6,1840
"7584","오남읍","오남읍제4투","대통령선거","경기도","남양주시",3485,2080,685,549,588,109,123,2,0,1,1,4,2,1,4,2069,11,1405
"7585","오남읍","오남읍제5투","대통령선거","경기도","남양주시",4017,2426,949,549,595,140,174,5,0,1,0,0,0,2,2,2417,9,1591
"7586","오남읍","오남읍제6투","대통령선거","경기도","남양주시",3254,2153,892,451,529,120,148,2,0,1,0,1,1,0,1,2146,7,1101
"7587","오남읍","오남읍제7투","대통령선거","경기도","남양주시",2379,1698,725,334,421,91,117,6,0,1,0,1,0,0,1,1697,1,681
"7588","오남읍","오남읍제8투","대통령선거","경기도","남양주시",3996,2730,1176,560,643,150,183,5,0,4,0,0,4,0,1,2726,4,1266
"7589","오남읍","오남읍제9투","대통령선거","경기도","남양주시",3890,2778,1311,439,635,203,182,3,0,0,0,3,0,1,0,2777,1,1112
"7590","별내면","관내사전투표","대통령선거","경기도","남양주시",2839,2839,1330,493,627,171,201,4,2,1,0,0,1,1,2,2833,6,0
"7591","별내면","별내면제1투","대통령선거","경기도","남양주시",1152,620,162,247,156,30,19,2,0,0,0,1,0,0,2,619,1,532
"7592","별내면","별내면제2투","대통령선거","경기도","남양주시",2786,2061,852,442,513,122,122,3,1,1,0,2,1,0,0,2059,2,725
"7593","별내면","별내면제3투","대통령선거","경기도","남양주시",3099,2087,750,527,561,125,106,5,1,2,1,1,1,2,0,2082,5,1012
"7594","별내면","별내면제4투","대통령선거","경기도","남양주시",2856,2125,874,488,485,144,124,1,0,2,0,1,0,1,1,2121,4,731
"7595","별내면","별내면제5투","대통령선거","경기도","남양주시",2995,2169,801,526,563,114,152,1,2,1,1,1,0,1,0,2163,6,826
"7596","퇴계원면","관내사전투표","대통령선거","경기도","남양주시",5061,5061,2225,1072,1104,308,306,8,2,2,1,5,1,3,3,5040,21,0
"7597","퇴계원면","퇴계원면제1투","대통령선거","경기도","남양주시",3452,2465,891,577,622,176,186,2,1,0,0,1,1,0,1,2458,7,987
"7598","퇴계원면","퇴계원면제2투","대통령선거","경기도","남양주시",4137,2631,964,636,666,166,175,8,0,2,0,3,0,1,1,2622,9,1506
"7599","퇴계원면","퇴계원면제3투","대통령선거","경기도","남양주시",3970,2592,929,689,625,173,153,3,0,3,0,4,1,0,5,2585,7,1378
"7600","퇴계원면","퇴계원면제4투","대통령선거","경기도","남양주시",4694,3468,1315,799,883,243,213,4,0,2,0,2,0,0,0,3461,7,1226
"7601","퇴계원면","퇴계원면제5투","대통령선거","경기도","남양주시",3201,2421,951,619,563,147,130,1,0,1,0,0,1,0,1,2414,7,780
"7602","수동면","관내사전투표","대통령선거","경기도","남양주시",1584,1584,502,552,313,49,85,6,5,1,1,2,5,2,14,1537,47,0
"7603","수동면","수동면제1투","대통령선거","경기도","남양주시",3249,1838,522,630,499,77,85,6,1,0,0,1,0,1,5,1827,11,1411
"7604","수동면","수동면제2투","대통령선거","경기도","남양주시",2524,1543,423,579,386,75,66,3,0,1,0,1,0,0,1,1535,8,981
"7605","조안면","관내사전투표","대통령선거","경기도","남양주시",486,486,190,160,87,24,21,1,0,0,0,2,0,0,0,485,1,0
"7606","조안면","조안면제1투","대통령선거","경기도","남양주시",1354,853,223,359,185,47,33,1,0,1,1,1,0,0,0,851,2,501
"7607","조안면","조안면제2투","대통령선거","경기도","남양주시",1402,943,293,361,187,44,53,0,0,0,1,0,0,0,0,939,4,459
"7608","호평동","관내사전투표","대통령선거","경기도","남양주시",6748,6748,3391,1014,1305,502,494,9,0,5,0,8,0,1,4,6733,15,0
"7609","호평동","호평동제1투","대통령선거","경기도","남양주시",3199,1851,802,385,446,89,112,4,0,1,1,1,0,0,3,1844,7,1348
"7610","호평동","호평동제2투","대통령선거","경기도","남양주시",4296,3126,1358,574,803,182,191,2,0,3,1,3,0,0,1,3118,8,1170
"7611","호평동","호평동제3투","대통령선거","경기도","남양주시",4453,3107,1312,646,729,188,218,4,0,1,0,2,2,1,1,3104,3,1346
"7612","호평동","호평동제4투","대통령선거","경기도","남양주시",2850,2132,966,421,492,115,131,3,0,0,0,1,0,0,2,2131,1,718
"7613","호평동","호평동제5투","대통령선거","경기도","남양주시",3054,2218,1003,416,515,146,133,2,0,0,0,0,0,1,1,2217,1,836
"7614","호평동","호평동제6투","대통령선거","경기도","남양주시",2363,1893,884,310,446,121,121,5,0,1,2,0,0,0,1,1891,2,470
"7615","호평동","호평동제7투","대통령선거","경기도","남양주시",4085,2903,1271,549,694,193,178,3,3,2,0,2,0,0,3,2898,5,1182
"7616","호평동","호평동제8투","대통령선거","경기도","남양주시",3429,2505,1149,391,585,183,185,2,0,1,0,2,1,1,0,2500,5,924
"7617","평내동","관내사전투표","대통령선거","경기도","남양주시",4992,4992,2485,802,940,369,369,10,0,0,0,1,1,2,3,4982,10,0
"7618","평내동","평내동제1투","대통령선거","경기도","남양주시",3684,2366,897,638,543,140,125,2,0,1,0,0,0,3,5,2354,12,1318
"7619","평내동","평내동제2투","대통령선거","경기도","남양주시",4250,2594,977,617,646,153,177,3,0,0,0,4,2,1,3,2583,11,1656
"7620","평내동","평내동제3투","대통령선거","경기도","남양주시",3428,2664,1330,399,608,151,168,0,0,1,0,0,1,0,3,2661,3,764
"7621","평내동","평내동제4투","대통령선거","경기도","남양주시",2651,2043,931,354,484,125,138,3,0,0,0,0,5,0,0,2040,3,608
"7622","평내동","평내동제5투","대통령선거","경기도","남양주시",4639,3247,1448,618,731,237,197,5,0,0,1,1,0,2,1,3241,6,1392
"7623","평내동","평내동제6투","대통령선거","경기도","남양주시",2636,1987,902,361,442,131,142,3,0,1,2,0,1,0,0,1985,2,649
"7624","평내동","평내동제7투","대통령선거","경기도","남양주시",2542,2015,892,369,454,137,156,2,0,1,0,2,1,0,0,2014,1,527
"7625","금곡동","관내사전투표","대통령선거","경기도","남양주시",2921,2921,1331,594,605,176,198,3,0,1,2,0,0,2,2,2914,7,0
"7626","금곡동","금곡동제1투","대통령선거","경기도","남양주시",2299,1414,440,492,324,75,69,3,1,2,0,0,0,1,1,1408,6,885
"7627","금곡동","금곡동제2투","대통령선거","경기도","남양주시",2724,1753,581,527,423,96,110,5,0,2,0,0,1,1,1,1747,6,971
"7628","금곡동","금곡동제3투","대통령선거","경기도","남양주시",2760,1793,632,470,433,121,124,1,0,2,1,0,0,1,3,1788,5,967
"7629","금곡동","금곡동제4투","대통령선거","경기도","남양주시",2333,1406,467,381,386,86,76,4,0,0,0,0,0,0,0,1400,6,927
"7630","금곡동","금곡동제5투","대통령선거","경기도","남양주시",4797,3273,1105,941,774,217,205,4,1,1,1,1,0,3,3,3256,17,1524
"7631","양정동","관내사전투표","대통령선거","경기도","남양주시",804,804,298,210,188,51,52,0,1,0,0,0,0,1,3,804,0,0
"7632","양정동","양정동제1투","대통령선거","경기도","남양주시",2001,1237,310,459,323,78,64,1,0,1,0,0,0,0,0,1236,1,764
"7633","양정동","양정동제2투","대통령선거","경기도","남양주시",1474,1011,297,393,216,50,42,0,0,0,1,0,0,1,3,1003,8,463
"7634","지금동","관내사전투표","대통령선거","경기도","남양주시",1176,1176,517,249,251,69,81,1,1,1,0,0,0,0,1,1171,5,0
"7635","지금동","지금동제1투","대통령선거","경기도","남양주시",1094,728,301,187,155,41,39,1,1,1,0,0,0,0,0,726,2,366
"7636","지금동","지금동제2투","대통령선거","경기도","남양주시",4108,3101,1237,699,744,218,189,3,0,0,0,0,1,3,1,3095,6,1007
"7637","지금동","지금동제3투","대통령선거","경기도","남양주시",3494,2446,882,619,626,150,147,10,0,1,0,2,0,0,1,2438,8,1048
"7638","지금동","지금동제4투","대통령선거","경기도","남양주시",3073,2466,1137,434,535,176,170,1,0,1,0,3,0,0,1,2458,8,607
"7639","도농동","관내사전투표","대통령선거","경기도","남양주시",5468,5468,2531,967,1128,386,424,7,0,3,0,2,1,1,3,5453,15,0
"7640","도농동","도농동제1투","대통령선거","경기도","남양주시",3468,2102,809,533,469,130,145,1,0,2,0,0,1,0,5,2095,7,1366
"7641","도농동","도농동제2투","대통령선거","경기도","남양주시",3883,2828,1154,622,676,175,176,3,0,3,0,2,2,0,4,2817,11,1055
"7642","도농동","도농동제3투","대통령선거","경기도","남양주시",4455,3291,1299,754,780,215,224,2,0,5,1,0,0,0,1,3281,10,1164
"7643","도농동","도농동제4투","대통령선거","경기도","남양주시",2486,2022,658,615,497,146,88,7,0,0,0,0,0,1,0,2012,10,464
"7644","도농동","도농동제5투","대통령선거","경기도","남양주시",3104,2546,928,701,573,184,146,6,0,0,0,1,0,0,0,2539,7,558
"7645","도농동","도농동제6투","대통령선거","경기도","남양주시",3627,2896,1010,770,748,190,158,0,0,1,1,3,0,4,1,2886,10,731
"7646","도농동","도농동제7투","대통령선거","경기도","남양주시",3140,2502,818,800,558,191,121,2,0,1,0,0,0,0,1,2492,10,638
"7647","별내동","관내사전투표","대통령선거","경기도","남양주시",8548,8548,4369,1324,1637,583,586,12,1,1,1,3,3,3,4,8527,21,0
"7648","별내동","별내동제1투","대통령선거","경기도","남양주시",3698,2612,1119,462,692,157,169,3,0,1,0,1,1,0,1,2606,6,1086
"7649","별내동","별내동제2투","대통령선거","경기도","남양주시",3199,2465,1084,435,612,180,142,3,0,0,0,2,0,1,0,2459,6,734
"7650","별내동","별내동제3투","대통령선거","경기도","남양주시",2393,1772,758,388,402,113,100,0,0,0,0,0,1,1,1,1764,8,621
"7651","별내동","별내동제4투","대통령선거","경기도","남양주시",3802,3033,1382,487,769,209,167,3,0,1,1,2,1,0,3,3025,8,769
"7652","별내동","별내동제5투","대통령선거","경기도","남양주시",3587,2775,1215,466,717,180,180,5,0,0,0,3,0,0,2,2768,7,812
"7653","별내동","별내동제6투","대통령선거","경기도","남양주시",1915,1280,562,240,327,60,83,1,1,0,0,0,0,0,4,1278,2,635
"7654","별내동","별내동제7투","대통령선거","경기도","남양주시",2994,2174,815,537,515,158,127,7,0,2,1,0,1,0,1,2164,10,820
"7655","별내동","별내동제8투","대통령선거","경기도","남양주시",4039,2899,1188,613,728,178,174,8,0,1,0,0,0,2,1,2893,6,1140
"7656","별내동","별내동제9투","대통령선거","경기도","남양주시",2065,1481,573,289,382,122,104,5,1,1,0,0,0,1,1,1479,2,584
"7657","별내동","별내동제10투","대통령선거","경기도","남양주시",2388,1802,704,385,451,153,95,8,1,1,0,0,1,0,0,1799,3,586
"7658","별내동","별내동제11투","대통령선거","경기도","남양주시",2313,1705,663,363,416,135,120,2,1,2,0,0,0,0,0,1702,3,608
"7659","별내동","별내동제12투","대통령선거","경기도","남양주시",3127,2337,980,466,564,147,167,0,1,1,0,1,0,1,1,2329,8,790
"7660","별내동","별내동제13투","대통령선거","경기도","남양주시",2915,2068,844,390,501,187,133,3,0,0,0,1,0,0,0,2059,9,847
"7661","잘못 투입·구분된 투표지","잘못 투입·구분된 투표지","대통령선거","경기도","남양주시",0,0,0,0,0,0,0,0,0,0,0,0,0,0,0,0,0,0
"7662","거소·선상투표","거소·선상투표","대통령선거","경기도","오산시",266,244,91,32,80,18,11,0,0,1,1,0,2,1,1,238,6,22
"7663","관외사전투표","관외사전투표","대통령선거","경기도","오산시",13452,13448,6508,1805,2828,1039,1092,13,2,10,7,16,7,5,28,13360,88,4
"7664","재외투표","재외투표","대통령선거","경기도","오산시",714,547,333,42,84,31,54,0,0,0,0,0,1,0,0,545,2,167
"7665","중앙동","관내사전투표","대통령선거","경기도","오산시",4943,4943,2287,973,985,322,333,6,0,6,3,0,3,1,3,4922,21,0
"7666","중앙동","중앙동제1투","대통령선거","경기도","오산시",1578,856,241,318,196,53,38,0,0,0,1,0,0,1,1,849,7,722
"7667","중앙동","중앙동제2투","대통령선거","경기도","오산시",2687,1463,440,473,347,99,89,3,0,0,1,0,1,2,2,1457,6,1224
"7668","중앙동","중앙동제3투","대통령선거","경기도","오산시",3391,2362,1073,320,590,167,188,4,1,2,3,2,0,0,3,2353,9,1029
"7669","중앙동","중앙동제4투","대통령선거","경기도","오산시",2285,1602,628,317,389,112,150,0,0,0,0,0,0,1,4,1601,1,683
"7670","중앙동","중앙동제5투","대통령선거","경기도","오산시",3321,2462,952,571,572,193,158,1,0,4,0,1,0,0,0,2452,10,859
"7671","중앙동","중앙동제6투","대통령선거","경기도","오산시",2564,1957,943,287,438,138,139,3,0,1,0,1,0,0,3,1953,4,607
"7672","대원동","관내사전투표","대통령선거","경기도","오산시",5904,5904,3019,856,1156,389,450,5,0,2,0,6,1,2,4,5890,14,0
"7673","대원동","대원동제1투","대통령선거","경기도","오산시",4246,2194,823,524,516,150,167,1,0,0,2,0,1,0,4,2188,6,2052
"7674","대원동","대원동제2투","대통령선거","경기도","오산시",1984,1437,556,301,357,111,101,2,0,1,0,0,0,1,1,1431,6,547
"7675","대원동","대원동제3투","대통령선거","경기도","오산시",2180,1477,633,291,351,99,92,1,0,1,0,1,0,1,0,1470,7,703
"7676","대원동","대원동제4투","대통령선거","경기도","오산시",3878,2373,928,548,563,162,156,3,0,1,0,1,1,1,1,2365,8,1505
"7677","대원동","대원동제5투","대통령선거","경기도","오산시",1836,1485,649,252,374,103,103,0,0,0,0,0,0,1,1,1483,2,351
"7678","대원동","대원동제6투","대통령선거","경기도","오산시",2361,1859,792,315,441,152,145,3,0,0,0,4,0,0,3,1855,4,502
"7679","대원동","대원동제7투","대통령선거","경기도","오산시",3772,2762,1136,493,700,190,224,4,0,1,0,2,1,0,2,2753,9,1010
"7680","대원동","대원동제8투","대통령선거","경기도","오산시",2733,1985,901,323,494,120,135,2,1,0,1,0,1,0,2,1980,5,748
"7681","대원동","대원동제9투","대통령선거","경기도","오산시",3999,2799,1115,533,753,156,217,2,0,2,0,2,1,2,2,2785,14,1200
"7682","대원동","대원동제10투","대통령선거","경기도","오산시",1842,1362,639,181,325,89,118,1,0,3,0,0,0,0,1,1357,5,480
"7683","대원동","대원동제11투","대통령선거","경기도","오산시",3757,2977,1405,455,692,222,189,0,1,1,0,1,1,0,2,2969,8,780
"7684","대원동","대원동제12투","대통령선거","경기도","오산시",2448,1681,740,265,453,102,110,0,2,2,0,0,0,0,2,1676,5,767
"7685","대원동","대원동제13투","대통령선거","경기도","오산시",1976,1422,579,305,342,80,110,0,0,2,0,0,0,1,0,1419,3,554
"7686","대원동","대원동제14투","대통령선거","경기도","오산시",2095,1387,578,289,369,81,54,3,0,1,0,2,1,1,0,1379,8,708
"7687","남촌동","관내사전투표","대통령선거","경기도","오산시",2178,2178,1124,289,425,161,159,3,0,0,1,4,0,0,2,2168,10,0
"7688","남촌동","남촌동제1투","대통령선거","경기도","오산시",2324,1442,484,390,377,87,96,0,0,0,0,2,1,1,1,1439,3,882
"7689","남촌동","남촌동제2투","대통령선거","경기도","오산시",1821,878,259,277,214,74,44,4,1,0,0,1,0,0,0,874,4,943
"7690","남촌동","남촌동제3투","대통령선거","경기도","오산시",2958,1155,535,137,275,94,106,0,0,0,0,0,1,1,2,1151,4,1803
"7691","남촌동","남촌동제4투","대통령선거","경기도","오산시",2548,1935,822,362,476,130,138,1,0,1,0,1,0,0,1,1932,3,613
"7692","남촌동","남촌동제5투","대통령선거","경기도","오산시",3176,1072,499,157,231,73,95,1,1,2,0,4,0,0,2,1065,7,2104
"7693","남촌동","남촌동제6투","대통령선거","경기도","오산시",2664,881,396,120,210,72,76,0,0,0,0,0,0,1,2,877,4,1783
"7694","신장동","관내사전투표","대통령선거","경기도","오산시",4810,4810,2510,732,958,270,304,7,0,2,0,5,3,5,0,4796,14,0
"7695","신장동","신장동제1투","대통령선거","경기도","오산시",2615,1613,514,504,383,100,89,5,2,1,1,0,0,0,2,1601,12,1002
"7696","신장동","신장동제2투","대통령선거","경기도","오산시",2768,1963,774,440,464,125,150,1,0,4,0,0,0,0,2,1960,3,805
"7697","신장동","신장동제3투","대통령선거","경기도","오산시",3151,2055,758,490,543,121,123,1,1,3,0,3,1,0,3,2047,8,1096
"7698","신장동","신장동제4투","대통령선거","경기도","오산시",3773,2532,916,643,628,157,168,0,0,2,1,1,0,0,4,2520,12,1241
"7699","신장동","신장동제5투","대통령선거","경기도","오산시",1870,1322,563,229,340,83,99,1,0,0,1,3,0,0,0,1319,3,548
"7700","신장동","신장동제6투","대통령선거","경기도","오산시",3052,1876,779,428,450,90,100,8,2,0,4,0,0,0,0,1861,15,1176
"7701","신장동","신장동제7투","대통령선거","경기도","오산시",3557,2240,1005,434,518,123,140,2,0,2,1,2,1,1,3,2232,8,1317
"7702","신장동","신장동제8투","대통령선거","경기도","오산시",4265,3053,1403,501,727,208,194,4,0,0,0,3,0,0,3,3043,10,1212
"7703","신장동","신장동제9투","대통령선거","경기도","오산시",2787,1928,972,270,416,124,133,2,1,0,0,1,0,0,2,1921,7,859
"7704","신장동","신장동제10투","대통령선거","경기도","오산시",2616,1878,842,325,456,123,125,0,0,0,0,3,0,0,0,1874,4,738
"7705","신장동","신장동제11투","대통령선거","경기도","오산시",2404,1523,664,333,328,97,91,1,2,1,0,1,0,0,2,1520,3,881
"7706","세마동","관내사전투표","대통령선거","경기도","오산시",3152,3152,1540,549,644,187,215,3,1,2,0,3,0,1,1,3146,6,0
"7707","세마동","세마동제1투","대통령선거","경기도","오산시",2225,1360,462,375,303,104,71,0,1,1,0,0,1,1,1,1320,40,865
"7708","세마동","세마동제2투","대통령선거","경기도","오산시",2476,1806,742,428,377,122,122,2,0,0,3,2,0,1,0,1799,7,670
"7709","세마동","세마동제3투","대통령선거","경기도","오산시",3005,2481,1164,390,571,165,179,3,0,1,1,0,0,1,2,2477,4,524
"7710","세마동","세마동제4투","대통령선거","경기도","오산시",2918,2248,1056,348,517,169,149,0,0,0,0,1,0,0,2,2242,6,670
"7711","초평동","관내사전투표","대통령선거","경기도","오산시",2340,2340,1138,410,472,112,194,3,0,1,4,1,0,0,0,2335,5,0
"7712","초평동","초평동제1투","대통령선거","경기도","오산시",2095,1173,394,364,276,60,71,4,0,0,0,0,0,0,1,1170,3,922
"7713","초평동","초평동제2투","대통령선거","경기도","오산시",2057,1242,501,246,304,78,102,3,0,0,0,0,0,0,3,1237,5,815
"7714","초평동","초평동제3투","대통령선거","경기도","오산시",1804,1130,488,210,269,81,72,0,0,0,0,1,0,0,4,1125,5,674
"7715","초평동","초평동제4투","대통령선거","경기도","오산시",1631,1182,497,213,296,68,101,0,0,1,0,1,0,0,3,1180,2,449
"7716","초평동","초평동제5투","대통령선거","경기도","오산시",1930,1247,568,166,358,57,86,1,0,1,0,0,0,1,2,1240,7,683
"7717","잘못 투입·구분된 투표지","잘못 투입·구분된 투표지","대통령선거","경기도","오산시",0,0,0,0,0,0,0,0,0,0,0,0,0,0,0,0,0,0
"7718","거소·선상투표","거소·선상투표","대통령선거","경기도","화성시",818,737,239,92,245,51,30,2,1,5,0,2,3,4,8,682,55,81
"7719","관외사전투표","관외사전투표","대통령선거","경기도","화성시",44610,44536,21074,6984,9124,3450,3411,50,12,38,8,30,11,16,63,44271,265,74
"7720","재외투표","재외투표","대통령선거","경기도","화성시",2772,2182,1375,109,337,91,256,5,0,2,0,1,1,0,0,2177,5,590
"7721","봉담읍","관내사전투표","대통령선거","경기도","화성시",7857,7857,3770,1413,1607,447,557,7,2,14,4,5,1,2,5,7834,23,0
"7722","봉담읍","봉담읍제1투","대통령선거","경기도","화성시",2896,1811,740,341,463,120,137,0,0,1,0,2,0,0,2,1806,5,1085
"7723","봉담읍","봉담읍제2투","대통령선거","경기도","화성시",2048,1390,530,281,355,94,115,3,0,3,0,1,0,1,1,1384,6,658
"7724","봉담읍","봉담읍제3투","대통령선거","경기도","화성시",2770,1795,547,614,444,79,98,2,0,0,0,2,1,0,4,1791,4,975
"7725","봉담읍","봉담읍제4투","대통령선거","경기도","화성시",2899,1706,558,475,457,89,112,5,0,3,0,0,0,1,1,1701,5,1193
"7726","봉담읍","봉담읍제5투","대통령선거","경기도","화성시",2349,1567,589,407,340,86,125,2,1,4,1,0,1,2,1,1559,8,782
"7727","봉담읍","봉담읍제6투","대통령선거","경기도","화성시",3239,2066,926,411,467,122,124,4,0,0,0,1,0,1,4,2060,6,1173
"7728","봉담읍","봉담읍제7투","대통령선거","경기도","화성시",2818,1964,800,374,473,137,169,2,1,0,0,1,1,1,0,1959,5,854
"7729","봉담읍","봉담읍제8투","대통령선거","경기도","화성시",3297,2121,923,420,513,130,112,1,0,3,0,3,2,0,4,2111,10,1176
"7730","봉담읍","봉담읍제9투","대통령선거","경기도","화성시",3155,2436,1080,436,536,169,200,1,0,0,0,4,1,1,2,2430,6,719
"7731","봉담읍","봉담읍제10투","대통령선거","경기도","화성시",4263,3334,1384,636,814,243,225,9,1,7,0,1,1,1,2,3324,10,929
"7732","봉담읍","봉담읍제11투","대통령선거","경기도","화성시",3215,2338,1099,384,537,144,162,2,0,2,1,3,1,0,2,2337,1,877
"7733","봉담읍","봉담읍제12투","대통령선거","경기도","화성시",4266,3286,1502,530,795,223,218,2,0,2,0,2,0,0,1,3275,11,980
"7734","봉담읍","봉담읍제13투","대통령선거","경기도","화성시",2006,1329,585,209,315,106,104,0,0,2,2,0,0,0,1,1324,5,677
"7735","봉담읍","봉담읍제14투","대통령선거","경기도","화성시",1608,1250,638,118,294,104,89,0,0,1,1,2,1,0,0,1248,2,358
"7736","우정읍","관내사전투표","대통령선거","경기도","화성시",2658,2658,1091,572,582,154,240,2,2,1,0,4,1,0,1,2650,8,0
"7737","우정읍","우정읍제1투","대통령선거","경기도","화성시",3004,1800,602,476,444,110,151,0,0,2,3,2,1,3,2,1796,4,1204
"7738","우정읍","우정읍제2투","대통령선거","경기도","화성시",1925,1139,268,469,294,45,50,1,0,3,1,0,1,1,3,1136,3,786
"7739","우정읍","우정읍제3투","대통령선거","경기도","화성시",2437,1330,430,379,329,78,98,1,0,2,3,1,1,0,5,1327,3,1107
"7740","우정읍","우정읍제4투","대통령선거","경기도","화성시",1307,866,376,141,186,49,95,4,0,0,0,5,1,2,1,860,6,441
"7741","우정읍","우정읍제5투","대통령선거","경기도","화성시",1373,846,264,290,193,43,43,1,0,2,0,1,2,1,2,842,4,527
"7742","우정읍","우정읍제6투","대통령선거","경기도","화성시",1242,719,181,278,169,41,38,0,0,3,0,2,0,0,2,714,5,523
"7743","향남읍","관내사전투표","대통령선거","경기도","화성시",7739,7739,3993,1014,1520,479,669,4,2,8,1,13,3,2,5,7713,26,0
"7744","향남읍","향남읍제1투","대통령선거","경기도","화성시",2849,1517,554,388,367,104,93,2,1,1,1,1,1,0,1,1514,3,1332
"7745","향남읍","향남읍제2투","대통령선거","경기도","화성시",3664,1974,794,424,485,117,138,2,1,0,1,3,1,3,0,1969,5,1690
"7746","향남읍","향남읍제3투","대통령선거","경기도","화성시",935,548,128,185,179,32,18,0,0,0,0,1,0,0,2,545,3,387
"7747","향남읍","향남읍제4투","대통령선거","경기도","화성시",1272,783,215,293,204,39,26,0,0,0,1,0,0,0,2,780,3,489
"7748","향남읍","향남읍제5투","대통령선거","경기도","화성시",2681,1676,602,416,423,94,122,3,0,2,0,3,0,0,2,1667,9,1005
"7749","향남읍","향남읍제6투","대통령선거","경기도","화성시",2581,1587,635,365,388,80,102,8,0,0,0,2,1,0,2,1583,4,994
"7750","향남읍","향남읍제7투","대통령선거","경기도","화성시",1847,1435,593,273,357,79,122,1,0,0,0,4,0,0,1,1430,5,412
"7751","향남읍","향남읍제8투","대통령선거","경기도","화성시",2907,2183,1001,357,554,126,137,2,0,0,0,1,0,1,1,2180,3,724
"7752","향남읍","향남읍제9투","대통령선거","경기도","화성시",2447,1874,945,257,418,116,131,1,0,0,0,3,0,0,1,1872,2,573
"7753","향남읍","향남읍제10투","대통령선거","경기도","화성시",4354,3177,1490,468,784,175,236,6,0,1,1,1,2,0,4,3168,9,1177
"7754","향남읍","향남읍제11투","대통령선거","경기도","화성시",2750,1961,1052,200,408,116,168,1,0,0,0,8,3,1,0,1957,4,789
"7755","향남읍","향남읍제12투","대통령선거","경기도","화성시",3226,2037,835,394,526,117,150,2,0,5,0,0,1,1,1,2032,5,1189
"7756","향남읍","향남읍제13투","대통령선거","경기도","화성시",1759,1438,732,179,296,97,122,0,0,0,1,6,0,1,2,1436,2,321
"7757","향남읍","향남읍제14투","대통령선거","경기도","화성시",2159,1625,828,161,382,111,132,3,0,0,0,2,0,0,0,1619,6,534
"7758","향남읍","향남읍제15투","대통령선거","경기도","화성시",2717,2012,910,278,512,151,153,1,0,1,0,2,2,0,1,2011,1,705
"7759","향남읍","향남읍제16투","대통령선거","경기도","화성시",2878,1671,740,288,416,104,114,1,0,0,0,1,0,0,0,1664,7,1207
"7760","향남읍","향남읍제17투","대통령선거","경기도","화성시",2313,1506,697,203,376,108,113,3,0,0,1,2,0,0,0,1503,3,807
"7761","매송면","관내사전투표","대통령선거","경기도","화성시",1041,1041,356,290,258,57,64,1,0,5,0,1,1,3,0,1036,5,0
"7762","매송면","매송면제1투","대통령선거","경기도","화성시",2064,1272,375,428,316,74,68,0,0,1,0,3,0,2,1,1268,4,792
"7763","매송면","매송면제2투","대통령선거","경기도","화성시",1484,997,304,306,222,75,70,2,0,6,0,0,1,3,1,990,7,487
"7764","매송면","매송면제3투","대통령선거","경기도","화성시",1713,1098,306,367,294,62,50,2,0,2,0,1,0,2,5,1091,7,615
"7765","비봉면","관내사전투표","대통령선거","경기도","화성시",962,962,306,309,212,64,58,0,0,2,0,5,0,1,1,958,4,0
"7766","비봉면","비봉면제1투","대통령선거","경기도","화성시",2114,1344,368,504,320,67,71,2,0,1,1,1,1,2,1,1339,5,770
"7767","비봉면","비봉면제2투","대통령선거","경기도","화성시",1127,706,143,311,172,42,22,2,0,1,0,2,1,3,1,700,6,421
"7768","비봉면","비봉면제3투","대통령선거","경기도","화성시",623,409,99,201,81,12,14,0,0,0,0,0,0,0,0,407,2,214
"7769","마도면","관내사전투표","대통령선거","경기도","화성시",936,936,335,294,199,49,50,1,0,0,0,1,0,0,2,931,5,0
"7770","마도면","마도면제1투","대통령선거","경기도","화성시",2987,1795,482,586,515,92,103,1,1,0,1,0,1,0,4,1786,9,1192
"7771","마도면","마도면제2투","대통령선거","경기도","화성시",1491,976,250,416,229,32,35,0,1,0,3,0,3,2,1,972,4,515
"7772","송산면","관내사전투표","대통령선거","경기도","화성시",1491,1491,497,473,319,90,87,3,0,4,0,2,0,1,3,1479,12,0
"7773","송산면","송산면제1투","대통령선거","경기도","화성시",4202,2332,570,913,571,127,121,2,2,2,2,3,3,0,4,2320,12,1870
"7774","송산면","송산면제2투","대통령선거","경기도","화성시",1222,784,151,398,176,25,24,2,0,5,0,0,3,0,0,784,0,438
"7775","송산면","송산면제3투","대통령선거","경기도","화성시",1878,1125,245,509,272,54,31,0,0,0,3,1,1,3,1,1120,5,753
"7776","서신면","관내사전투표","대통령선거","경기도","화성시",893,893,295,285,218,44,44,1,0,0,1,2,0,0,0,890,3,0
"7777","서신면","서신면제1투","대통령선거","경기도","화성시",1676,959,175,421,260,39,46,5,0,0,1,2,2,0,0,951,8,717
"7778","서신면","서신면제2투","대통령선거","경기도","화성시",1874,1015,267,387,276,39,36,0,0,1,0,2,0,1,2,1011,4,859
"7779","서신면","서신면제3투","대통령선거","경기도","화성시",1287,758,185,326,195,12,31,3,0,0,0,1,1,0,1,755,3,529
"7780","팔탄면","관내사전투표","대통령선거","경기도","화성시",1992,1992,758,580,429,102,105,0,1,0,0,2,0,3,2,1982,10,0
"7781","팔탄면","팔탄면제1투","대통령선거","경기도","화성시",3410,1930,549,586,545,126,101,2,2,3,0,3,0,0,4,1921,9,1480
"7782","팔탄면","팔탄면제2투","대통령선거","경기도","화성시",1515,919,250,324,256,48,38,0,0,2,0,0,0,0,0,918,1,596
"7783","팔탄면","팔탄면제3투","대통령선거","경기도","화성시",1861,1029,297,382,242,46,47,2,0,1,1,2,1,1,2,1024,5,832
"7784","장안면","관내사전투표","대통령선거","경기도","화성시",1045,1045,366,293,233,52,81,3,0,1,0,2,0,2,4,1037,8,0
"7785","장안면","장안면제1투","대통령선거","경기도","화성시",1794,928,223,344,262,49,40,1,0,0,0,1,1,0,2,923,5,866
"7786","장안면","장안면제2투","대통령선거","경기도","화성시",1886,1115,283,365,295,53,61,6,1,2,2,2,2,4,8,1084,31,771
"7787","장안면","장안면제3투","대통령선거","경기도","화성시",1116,655,171,265,160,20,28,1,0,1,0,0,2,0,1,649,6,461
"7788","장안면","장안면제4투","대통령선거","경기도","화성시",767,511,156,171,128,16,33,0,0,1,0,2,0,0,1,508,3,256
"7789","장안면","장안면제5투","대통령선거","경기도","화성시",1647,949,359,216,233,68,64,0,1,0,0,2,0,0,1,944,5,698
"7790","양감면","관내사전투표","대통령선거","경기도","화성시",654,654,246,157,171,37,35,1,0,1,1,1,0,2,0,652,2,0
"7791","양감면","양감면제1투","대통령선거","경기도","화성시",1420,861,230,329,204,42,47,2,0,0,1,1,1,0,2,859,2,559
"7792","양감면","양감면제2투","대통령선거","경기도","화성시",1520,904,208,353,238,49,47,0,0,1,0,0,0,1,1,898,6,616
"7793","정남면","관내사전투표","대통령선거","경기도","화성시",1298,1298,502,393,268,55,61,5,0,2,0,3,0,2,1,1292,6,0
"7794","정남면","정남면제1투","대통령선거","경기도","화성시",2240,1415,380,579,288,76,76,1,1,1,1,2,0,2,2,1409,6,825
"7795","정남면","정남면제2투","대통령선거","경기도","화성시",1826,995,249,406,238,50,42,1,1,0,0,1,0,3,2,993,2,831
"7796","정남면","정남면제3투","대통령선거","경기도","화성시",2279,1399,362,529,371,75,48,3,0,0,1,0,1,1,2,1393,6,880
"7797","정남면","정남면제4투","대통령선거","경기도","화성시",1757,1158,412,269,299,77,87,1,0,1,2,1,1,1,3,1154,4,599
"7798","동탄면","관내사전투표","대통령선거","경기도","화성시",1579,1579,932,176,243,121,98,2,0,0,2,2,0,0,3,1579,0,0
"7799","동탄면","동탄면제1투","대통령선거","경기도","화성시",1744,1043,393,268,243,69,62,1,1,0,0,0,1,0,3,1041,2,701
"7800","동탄면","동탄면제2투","대통령선거","경기도","화성시",467,327,72,140,80,18,14,0,0,0,0,0,2,0,0,326,1,140
"7801","동탄면","동탄면제3투","대통령선거","경기도","화성시",3261,2669,1424,306,597,167,167,0,0,2,0,1,0,0,0,2664,5,592
"7802","남양읍","관내사전투표","대통령선거","경기도","화성시",4484,4484,1957,930,946,266,341,5,2,2,1,5,2,1,5,4463,21,0
"7803","남양읍","남양읍제1투","대통령선거","경기도","화성시",2457,1443,537,356,332,92,108,3,0,1,0,0,0,0,4,1433,10,1014
"7804","남양읍","남양읍제2투","대통령선거","경기도","화성시",4020,2480,815,671,650,160,169,2,0,2,0,2,1,1,2,2475,5,1540
"7805","남양읍","남양읍제3투","대통령선거","경기도","화성시",3305,1887,512,672,494,97,94,4,0,0,0,1,1,1,2,1878,9,1418
"7806","남양읍","남양읍제4투","대통령선거","경기도","화성시",959,601,126,260,160,25,17,0,0,3,0,1,0,1,2,595,6,358
"7807","남양읍","남양읍제5투","대통령선거","경기도","화성시",3086,1844,766,302,466,135,157,2,0,1,1,2,1,0,1,1834,10,1242
"7808","남양읍","남양읍제6투","대통령선거","경기도","화성시",3264,2094,893,375,513,137,163,2,1,1,0,1,0,0,2,2088,6,1170
"7809","진안동","관내사전투표","대통령선거","경기도","화성시",3599,3599,1842,511,693,245,285,3,0,5,0,3,0,3,0,3590,9,0
"7810","진안동","진안동제1투","대통령선거","경기도","화성시",3364,1872,778,379,427,131,136,2,0,2,1,0,2,2,4,1864,8,1492
"7811","진안동","진안동제2투","대통령선거","경기도","화성시",2367,1486,680,233,368,103,92,2,0,4,0,0,0,0,0,1482,4,881
"7812","진안동","진안동제3투","대통령선거","경기도","화성시",2318,1877,807,375,437,133,108,2,0,1,0,0,2,2,6,1873,4,441
"7813","진안동","진안동제4투","대통령선거","경기도","화성시",4202,2821,1339,466,601,207,190,1,2,3,0,0,0,0,3,2812,9,1381
"7814","진안동","진안동제5투","대통령선거","경기도","화성시",3862,2786,1345,505,575,155,194,1,0,3,0,1,1,1,1,2782,4,1076
"7815","진안동","진안동제6투","대통령선거","경기도","화성시",2431,1965,932,299,426,143,148,8,1,2,0,1,0,0,0,1960,5,466
"7816","진안동","진안동제7투","대통령선거","경기도","화성시",3018,1626,810,173,328,137,163,2,0,1,0,2,2,1,1,1620,6,1392
"7817","병점1동","관내사전투표","대통령선거","경기도","화성시",4285,4285,2237,616,835,291,284,1,0,2,0,2,1,0,6,4275,10,0
"7818","병점1동","병점1동제1투","대통령선거","경기도","화성시",3402,2561,1162,403,635,157,186,1,0,0,2,2,1,0,2,2551,10,841
"7819","병점1동","병점1동제2투","대통령선거","경기도","화성시",2831,2064,912,364,470,143,157,6,0,1,0,2,1,0,2,2058,6,767
"7820","병점1동","병점1동제3투","대통령선거","경기도","화성시",2862,1868,821,332,436,137,129,3,0,1,0,2,0,0,3,1864,4,994
"7821","병점1동","병점1동제4투","대통령선거","경기도","화성시",3562,2756,1286,413,627,229,193,0,0,0,0,0,0,1,3,2752,4,806
"7822","병점1동","병점1동제5투","대통령선거","경기도","화성시",3301,2246,965,419,529,162,155,1,1,2,2,0,1,0,3,2240,6,1055
"7823","병점2동","관내사전투표","대통령선거","경기도","화성시",4247,4247,2381,486,764,257,333,6,2,7,0,0,1,1,1,4239,8,0
"7824","병점2동","병점2동제1투","대통령선거","경기도","화성시",3348,2427,1185,372,524,169,166,3,0,1,1,0,2,1,1,2425,2,921
"7825","병점2동","병점2동제2투","대통령선거","경기도","화성시",3638,2929,1359,486,670,209,191,4,0,1,0,4,0,1,1,2926,3,709
"7826","병점2동","병점2동제3투","대통령선거","경기도","화성시",3471,2450,1196,319,580,173,165,4,0,2,0,1,0,1,3,2444,6,1021
"7827","병점2동","병점2동제4투","대통령선거","경기도","화성시",2986,2159,1005,370,474,138,150,3,0,3,2,3,1,0,1,2150,9,827
"7828","반월동","관내사전투표","대통령선거","경기도","화성시",3628,3628,1802,563,714,290,238,1,0,3,0,3,0,1,4,3619,9,0
"7829","반월동","반월동제1투","대통령선거","경기도","화성시",2886,2227,973,414,545,154,125,3,0,4,1,0,0,0,2,2221,6,659
"7830","반월동","반월동제2투","대통령선거","경기도","화성시",3620,2659,1130,496,605,234,170,5,0,1,1,1,0,3,2,2648,11,961
"7831","반월동","반월동제3투","대통령선거","경기도","화성시",2918,2392,1137,401,520,194,130,0,0,1,0,0,0,0,0,2383,9,526
"7832","반월동","반월동제4투","대통령선거","경기도","화성시",3429,2833,1497,315,610,222,177,2,1,1,1,0,0,0,2,2828,5,596
"7833","반월동","반월동제5투","대통령선거","경기도","화성시",1666,1320,699,135,288,113,82,0,0,0,0,0,0,1,1,1319,1,346
"7834","반월동","반월동제6투","대통령선거","경기도","화성시",1205,949,489,115,222,62,59,1,0,0,0,0,0,0,1,949,0,256
"7835","기배동","관내사전투표","대통령선거","경기도","화성시",2568,2568,1204,425,566,164,195,1,0,3,0,2,0,0,3,2563,5,0
"7836","기배동","기배동제1투","대통령선거","경기도","화성시",2752,1947,789,405,447,133,151,3,0,2,2,2,0,2,4,1940,7,805
"7837","기배동","기배동제2투","대통령선거","경기도","화성시",2452,1802,742,348,450,117,132,1,0,1,0,2,1,0,1,1795,7,650
"7838","기배동","기배동제3투","대통령선거","경기도","화성시",2567,1819,712,408,454,119,111,2,1,0,0,0,0,0,3,1810,9,748
"7839","화산동","관내사전투표","대통령선거","경기도","화성시",3368,3368,1516,729,628,210,245,6,0,2,2,4,2,2,3,3349,19,0
"7840","화산동","화산동제1투","대통령선거","경기도","화성시",2878,1789,626,477,429,121,116,4,0,5,0,3,0,0,2,1783,6,1089
"7841","화산동","화산동제2투","대통령선거","경기도","화성시",3264,2058,735,496,507,153,140,6,1,4,0,4,1,0,4,2051,7,1206
"7842","화산동","화산동제3투","대통령선거","경기도","화성시",3564,2366,904,517,587,156,186,2,0,1,0,1,2,0,0,2356,10,1198
"7843","화산동","화산동제4투","대통령선거","경기도","화성시",3795,2398,865,592,596,163,169,1,2,0,0,1,0,1,3,2393,5,1397
"7844","동탄1동","관내사전투표","대통령선거","경기도","화성시",6660,6660,3780,671,1130,542,515,2,0,2,0,1,1,1,2,6647,13,0
"7845","동탄1동","동탄1동제1투","대통령선거","경기도","화성시",2160,1727,889,238,362,125,101,3,0,1,0,1,0,0,1,1721,6,433
"7846","동탄1동","동탄1동제2투","대통령선거","경기도","화성시",3186,2479,1281,327,517,182,166,0,0,2,0,0,0,0,2,2477,2,707
"7847","동탄1동","동탄1동제3투","대통령선거","경기도","화성시",2270,1758,967,203,340,134,107,1,0,1,0,1,0,0,0,1754,4,512
"7848","동탄1동","동탄1동제4투","대통령선거","경기도","화성시",3242,2705,1594,273,499,172,154,4,0,1,1,0,0,0,1,2699,6,537
"7849","동탄1동","동탄1동제5투","대통령선거","경기도","화성시",2391,2002,1049,275,407,156,108,2,0,0,0,0,0,1,0,1998,4,389
"7850","동탄1동","동탄1동제6투","대통령선거","경기도","화성시",2965,2236,1228,244,416,186,157,3,0,2,0,0,0,0,0,2236,0,729
"7851","동탄1동","동탄1동제7투","대통령선거","경기도","화성시",2498,2053,1126,229,414,160,115,1,0,0,0,0,0,1,0,2046,7,445
"7852","동탄1동","동탄1동제8투","대통령선거","경기도","화성시",3016,2410,1106,404,558,200,135,1,0,3,0,0,0,1,1,2409,1,606
"7853","동탄1동","동탄1동제9투","대통령선거","경기도","화성시",2108,1777,920,236,367,124,122,0,0,0,0,1,0,0,0,1770,7,331
"7854","동탄1동","동탄1동제10투","대통령선거","경기도","화성시",3032,2054,1017,270,439,203,117,5,0,0,1,0,1,0,0,2053,1,978
"7855","동탄2동","관내사전투표","대통령선거","경기도","화성시",5725,5724,3195,681,1027,400,400,2,0,2,2,2,1,0,3,5715,9,1
"7856","동탄2동","동탄2동제1투","대통령선거","경기도","화성시",3193,2663,1455,320,555,192,130,4,0,0,0,2,0,1,0,2659,4,530
"7857","동탄2동","동탄2동제2투","대통령선거","경기도","화성시",2152,1695,907,220,341,121,101,4,0,0,0,0,0,0,0,1694,1,457
"7858","동탄2동","동탄2동제3투","대통령선거","경기도","화성시",3225,2592,1445,268,482,197,181,2,0,2,0,2,0,0,1,2580,12,633
"7859","동탄2동","동탄2동제4투","대통령선거","경기도","화성시",2984,2526,1170,403,616,184,144,4,0,0,0,0,0,1,0,2522,4,458
"7860","동탄2동","동탄2동제5투","대통령선거","경기도","화성시",3151,2040,983,353,460,120,109,5,0,0,1,0,0,0,3,2034,6,1111
"7861","동탄2동","동탄2동제6투","대통령선거","경기도","화성시",3903,3108,1592,349,708,261,191,1,0,0,0,1,0,0,0,3103,5,795
"7862","동탄3동","관내사전투표","대통령선거","경기도","화성시",6460,6460,3823,637,1076,450,445,6,1,5,0,2,1,1,3,6450,10,0
"7863","동탄3동","동탄3동제1투","대통령선거","경기도","화성시",3458,2822,1677,218,585,155,178,1,1,0,0,2,1,0,2,2820,2,636
"7864","동탄3동","동탄3동제2투","대통령선거","경기도","화성시",3795,2719,1422,358,598,173,156,1,0,1,0,0,3,0,1,2713,6,1076
"7865","동탄3동","동탄3동제3투","대통령선거","경기도","화성시",3625,2352,1168,320,540,164,135,4,1,2,1,1,2,1,1,2340,12,1273
"7866","동탄3동","동탄3동제4투","대통령선거","경기도","화성시",3524,2846,1516,329,622,209,162,0,0,0,0,0,0,0,2,2840,6,678
"7867","동탄3동","동탄3동제5투","대통령선거","경기도","화성시",3853,3110,1708,335,625,244,186,3,1,0,0,1,2,0,2,3107,3,743
"7868","동탄3동","동탄3동제6투","대통령선거","경기도","화성시",3496,2974,1733,245,599,203,185,0,0,0,1,2,0,0,1,2969,5,522
"7869","동탄4동","관내사전투표","대통령선거","경기도","화성시",8309,8309,4686,893,1592,593,520,6,2,2,1,1,1,2,2,8301,8,0
"7870","동탄4동","동탄4동제1투","대통령선거","경기도","화성시",3657,2885,1495,329,661,209,178,7,0,0,2,1,0,1,0,2883,2,772
"7871","동탄4동","동탄4동제2투","대통령선거","경기도","화성시",3214,2698,1529,209,612,187,152,1,0,0,0,0,0,2,0,2692,6,516
"7872","동탄4동","동탄4동제3투","대통령선거","경기도","화성시",2779,2367,1334,207,463,204,151,0,0,1,0,1,0,0,3,2364,3,412
"7873","동탄4동","동탄4동제4투","대통령선거","경기도","화성시",3626,2925,1569,345,620,231,147,1,0,1,0,3,0,2,0,2919,6,701
"7874","동탄4동","동탄4동제5투","대통령선거","경기도","화성시",3475,2850,1422,325,644,280,171,1,0,1,0,0,0,0,1,2845,5,625
"7875","동탄4동","동탄4동제6투","대통령선거","경기도","화성시",2463,2054,1182,203,410,137,119,2,0,0,0,1,0,0,0,2054,0,409
"7876","동탄4동","동탄4동제7투","대통령선거","경기도","화성시",1575,1260,652,167,262,82,88,0,0,5,0,0,0,0,1,1257,3,315
"7877","동탄4동","동탄4동제8투","대통령선거","경기도","화성시",3029,2543,1346,272,559,197,165,0,0,0,0,0,1,1,0,2541,2,486
"7878","동탄4동","동탄4동제9투","대통령선거","경기도","화성시",2157,1760,1010,171,356,114,107,1,0,0,0,0,0,0,1,1760,0,397
"7879","동탄4동","동탄4동제10투","대통령선거","경기도","화성시",2558,1800,785,308,441,113,140,6,1,1,0,0,0,2,0,1797,3,758
"7880","동탄4동","동탄4동제11투","대통령선거","경기도","화성시",3194,2709,1331,355,648,201,167,0,0,0,0,0,0,1,0,2703,6,485
"7881","동탄4동","동탄4동제12투","대통령선거","경기도","화성시",2590,2159,994,349,520,174,114,2,1,1,0,0,2,0,1,2158,1,431
"7882","동탄4동","동탄4동제13투","대통령선거","경기도","화성시",3802,3063,1514,403,710,252,171,1,0,2,0,0,0,2,2,3057,6,739
"7883","잘못 투입·구분된 투표지","잘못 투입·구분된 투표지","대통령선거","경기도","화성시",0,74,26,12,22,5,8,0,0,0,0,0,0,1,0,74,0,-74
"7884","거소·선상투표","거소·선상투표","대통령선거","경기도","시흥시",541,518,188,59,186,52,13,2,2,0,0,2,0,0,3,507,11,23
"7885","관외사전투표","관외사전투표","대통령선거","경기도","시흥시",24208,24202,11273,3345,5563,1807,1909,34,14,9,7,17,12,10,52,24052,150,6
"7886","재외투표","재외투표","대통령선거","경기도","시흥시",1368,1054,660,56,156,44,132,2,0,1,0,0,0,1,0,1052,2,314
"7887","대야동","관내사전투표","대통령선거","경기도","시흥시",4741,4741,2220,731,1102,296,337,10,1,7,1,4,0,2,5,4716,25,0
"7888","대야동","대야동제1투","대통령선거","경기도","시흥시",4293,2537,974,542,643,169,178,3,1,0,1,4,1,0,5,2521,16,1756
"7889","대야동","대야동제2투","대통령선거","경기도","시흥시",2544,1658,588,411,470,82,94,1,2,1,0,0,0,0,2,1651,7,886
"7890","대야동","대야동제3투","대통령선거","경기도","시흥시",3384,2274,899,494,593,131,142,2,0,2,0,3,1,1,2,2270,4,1110
"7891","대야동","대야동제4투","대통령선거","경기도","시흥시",3463,2661,1123,485,669,171,184,8,1,4,2,3,0,3,3,2656,5,802
"7892","대야동","대야동제5투","대통령선거","경기도","시흥시",473,335,73,154,75,17,10,3,0,0,1,0,2,0,0,335,0,138
"7893","대야동","대야동제6투","대통령선거","경기도","시흥시",1811,1374,549,286,360,85,83,1,1,1,0,2,0,2,0,1370,4,437
"7894","대야동","대야동제7투","대통령선거","경기도","시흥시",3745,2724,1093,588,646,162,207,6,1,4,0,2,1,2,1,2713,11,1021
"7895","대야동","대야동제8투","대통령선거","경기도","시흥시",1293,866,267,279,216,44,53,1,0,0,0,1,0,1,1,863,3,427
"7896","신천동","관내사전투표","대통령선거","경기도","시흥시",4010,4010,1859,777,858,226,259,3,1,2,0,5,0,2,4,3996,14,0
"7897","신천동","신천동제1투","대통령선거","경기도","시흥시",2543,1406,565,286,365,59,117,5,1,1,1,0,2,0,2,1404,2,1137
"7898","신천동","신천동제2투","대통령선거","경기도","시흥시",4518,2807,1035,703,705,148,183,1,0,2,1,4,2,1,3,2788,19,1711
"7899","신천동","신천동제3투","대통령선거","경기도","시흥시",2580,1574,521,413,443,77,91,6,0,2,1,1,1,2,2,1560,14,1006
"7900","신천동","신천동제4투","대통령선거","경기도","시흥시",3583,2240,869,526,554,115,146,2,1,0,0,2,2,2,5,2224,16,1343
"7901","신천동","신천동제5투","대통령선거","경기도","시흥시",2961,1879,725,398,511,109,115,3,3,1,0,3,0,1,2,1871,8,1082
"7902","신천동","신천동제6투","대통령선거","경기도","시흥시",3035,1925,785,414,468,102,135,2,0,1,1,1,0,4,4,1917,8,1110
"7903","신천동","신천동제7투","대통령선거","경기도","시흥시",3839,2789,1148,554,695,190,184,3,0,2,0,3,0,0,2,2781,8,1050
"7904","신천동","신천동제8투","대통령선거","경기도","시흥시",4265,2794,1081,558,740,174,217,2,0,1,0,2,0,2,3,2780,14,1471
"7905","신현동","관내사전투표","대통령선거","경기도","시흥시",1704,1704,744,375,337,99,124,2,0,1,0,4,1,3,1,1691,13,0
"7906","신현동","신현동제1투","대통령선거","경기도","시흥시",1814,1234,458,281,294,88,95,2,0,1,0,4,2,3,0,1228,6,580
"7907","신현동","신현동제2투","대통령선거","경기도","시흥시",2228,1534,508,426,407,78,107,0,1,2,0,0,0,1,0,1530,4,694
"7908","신현동","신현동제3투","대통령선거","경기도","시흥시",2679,1791,555,533,473,109,99,2,0,4,0,0,3,1,2,1781,10,888
"7909","신현동","신현동제4투","대통령선거","경기도","시흥시",403,281,63,149,48,10,8,0,0,2,0,0,0,0,1,281,0,122
"7910","은행동","관내사전투표","대통령선거","경기도","시흥시",3941,3941,1930,597,828,232,323,4,0,7,0,6,0,1,3,3931,10,0
"7911","은행동","은행동제1투","대통령선거","경기도","시흥시",3177,2053,782,481,501,122,145,3,0,2,0,2,2,1,1,2042,11,1124
"7912","은행동","은행동제2투","대통령선거","경기도","시흥시",3725,2425,992,481,605,144,162,3,0,9,3,4,0,1,10,2414,11,1300
"7913","은행동","은행동제3투","대통령선거","경기도","시흥시",3307,2615,1238,461,565,165,171,0,0,4,0,2,0,0,0,2606,9,692
"7914","은행동","은행동제4투","대통령선거","경기도","시흥시",4156,3222,1437,498,805,232,230,1,1,3,0,3,0,0,2,3212,10,934
"7915","은행동","은행동제5투","대통령선거","경기도","시흥시",3363,2618,1090,474,685,168,192,1,0,2,0,1,1,0,1,2615,3,745
"7916","매화동","관내사전투표","대통령선거","경기도","시흥시",2051,2051,879,425,452,118,154,4,1,2,0,3,1,0,4,2043,8,0
"7917","매화동","매화동제1투","대통령선거","경기도","시흥시",3318,2167,835,434,589,148,137,2,0,3,1,2,0,0,3,2154,13,1151
"7918","매화동","매화동제2투","대통령선거","경기도","시흥시",2434,1586,555,432,418,76,92,1,0,1,0,4,0,0,2,1581,5,848
"7919","매화동","매화동제3투","대통령선거","경기도","시흥시",2443,1547,559,332,415,83,129,6,2,5,0,5,1,2,0,1539,8,896
"7920","목감동","관내사전투표","대통령선거","경기도","시흥시",2670,2670,1234,471,576,176,193,6,0,3,0,3,0,0,2,2664,6,0
"7921","목감동","목감동제1투","대통령선거","경기도","시흥시",2600,1651,573,432,452,81,101,2,0,2,0,4,0,1,0,1648,3,949
"7922","목감동","목감동제2투","대통령선거","경기도","시흥시",1308,953,302,296,240,49,59,2,0,1,0,0,0,1,1,951,2,355
"7923","목감동","목감동제3투","대통령선거","경기도","시흥시",4046,2844,1113,678,668,164,192,3,0,3,0,2,0,3,5,2831,13,1202
"7924","목감동","목감동제4투","대통령선거","경기도","시흥시",3497,2596,1229,379,634,180,162,2,0,2,0,3,0,1,0,2592,4,901
"7925","군자동","관내사전투표","대통령선거","경기도","시흥시",2686,2686,1191,466,642,140,213,8,1,6,1,4,3,0,2,2677,9,0
"7926","군자동","군자동제1투","대통령선거","경기도","시흥시",3842,2258,863,529,584,101,159,1,0,5,0,2,1,0,2,2247,11,1584
"7927","군자동","군자동제2투","대통령선거","경기도","시흥시",2660,1622,661,364,384,78,121,0,1,4,0,2,1,0,3,1619,3,1038
"7928","군자동","군자동제3투","대통령선거","경기도","시흥시",3411,2249,904,469,580,105,158,8,2,0,0,4,1,0,4,2235,14,1162
"7929","군자동","군자동제4투","대통령선거","경기도","시흥시",3614,2337,853,526,645,146,146,5,1,2,3,1,1,0,5,2334,3,1277
"7930","군자동","군자동제5투","대통령선거","경기도","시흥시",2512,1617,609,384,419,81,113,0,0,1,0,1,0,1,3,1612,5,895
"7931","정왕본동","관내사전투표","대통령선거","경기도","시흥시",3149,3149,1589,446,671,173,231,5,0,6,1,4,2,2,4,3134,15,0
"7932","정왕본동","정왕본동제1투","대통령선거","경기도","시흥시",3330,1268,493,276,329,72,77,6,0,2,1,0,1,0,5,1262,6,2062
"7933","정왕본동","정왕본동제2투","대통령선거","경기도","시흥시",3563,1487,717,230,355,82,92,3,0,1,2,0,2,0,1,1485,2,2076
"7934","정왕본동","정왕본동제3투","대통령선거","경기도","시흥시",2233,910,404,183,212,41,62,1,0,1,0,2,1,0,0,907,3,1323
"7935","정왕본동","정왕본동제4투","대통령선거","경기도","시흥시",2268,899,397,160,212,54,64,5,0,0,0,0,1,0,0,893,6,1369
"7936","정왕본동","정왕본동제5투","대통령선거","경기도","시흥시",1929,719,331,112,167,49,56,1,0,1,1,1,0,0,0,719,0,1210
"7937","정왕본동","정왕본동제6투","대통령선거","경기도","시흥시",3777,2733,1175,474,691,182,190,3,0,2,0,4,1,1,1,2724,9,1044
"7938","정왕1동","관내사전투표","대통령선거","경기도","시흥시",3376,3376,1684,459,731,207,265,3,1,2,0,1,4,0,3,3360,16,0
"7939","정왕1동","정왕1동제1투","대통령선거","경기도","시흥시",2993,1879,811,303,476,110,164,5,0,1,0,1,0,0,1,1872,7,1114
"7940","정왕1동","정왕1동제2투","대통령선거","경기도","시흥시",2949,1620,647,333,416,97,114,0,0,0,0,2,1,0,1,1611,9,1329
"7941","정왕1동","정왕1동제3투","대통령선거","경기도","시흥시",3115,1373,582,257,353,79,85,1,1,4,0,1,1,1,1,1366,7,1742
"7942","정왕1동","정왕1동제4투","대통령선거","경기도","시흥시",2762,1127,488,201,285,60,77,4,0,1,0,1,0,0,4,1121,6,1635
"7943","정왕1동","정왕1동제5투","대통령선거","경기도","시흥시",2141,1445,611,295,347,81,100,2,0,1,1,0,1,0,0,1439,6,696
"7944","정왕1동","정왕1동제6투","대통령선거","경기도","시흥시",3696,2318,1047,392,536,140,190,1,1,0,0,2,1,0,1,2311,7,1378
"7945","정왕2동","관내사전투표","대통령선거","경기도","시흥시",4315,4315,2152,540,911,288,381,7,3,5,1,7,0,2,7,4304,11,0
"7946","정왕2동","정왕2동제1투","대통령선거","경기도","시흥시",3145,2191,934,329,576,153,186,1,0,2,1,2,0,1,1,2186,5,954
"7947","정왕2동","정왕2동제2투","대통령선거","경기도","시흥시",3387,2491,1043,460,620,173,183,1,0,5,0,2,1,0,2,2490,1,896
"7948","정왕2동","정왕2동제3투","대통령선거","경기도","시흥시",4180,2823,1164,524,712,186,221,1,0,4,2,1,2,0,0,2817,6,1357
"7949","정왕2동","정왕2동제4투","대통령선거","경기도","시흥시",2878,2060,884,306,539,143,177,1,0,2,0,1,0,0,0,2053,7,818
"7950","정왕2동","정왕2동제5투","대통령선거","경기도","시흥시",3282,2075,897,372,510,138,144,7,0,1,0,0,1,0,0,2070,5,1207
"7951","정왕2동","정왕2동제6투","대통령선거","경기도","시흥시",2733,1687,786,249,413,89,137,3,0,3,2,1,0,1,2,1686,1,1046
"7952","정왕3동","관내사전투표","대통령선거","경기도","시흥시",3792,3792,1844,499,831,266,323,3,1,2,1,3,2,3,3,3781,11,0
"7953","정왕3동","정왕3동제1투","대통령선거","경기도","시흥시",3209,2191,946,340,589,149,152,3,1,2,0,0,0,1,2,2185,6,1018
"7954","정왕3동","정왕3동제2투","대통령선거","경기도","시흥시",3373,2418,1054,375,673,140,162,1,0,2,0,0,0,0,3,2410,8,955
"7955","정왕3동","정왕3동제3투","대통령선거","경기도","시흥시",4025,2494,1066,440,633,189,153,3,0,0,1,0,0,0,2,2487,7,1531
"7956","정왕3동","정왕3동제4투","대통령선거","경기도","시흥시",5870,3178,1290,640,885,156,189,1,1,1,1,1,1,1,2,3169,9,2692
"7957","정왕4동","관내사전투표","대통령선거","경기도","시흥시",4627,4627,2399,553,959,313,360,11,0,3,2,7,0,2,1,4610,17,0
"7958","정왕4동","정왕4동제1투","대통령선거","경기도","시흥시",3095,2244,992,376,550,157,160,1,0,1,0,0,0,0,2,2239,5,851
"7959","정왕4동","정왕4동제2투","대통령선거","경기도","시흥시",2012,1458,582,299,377,106,88,0,0,0,1,0,0,0,0,1453,5,554
"7960","정왕4동","정왕4동제3투","대통령선거","경기도","시흥시",2740,2016,890,338,492,126,154,7,0,0,0,1,1,0,1,2010,6,724
"7961","정왕4동","정왕4동제4투","대통령선거","경기도","시흥시",2721,1985,932,266,498,134,143,1,0,0,0,3,0,1,1,1979,6,736
"7962","정왕4동","정왕4동제5투","대통령선거","경기도","시흥시",2323,1723,729,236,481,120,138,3,0,2,0,3,0,1,2,1715,8,600
"7963","정왕4동","정왕4동제6투","대통령선거","경기도","시흥시",2426,1869,885,250,462,134,123,0,1,1,1,3,0,0,1,1861,8,557
"7964","정왕4동","정왕4동제7투","대통령선거","경기도","시흥시",3145,2470,1167,300,663,156,167,2,1,1,1,3,2,0,2,2465,5,675
"7965","정왕4동","정왕4동제8투","대통령선거","경기도","시흥시",2604,2097,931,316,548,137,153,2,0,2,1,0,0,2,3,2095,2,507
"7966","과림동","관내사전투표","대통령선거","경기도","시흥시",386,386,129,127,93,15,17,2,0,0,0,0,0,1,0,384,2,0
"7967","과림동","과림동투표소","대통령선거","경기도","시흥시",1451,908,237,403,202,30,30,2,0,0,1,0,0,0,0,905,3,543
"7968","연성동","관내사전투표","대통령선거","경기도","시흥시",2712,2712,1334,423,548,179,211,2,0,2,0,4,0,0,4,2707,5,0
"7969","연성동","연성동제1투","대통령선거","경기도","시흥시",3146,2153,962,373,512,139,151,3,0,4,0,1,1,1,1,2148,5,993
"7970","연성동","연성동제2투","대통령선거","경기도","시흥시",3586,2741,1099,589,662,166,205,4,0,2,1,3,0,0,1,2732,9,845
"7971","연성동","연성동제3투","대통령선거","경기도","시흥시",3628,2801,1276,408,690,179,226,2,1,0,3,1,0,1,0,2787,14,827
"7972","연성동","연성동제4투","대통령선거","경기도","시흥시",2559,1825,810,349,444,89,117,0,0,0,0,4,1,0,4,1818,7,734
"7973","연성동","연성동제5투","대통령선거","경기도","시흥시",1735,1347,516,314,293,113,101,1,0,1,0,1,0,0,0,1340,7,388
"7974","능곡동","관내사전투표","대통령선거","경기도","시흥시",2563,2563,1280,388,527,154,188,1,0,3,1,6,2,0,3,2553,10,0
"7975","능곡동","능곡동제1투","대통령선거","경기도","시흥시",3441,2427,932,555,637,154,132,2,0,1,1,5,0,0,2,2421,6,1014
"7976","능곡동","능곡동제2투","대통령선거","경기도","시흥시",2605,1795,720,376,448,115,122,2,2,2,0,4,0,0,0,1791,4,810
"7977","능곡동","능곡동제3투","대통령선거","경기도","시흥시",2658,1889,821,332,470,124,128,0,0,0,1,3,0,0,1,1880,9,769
"7978","월곶동","관내사전투표","대통령선거","경기도","시흥시",2464,2464,1160,410,603,124,150,1,1,6,0,4,0,1,0,2460,4,0
"7979","월곶동","월곶동제1투","대통령선거","경기도","시흥시",405,288,69,107,86,14,11,0,0,0,0,0,0,1,0,288,0,117
"7980","월곶동","월곶동제2투","대통령선거","경기도","시흥시",3127,1893,773,392,499,99,117,3,0,1,2,0,1,0,2,1889,4,1234
"7981","월곶동","월곶동제3투","대통령선거","경기도","시흥시",2476,1703,803,300,386,96,111,0,0,1,0,2,1,0,1,1701,2,773
"7982","월곶동","월곶동제4투","대통령선거","경기도","시흥시",3489,2177,898,410,596,129,132,0,1,2,0,2,0,0,1,2171,6,1312
"7983","장곡동","관내사전투표","대통령선거","경기도","시흥시",3116,3116,1585,383,700,179,241,1,0,3,0,10,1,0,2,3105,11,0
"7984","장곡동","장곡동제1투","대통령선거","경기도","시흥시",3768,2826,1229,472,727,180,202,0,1,0,0,1,2,0,3,2817,9,942
"7985","장곡동","장곡동제2투","대통령선거","경기도","시흥시",3208,2371,1128,325,595,145,166,2,0,1,3,1,1,0,1,2368,3,837
"7986","장곡동","장곡동제3투","대통령선거","경기도","시흥시",2333,1715,776,251,434,110,134,6,0,0,0,1,1,0,0,1713,2,618
"7987","잘못 투입·구분된 투표지","잘못 투입·구분된 투표지","대통령선거","경기도","시흥시",0,0,0,0,0,0,0,0,0,0,0,0,0,0,0,0,0,0
"7988","거소·선상투표","거소·선상투표","대통령선거","경기도","군포시",318,296,118,35,99,22,8,2,0,1,0,2,0,0,0,287,9,22
"7989","관외사전투표","관외사전투표","대통령선거","경기도","군포시",18477,18477,8892,2469,4033,1398,1479,24,5,5,3,17,5,4,28,18362,115,0
"7990","재외투표","재외투표","대통령선거","경기도","군포시",1806,1412,905,107,185,52,154,2,0,0,0,0,0,1,0,1406,6,394
"7991","군포1동","관내사전투표","대통령선거","경기도","군포시",3496,3496,1496,763,778,204,223,5,0,5,0,1,1,3,4,3483,13,0
"7992","군포1동","군포1동제1투","대통령선거","경기도","군포시",3361,2107,833,504,488,133,127,2,0,0,0,3,1,2,3,2096,11,1254
"7993","군포1동","군포1동제2투","대통령선거","경기도","군포시",3222,1830,671,481,439,107,119,1,0,2,0,1,0,0,2,1823,7,1392
"7994","군포1동","군포1동제3투","대통령선거","경기도","군포시",3222,2083,812,505,515,132,109,0,0,2,0,2,0,0,3,2080,3,1139
"7995","군포1동","군포1동제4투","대통령선거","경기도","군포시",3267,2123,798,455,590,130,129,5,0,3,0,3,2,0,3,2118,5,1144
"7996","군포1동","군포1동제5투","대통령선거","경기도","군포시",251,122,46,33,30,5,8,0,0,0,0,0,0,0,0,122,0,129
"7997","군포1동","군포1동제6투","대통령선거","경기도","군포시",191,130,33,39,43,9,5,0,0,0,0,0,0,0,0,129,1,61
"7998","군포1동","군포1동제7투","대통령선거","경기도","군포시",3741,2960,1182,633,682,216,222,0,0,4,2,1,0,1,4,2947,13,781
"7999","군포1동","군포1동제8투","대통령선거","경기도","군포시",4696,3756,1723,610,844,297,263,3,1,2,0,1,2,1,1,3748,8,940
"8000","군포2동","관내사전투표","대통령선거","경기도","군포시",7340,7340,3507,1229,1487,473,586,14,2,7,1,4,3,0,4,7317,23,0
"8001","군포2동","군포2동제1투","대통령선거","경기도","군포시",3298,2498,1050,501,578,194,167,3,0,0,1,0,0,0,0,2494,4,800
"8002","군포2동","군포2동제2투","대통령선거","경기도","군포시",2884,2032,850,400,498,129,136,5,0,1,0,2,1,0,3,2025,7,852
"8003","군포2동","군포2동제3투","대통령선거","경기도","군포시",2893,2195,888,497,529,119,142,4,0,4,1,2,1,2,1,2190,5,698
"8004","군포2동","군포2동제4투","대통령선거","경기도","군포시",3682,2938,1279,567,672,200,199,5,1,2,2,1,0,0,1,2929,9,744
"8005","군포2동","군포2동제5투","대통령선거","경기도","군포시",2414,2036,997,307,445,160,120,1,0,3,0,0,0,0,3,2036,0,378
"8006","군포2동","군포2동제6투","대통령선거","경기도","군포시",2418,1763,676,422,431,106,120,1,0,1,0,0,0,0,0,1757,6,655
"8007","군포2동","군포2동제7투","대통령선거","경기도","군포시",3525,2759,1168,530,685,175,177,6,0,1,0,2,1,2,2,2749,10,766
"8008","군포2동","군포2동제8투","대통령선거","경기도","군포시",3879,2959,1382,516,669,177,195,3,0,3,1,0,1,0,0,2947,12,920
"8009","군포2동","군포2동제9투","대통령선거","경기도","군포시",1848,1540,725,251,324,112,121,1,0,0,0,4,0,0,1,1539,1,308
"8010","군포2동","군포2동제10투","대통령선거","경기도","군포시",1160,1003,354,233,254,97,60,1,0,0,0,0,0,1,2,1002,1,157
"8011","군포2동","군포2동제11투","대통령선거","경기도","군포시",3185,2625,1269,396,581,204,169,0,1,1,0,1,0,0,0,2622,3,560
"8012","군포2동","군포2동제12투","대통령선거","경기도","군포시",1687,1290,531,247,318,73,113,2,0,1,0,0,0,2,0,1287,3,397
"8013","산본1동","관내사전투표","대통령선거","경기도","군포시",2414,2414,1096,458,528,133,184,4,0,0,1,0,0,0,4,2408,6,0
"8014","산본1동","산본1동제1투","대통령선거","경기도","군포시",2869,1863,731,416,459,117,124,3,0,2,2,0,0,1,0,1855,8,1006
"8015","산본1동","산본1동제2투","대통령선거","경기도","군포시",1802,1149,454,286,277,62,61,2,0,1,0,0,1,0,0,1144,5,653
"8016","산본1동","산본1동제3투","대통령선거","경기도","군포시",2356,1589,596,407,396,78,100,3,1,2,1,1,0,1,2,1588,1,767
"8017","산본1동","산본1동제4투","대통령선거","경기도","군포시",2343,1690,692,361,427,103,96,3,1,2,0,0,1,0,2,1688,2,653
"8018","산본1동","산본1동제5투","대통령선거","경기도","군포시",3037,2059,811,459,502,138,128,2,1,1,0,1,1,2,3,2049,10,978
"8019","산본2동","관내사전투표","대통령선거","경기도","군포시",3755,3755,1785,676,762,265,244,8,1,4,0,1,0,0,2,3748,7,0
"8020","산본2동","산본2동제1투","대통령선거","경기도","군포시",2684,2068,809,464,496,143,142,2,0,1,1,1,0,0,1,2060,8,616
"8021","산본2동","산본2동제2투","대통령선거","경기도","군포시",2096,1549,688,284,354,100,107,1,2,1,0,1,1,0,1,1540,9,547
"8022","산본2동","산본2동제3투","대통령선거","경기도","군포시",2664,2172,964,357,519,162,154,6,0,2,0,1,0,1,1,2167,5,492
"8023","산본2동","산본2동제4투","대통령선거","경기도","군포시",2210,1764,729,356,403,147,114,3,0,1,0,1,0,0,1,1755,9,446
"8024","산본2동","산본2동제5투","대통령선거","경기도","군포시",2231,1804,831,313,394,125,121,4,0,2,1,3,0,1,2,1797,7,427
"8025","산본2동","산본2동제6투","대통령선거","경기도","군포시",2700,2228,940,486,499,184,108,0,0,1,0,2,0,1,0,2221,7,472
"8026","산본2동","산본2동제7투","대통령선거","경기도","군포시",2899,2436,968,562,566,209,116,3,0,0,0,4,0,1,1,2430,6,463
"8027","금정동","관내사전투표","대통령선거","경기도","군포시",3478,3478,1648,593,757,193,255,6,0,2,2,3,1,2,3,3465,13,0
"8028","금정동","금정동제1투","대통령선거","경기도","군포시",3208,2164,887,451,519,140,153,1,0,1,1,1,0,1,1,2156,8,1044
"8029","금정동","금정동제2투","대통령선거","경기도","군포시",3317,2082,831,457,517,138,128,0,0,0,0,1,2,0,4,2078,4,1235
"8030","금정동","금정동제3투","대통령선거","경기도","군포시",3535,2309,869,541,612,128,145,6,0,2,0,0,1,1,1,2306,3,1226
"8031","금정동","금정동제4투","대통령선거","경기도","군포시",2448,1569,614,376,363,82,114,3,0,3,1,3,1,2,2,1564,5,879
"8032","재궁동","관내사전투표","대통령선거","경기도","군포시",4359,4359,2197,592,866,326,354,1,0,4,1,2,0,0,5,4348,11,0
"8033","재궁동","재궁동제1투","대통령선거","경기도","군포시",3004,2182,860,472,560,159,116,3,0,0,0,3,0,0,2,2175,7,822
"8034","재궁동","재궁동제2투","대통령선거","경기도","군포시",2846,2005,845,410,438,140,152,5,1,3,0,1,0,0,2,1997,8,841
"8035","재궁동","재궁동제3투","대통령선거","경기도","군포시",2830,2077,890,442,462,140,132,1,1,0,0,4,0,0,1,2073,4,753
"8036","재궁동","재궁동제4투","대통령선거","경기도","군포시",2722,2097,950,384,466,162,127,2,0,1,0,0,0,2,1,2095,2,625
"8037","재궁동","재궁동제5투","대통령선거","경기도","군포시",2118,1541,696,279,348,111,99,5,0,1,0,0,0,0,0,1539,2,577
"8038","오금동","관내사전투표","대통령선거","경기도","군포시",3798,3798,1959,522,730,300,252,4,0,11,0,2,4,0,0,3784,14,0
"8039","오금동","오금동제1투","대통령선거","경기도","군포시",3008,2401,963,568,534,187,141,3,1,0,0,0,1,0,1,2399,2,607
"8040","오금동","오금동제2투","대통령선거","경기도","군포시",2983,2411,1091,426,548,183,155,1,0,1,0,0,0,0,1,2406,5,572
"8041","오금동","오금동제3투","대통령선거","경기도","군포시",2523,1846,832,302,428,149,121,4,0,1,0,1,1,0,0,1839,7,677
"8042","오금동","오금동제4투","대통령선거","경기도","군포시",1962,1613,725,308,371,88,107,0,0,4,0,2,0,4,1,1610,3,349
"8043","오금동","오금동제5투","대통령선거","경기도","군포시",3185,2643,1246,368,637,170,201,3,0,6,0,4,0,0,5,2640,3,542
"8044","수리동","관내사전투표","대통령선거","경기도","군포시",2544,2544,1244,464,491,165,171,3,0,0,0,4,0,0,0,2542,2,0
"8045","수리동","수리동제1투","대통령선거","경기도","군포시",2108,1640,632,372,392,131,101,6,0,1,0,1,0,0,0,1636,4,468
"8046","수리동","수리동제2투","대통령선거","경기도","군포시",2050,1605,613,407,346,124,107,3,0,0,1,0,0,0,0,1601,4,445
"8047","수리동","수리동제3투","대통령선거","경기도","군포시",2204,1763,785,318,412,115,119,5,0,0,0,1,0,1,2,1758,5,441
"8048","수리동","수리동제4투","대통령선거","경기도","군포시",2436,1927,916,339,436,120,110,3,0,1,0,0,0,0,1,1926,1,509
"8049","수리동","수리동제5투","대통령선거","경기도","군포시",2532,1745,736,382,404,84,113,3,0,5,0,3,1,0,1,1732,13,787
"8050","궁내동","관내사전투표","대통령선거","경기도","군포시",3007,3007,1508,476,619,192,199,2,0,3,0,1,0,0,2,3002,5,0
"8051","궁내동","궁내동제1투","대통령선거","경기도","군포시",1867,1370,630,247,315,93,80,1,0,2,1,0,0,0,0,1369,1,497
"8052","궁내동","궁내동제2투","대통령선거","경기도","군포시",2400,1928,852,365,397,182,117,1,0,1,0,2,0,1,2,1920,8,472
"8053","궁내동","궁내동제3투","대통령선거","경기도","군포시",2639,2161,912,457,464,187,135,1,0,0,1,0,0,1,1,2159,2,478
"8054","궁내동","궁내동제4투","대통령선거","경기도","군포시",2776,2292,994,439,521,159,164,2,0,1,0,3,0,0,1,2284,8,484
"8055","궁내동","궁내동제5투","대통령선거","경기도","군포시",2107,1726,889,254,336,121,110,2,0,5,0,4,0,1,0,1722,4,381
"8056","광정동","관내사전투표","대통령선거","경기도","군포시",2890,2890,1515,412,557,199,186,3,0,2,2,1,1,2,1,2881,9,0
"8057","광정동","광정동제1투","대통령선거","경기도","군포시",3342,2216,862,520,548,128,130,4,1,1,1,0,2,0,1,2198,18,1126
"8058","광정동","광정동제2투","대통령선거","경기도","군포시",2423,1705,784,268,392,129,118,3,0,1,0,2,0,1,2,1700,5,718
"8059","광정동","광정동제3투","대통령선거","경기도","군포시",3665,2984,1110,680,734,255,180,5,0,1,1,2,0,1,3,2972,12,681
"8060","광정동","광정동제4투","대통령선거","경기도","군포시",1759,1498,630,349,299,138,74,2,0,1,2,0,0,0,0,1495,3,261
"8061","광정동","광정동제5투","대통령선거","경기도","군포시",1716,1441,572,321,357,121,64,0,0,2,1,0,0,2,0,1440,1,275
"8062","광정동","광정동제6투","대통령선거","경기도","군포시",3123,2605,1271,391,601,150,181,0,0,2,0,2,0,3,2,2603,2,518
"8063","대야동","관내사전투표","대통령선거","경기도","군포시",2021,2021,921,378,423,140,137,2,0,3,1,5,0,0,0,2010,11,0
"8064","대야동","대야동제1투","대통령선거","경기도","군포시",2721,2019,886,389,430,142,153,5,1,4,0,0,0,1,1,2012,7,702
"8065","대야동","대야동제2투","대통령선거","경기도","군포시",2856,2112,907,450,474,123,144,1,0,6,1,0,0,1,0,2107,5,744
"8066","잘못 투입·구분된 투표지","잘못 투입·구분된 투표지","대통령선거","경기도","군포시",0,0,0,0,0,0,0,0,0,0,0,0,0,0,0,0,0,0
"8067","거소·선상투표","거소·선상투표","대통령선거","경기도","하남시",206,199,70,46,56,13,7,1,0,0,0,0,0,0,0,193,6,7
"8068","관외사전투표","관외사전투표","대통령선거","경기도","하남시",16729,16727,7643,2950,3532,1292,1162,25,5,13,3,5,7,6,19,16662,65,2
"8069","재외투표","재외투표","대통령선거","경기도","하남시",1308,1040,615,79,164,41,124,12,0,0,1,0,0,1,0,1037,3,268
"8070","천현동","관내사전투표","대통령선거","경기도","하남시",875,875,274,293,209,38,49,2,1,0,0,1,0,1,2,870,5,0
"8071","천현동","천현동제1투","대통령선거","경기도","하남시",2132,1244,345,461,309,60,58,1,0,0,0,1,0,0,1,1236,8,888
"8072","천현동","천현동제2투","대통령선거","경기도","하남시",1761,1044,376,284,267,48,59,3,0,1,0,1,0,0,3,1042,2,717
"8073","천현동","천현동제3투","대통령선거","경기도","하남시",1236,750,210,307,142,45,31,1,1,2,1,0,1,0,0,741,9,486
"8074","신장1동","관내사전투표","대통령선거","경기도","하남시",2032,2032,761,577,434,117,118,3,0,2,0,4,1,1,4,2022,10,0
"8075","신장1동","신장1동제1투","대통령선거","경기도","하남시",1766,1035,369,269,235,66,78,3,0,2,1,1,0,3,0,1027,8,731
"8076","신장1동","신장1동제2투","대통령선거","경기도","하남시",2572,1568,535,418,399,95,105,2,0,1,0,1,0,1,1,1558,10,1004
"8077","신장2동","관내사전투표","대통령선거","경기도","하남시",6924,6924,3107,1604,1276,468,427,9,0,1,1,3,2,1,3,6902,22,0
"8078","신장2동","신장2동제1투","대통령선거","경기도","하남시",2684,1613,618,427,344,95,111,4,0,1,0,4,0,0,1,1605,8,1071
"8079","신장2동","신장2동제2투","대통령선거","경기도","하남시",2202,1296,413,382,338,78,74,2,0,0,0,1,0,0,0,1288,8,906
"8080","신장2동","신장2동제3투","대통령선거","경기도","하남시",2379,1547,590,356,388,107,95,0,0,0,0,1,0,0,2,1539,8,832
"8081","신장2동","신장2동제4투","대통령선거","경기도","하남시",1720,1281,454,365,294,96,60,0,0,0,0,0,0,0,1,1270,11,439
"8082","신장2동","신장2동제5투","대통령선거","경기도","하남시",2345,1841,645,591,398,97,94,1,0,1,0,2,1,0,2,1832,9,504
"8083","신장2동","신장2동제6투","대통령선거","경기도","하남시",2404,1881,696,512,461,112,88,0,0,1,1,0,0,0,2,1873,8,523
"8084","신장2동","신장2동제7투","대통령선거","경기도","하남시",2240,1744,656,488,392,111,87,3,0,0,0,0,0,1,0,1738,6,496
"8085","신장2동","신장2동제8투","대통령선거","경기도","하남시",3420,2602,1057,590,613,175,142,4,1,1,0,0,0,3,1,2587,15,818
"8086","신장2동","신장2동제9투","대통령선거","경기도","하남시",3740,2851,1064,753,651,221,145,0,0,0,0,3,0,1,4,2842,9,889
"8087","신장2동","신장2동제10투","대통령선거","경기도","하남시",2951,2260,815,635,531,147,119,1,1,3,0,0,0,1,1,2254,6,691
"8088","덕풍1동","관내사전투표","대통령선거","경기도","하남시",2938,2938,1189,784,598,168,180,5,0,0,0,4,2,0,1,2931,7,0
"8089","덕풍1동","덕풍1동제1투","대통령선거","경기도","하남시",3030,1933,701,496,461,147,104,2,0,0,0,2,0,0,2,1915,18,1097
"8090","덕풍1동","덕풍1동제2투","대통령선거","경기도","하남시",2032,1432,515,381,352,87,86,1,0,3,0,0,0,0,1,1426,6,600
"8091","덕풍1동","덕풍1동제3투","대통령선거","경기도","하남시",2595,1538,554,467,348,76,77,2,0,1,0,3,0,0,1,1529,9,1057
"8092","덕풍1동","덕풍1동제4투","대통령선거","경기도","하남시",2844,2040,723,535,490,154,121,6,0,1,0,1,0,2,1,2034,6,804
"8093","덕풍2동","관내사전투표","대통령선거","경기도","하남시",2952,2952,1252,713,592,188,185,3,0,1,1,4,0,0,2,2941,11,0
"8094","덕풍2동","덕풍2동제1투","대통령선거","경기도","하남시",2287,1395,517,384,316,60,102,5,0,0,2,0,1,0,2,1389,6,892
"8095","덕풍2동","덕풍2동제2투","대통령선거","경기도","하남시",2191,1326,451,378,312,86,82,3,0,4,0,2,1,0,0,1319,7,865
"8096","덕풍2동","덕풍2동제3투","대통령선거","경기도","하남시",1835,1085,383,317,272,57,48,1,1,0,0,1,0,0,2,1082,3,750
"8097","덕풍2동","덕풍2동제4투","대통령선거","경기도","하남시",2208,1366,463,367,360,75,78,9,0,2,0,4,0,0,2,1360,6,842
"8098","덕풍2동","덕풍2동제5투","대통령선거","경기도","하남시",2484,1667,608,424,420,111,88,5,0,1,0,3,0,2,0,1662,5,817
"8099","덕풍2동","덕풍2동제6투","대통령선거","경기도","하남시",2028,1539,566,396,371,128,72,1,0,1,0,1,0,0,0,1536,3,489
"8100","덕풍3동","관내사전투표","대통령선거","경기도","하남시",3395,3395,1587,694,620,233,236,3,0,2,1,5,0,1,1,3383,12,0
"8101","덕풍3동","덕풍3동제1투","대통령선거","경기도","하남시",3528,2573,978,609,623,203,145,2,0,3,1,0,0,0,2,2566,7,955
"8102","덕풍3동","덕풍3동제2투","대통령선거","경기도","하남시",3535,2570,958,597,681,153,167,0,0,0,0,7,0,1,0,2564,6,965
"8103","덕풍3동","덕풍3동제3투","대통령선거","경기도","하남시",2823,1737,680,470,379,91,96,2,1,1,0,3,1,0,1,1725,12,1086
"8104","덕풍3동","덕풍3동제4투","대통령선거","경기도","하남시",3161,2218,915,510,495,180,110,0,0,0,0,0,0,1,0,2211,7,943
"8105","덕풍3동","덕풍3동제5투","대통령선거","경기도","하남시",2850,1990,701,533,520,130,97,0,0,1,0,3,1,0,0,1986,4,860
"8106","풍산동","관내사전투표","대통령선거","경기도","하남시",811,811,357,193,166,52,39,0,0,0,0,1,0,0,1,809,2,0
"8107","풍산동","풍산동투표소","대통령선거","경기도","하남시",3633,2466,1059,500,558,189,138,4,0,1,1,2,0,0,2,2454,12,1167
"8108","감북동","관내사전투표","대통령선거","경기도","하남시",522,522,195,175,95,28,26,1,0,0,0,0,0,0,1,521,1,0
"8109","감북동","감북동투표소","대통령선거","경기도","하남시",2539,1525,418,609,345,82,55,0,2,2,0,1,1,1,2,1518,7,1014
"8110","춘궁동","관내사전투표","대통령선거","경기도","하남시",963,963,294,391,194,28,48,0,0,0,0,3,0,0,0,958,5,0
"8111","춘궁동","춘궁동투표소","대통령선거","경기도","하남시",2419,1497,376,632,333,79,57,1,0,1,1,0,1,1,0,1482,15,922
"8112","초이동","관내사전투표","대통령선거","경기도","하남시",507,507,199,141,107,29,26,0,0,0,0,3,0,0,0,505,2,0
"8113","초이동","초이동제1투","대통령선거","경기도","하남시",1138,677,206,237,169,38,20,0,0,1,0,3,0,1,0,675,2,461
"8114","초이동","초이동제2투","대통령선거","경기도","하남시",1356,885,244,295,241,52,40,3,1,1,0,0,0,3,0,880,5,471
"8115","미사1동","관내사전투표","대통령선거","경기도","하남시",1900,1900,971,324,339,137,119,2,0,1,0,1,0,0,1,1895,5,0
"8116","미사1동","미사1동제1투","대통령선거","경기도","하남시",3129,2310,1017,458,525,162,138,4,0,0,1,0,0,1,0,2306,4,819
"8117","미사1동","미사1동제2투","대통령선거","경기도","하남시",2580,1819,682,405,456,128,131,0,0,2,2,4,1,0,0,1811,8,761
"8118","미사1동","미사1동제3투","대통령선거","경기도","하남시",3143,2569,1170,405,600,236,151,0,1,0,0,1,0,0,1,2565,4,574
"8119","미사1동","미사1동제4투","대통령선거","경기도","하남시",2356,1977,977,295,448,158,94,1,1,0,0,1,0,0,1,1976,1,379
"8120","미사2동","관내사전투표","대통령선거","경기도","하남시",6896,6895,3485,1164,1316,480,427,4,0,1,0,3,2,1,2,6885,10,1
"8121","미사2동","미사2동제1투","대통령선거","경기도","하남시",2584,1593,519,480,416,76,84,4,0,3,0,0,1,1,1,1585,8,991
"8122","미사2동","미사2동제2투","대통령선거","경기도","하남시",2769,2166,1062,300,489,156,144,1,0,3,1,4,0,0,2,2162,4,603
"8123","미사2동","미사2동제3투","대통령선거","경기도","하남시",2706,2047,925,306,482,171,152,6,0,1,0,2,0,0,0,2045,2,659
"8124","미사2동","미사2동제4투","대통령선거","경기도","하남시",2604,2174,1047,370,471,162,115,2,0,1,0,0,0,1,3,2172,2,430
"8125","미사2동","미사2동제5투","대통령선거","경기도","하남시",3473,2775,1346,448,626,218,128,2,0,0,0,3,0,2,1,2774,1,698
"8126","미사2동","미사2동제6투","대통령선거","경기도","하남시",986,805,410,124,175,53,41,2,0,0,0,0,0,0,0,805,0,181
"8127","미사2동","미사2동제7투","대통령선거","경기도","하남시",3957,3032,1534,418,628,247,193,2,1,0,0,2,0,0,2,3027,5,925
"8128","위례동","관내사전투표","대통령선거","경기도","하남시",2795,2795,1276,481,621,252,160,2,0,0,0,0,0,0,0,2792,3,0
"8129","위례동","위례동제1투","대통령선거","경기도","하남시",2467,1926,885,277,481,176,101,0,0,0,0,2,0,0,0,1922,4,541
"8130","위례동","위례동제2투","대통령선거","경기도","하남시",2751,2121,719,534,549,226,85,1,0,0,0,0,0,3,0,2117,4,630
"8131","위례동","위례동제3투","대통령선거","경기도","하남시",2774,2132,871,389,526,216,116,5,0,0,0,2,0,1,1,2127,5,642
"8132","잘못 투입·구분된 투표지","잘못 투입·구분된 투표지","대통령선거","경기도","하남시",0,0,0,0,0,0,0,0,0,0,0,0,0,0,0,0,0,0
"8133","거소·선상투표","거소·선상투표","대통령선거","경기도","파주시",828,786,277,141,227,55,35,0,3,4,3,1,5,1,4,756,30,42
"8134","관외사전투표","관외사전투표","대통령선거","경기도","파주시",26250,26242,12199,4206,5267,1954,2329,38,10,17,9,18,13,8,30,26098,144,8
"8135","재외투표","재외투표","대통령선거","경기도","파주시",2109,1651,1015,115,218,71,220,8,0,0,0,0,0,0,0,1647,4,458
"8136","문산읍","관내사전투표","대통령선거","경기도","파주시",7190,7190,3278,1357,1337,496,638,12,3,8,3,9,0,2,15,7158,32,0
"8137","문산읍","문산읍제1투","대통령선거","경기도","파주시",3038,1920,635,627,399,112,126,1,0,4,0,1,0,0,5,1910,10,1118
"8138","문산읍","문산읍제2투","대통령선거","경기도","파주시",4230,2719,1169,564,579,157,215,9,2,2,1,4,1,1,2,2706,13,1511
"8139","문산읍","문산읍제3투","대통령선거","경기도","파주시",3714,2302,769,603,530,194,179,1,1,0,1,6,2,3,3,2292,10,1412
"8140","문산읍","문산읍제4투","대통령선거","경기도","파주시",2170,1203,448,280,290,77,99,5,0,0,0,2,0,2,0,1203,0,967
"8141","문산읍","문산읍제5투","대통령선거","경기도","파주시",3409,1927,648,507,445,159,145,4,1,2,1,0,1,2,3,1918,9,1482
"8142","문산읍","문산읍제6투","대통령선거","경기도","파주시",878,588,167,246,122,26,16,2,0,2,1,1,0,0,2,585,3,290
"8143","문산읍","문산읍제7투","대통령선거","경기도","파주시",1028,665,156,298,144,22,37,0,0,0,0,3,0,0,2,662,3,363
"8144","문산읍","문산읍제8투","대통령선거","경기도","파주시",680,403,95,169,85,16,27,2,0,4,0,0,0,2,0,400,3,277
"8145","문산읍","문산읍제9투","대통령선거","경기도","파주시",5680,3831,1503,870,822,289,316,3,0,1,2,4,0,1,2,3813,18,1849
"8146","문산읍","문산읍제10투","대통령선거","경기도","파주시",1657,1075,323,406,219,42,71,2,1,0,0,0,1,1,3,1069,6,582
"8147","문산읍","문산읍제11투","대통령선거","경기도","파주시",3499,2195,869,527,486,121,172,2,1,2,1,0,0,1,6,2188,7,1304
"8148","조리읍","관내사전투표","대통령선거","경기도","파주시",3900,3900,1608,925,756,219,346,13,0,3,3,8,1,0,6,3888,12,0
"8149","조리읍","조리읍제1투","대통령선거","경기도","파주시",3600,2586,893,733,609,154,175,2,0,2,2,0,1,3,4,2578,8,1014
"8150","조리읍","조리읍제2투","대통령선거","경기도","파주시",2021,1349,453,374,336,81,97,0,0,0,1,0,0,1,1,1344,5,672
"8151","조리읍","조리읍제3투","대통령선거","경기도","파주시",1953,1283,409,400,324,57,83,4,1,0,0,0,0,1,1,1280,3,670
"8152","조리읍","조리읍제4투","대통령선거","경기도","파주시",2964,2127,754,551,487,149,166,7,0,3,1,0,0,0,1,2119,8,837
"8153","조리읍","조리읍제5투","대통령선거","경기도","파주시",1679,821,255,268,183,43,59,2,0,1,1,0,1,0,1,814,7,858
"8154","조리읍","조리읍제6투","대통령선거","경기도","파주시",3394,2322,905,517,574,147,166,1,0,1,2,3,0,0,2,2318,4,1072
"8155","조리읍","조리읍제7투","대통령선거","경기도","파주시",1837,1051,317,373,239,48,58,6,0,2,0,0,3,0,2,1048,3,786
"8156","조리읍","조리읍제8투","대통령선거","경기도","파주시",1105,703,206,222,184,38,49,0,0,0,0,0,0,0,0,699,4,402
"8157","조리읍","조리읍제9투","대통령선거","경기도","파주시",1238,753,230,241,172,33,64,1,0,3,0,0,2,1,1,748,5,485
"8158","법원읍","관내사전투표","대통령선거","경기도","파주시",1420,1420,462,421,305,92,103,5,1,2,3,4,2,0,3,1403,17,0
"8159","법원읍","법원읍제1투","대통령선거","경기도","파주시",1988,1019,263,377,254,48,60,4,0,2,1,1,0,1,1,1012,7,969
"8160","법원읍","법원읍제2투","대통령선거","경기도","파주시",613,442,115,161,86,24,16,3,2,2,2,4,4,2,6,427,15,171
"8161","법원읍","법원읍제3투","대통령선거","경기도","파주시",650,465,120,202,96,16,24,1,0,1,0,0,1,0,0,461,4,185
"8162","법원읍","법원읍제4투","대통령선거","경기도","파주시",1776,1088,275,410,270,60,63,2,0,2,0,0,0,0,2,1084,4,688
"8163","법원읍","법원읍제5투","대통령선거","경기도","파주시",1527,821,197,339,205,38,36,1,0,0,0,0,0,0,2,818,3,706
"8164","법원읍","법원읍제6투","대통령선거","경기도","파주시",1684,1070,309,406,252,43,49,1,0,0,0,2,2,1,2,1067,3,614
"8165","파주읍","관내사전투표","대통령선거","경기도","파주시",1683,1683,590,456,364,96,149,1,0,1,1,2,4,1,3,1668,15,0
"8166","파주읍","파주읍제1투","대통령선거","경기도","파주시",3165,1640,434,608,374,90,114,4,0,3,0,0,1,3,4,1635,5,1525
"8167","파주읍","파주읍제2투","대통령선거","경기도","파주시",2358,1399,452,433,327,79,91,1,0,1,1,2,1,2,1,1391,8,959
"8168","파주읍","파주읍제3투","대통령선거","경기도","파주시",981,583,152,226,137,32,29,1,1,0,0,0,1,0,1,580,3,398
"8169","파주읍","파주읍제4투","대통령선거","경기도","파주시",1036,682,182,253,162,35,42,1,0,0,0,0,0,0,2,677,5,354
"8170","파주읍","파주읍제5투","대통령선거","경기도","파주시",907,567,138,233,112,29,42,0,0,2,0,0,1,0,3,560,7,340
"8171","파주읍","파주읍제6투","대통령선거","경기도","파주시",989,677,179,270,141,45,32,0,2,2,0,0,0,0,1,672,5,312
"8172","광탄면","관내사전투표","대통령선거","경기도","파주시",1975,1975,691,575,430,92,165,1,0,1,0,3,0,3,3,1964,11,0
"8173","광탄면","광탄면제1투","대통령선거","경기도","파주시",2700,1499,417,485,353,83,138,6,1,1,3,1,1,2,0,1491,8,1201
"8174","광탄면","광탄면제2투","대통령선거","경기도","파주시",1925,1154,290,437,265,52,90,2,0,1,1,2,0,3,2,1145,9,771
"8175","광탄면","광탄면제3투","대통령선거","경기도","파주시",1044,683,139,269,160,33,67,2,1,1,0,0,0,1,0,673,10,361
"8176","광탄면","광탄면제4투","대통령선거","경기도","파주시",1397,764,202,273,181,43,57,1,1,0,0,0,1,1,1,761,3,633
"8177","광탄면","광탄면제5투","대통령선거","경기도","파주시",1155,717,175,272,187,32,42,2,1,1,0,0,2,0,1,715,2,438
"8178","탄현면","관내사전투표","대통령선거","경기도","파주시",1452,1452,685,318,235,60,137,2,0,1,2,0,0,0,0,1440,12,0
"8179","탄현면","탄현면제1투","대통령선거","경기도","파주시",1569,915,213,362,210,53,66,0,0,1,0,0,1,1,2,909,6,654
"8180","탄현면","탄현면제2투","대통령선거","경기도","파주시",1112,703,210,266,139,46,33,1,0,4,0,0,1,0,1,701,2,409
"8181","탄현면","탄현면제3투","대통령선거","경기도","파주시",1277,774,209,315,147,39,57,0,0,1,0,0,0,0,1,769,5,503
"8182","탄현면","탄현면제4투","대통령선거","경기도","파주시",2145,1407,539,364,301,95,92,3,1,2,0,4,0,0,1,1402,5,738
"8183","탄현면","탄현면제5투","대통령선거","경기도","파주시",3115,2169,937,468,456,120,174,2,0,2,0,1,0,1,0,2161,8,946
"8184","월롱면","관내사전투표","대통령선거","경기도","파주시",2145,2145,1058,328,349,166,217,4,0,3,1,2,2,3,3,2136,9,0
"8185","월롱면","월롱면제1투","대통령선거","경기도","파주시",1183,708,186,302,130,32,51,0,0,0,0,2,2,0,2,707,1,475
"8186","월롱면","월롱면제2투","대통령선거","경기도","파주시",1639,882,308,240,190,59,79,0,0,0,1,0,1,0,1,879,3,757
"8187","월롱면","월롱면제3투","대통령선거","경기도","파주시",1806,1061,336,330,274,43,69,1,1,1,0,1,0,0,1,1057,4,745
"8188","월롱면","월롱면제4투","대통령선거","경기도","파주시",1338,851,419,55,165,114,95,0,0,0,0,0,0,0,0,848,3,487
"8189","월롱면","월롱면제5투","대통령선거","경기도","파주시",2441,1875,945,76,263,240,328,0,0,0,0,6,0,0,6,1864,11,566
"8190","적성면","관내사전투표","대통령선거","경기도","파주시",1114,1114,335,372,234,83,72,1,1,0,0,1,1,1,4,1105,9,0
"8191","적성면","적성면제1투","대통령선거","경기도","파주시",2368,1396,354,502,335,107,81,2,0,1,0,2,2,1,1,1388,8,972
"8192","적성면","적성면제2투","대통령선거","경기도","파주시",618,419,97,181,99,21,8,2,0,0,1,0,0,0,2,411,8,199
"8193","적성면","적성면제3투","대통령선거","경기도","파주시",871,538,106,256,119,26,23,0,0,0,0,0,2,2,0,534,4,333
"8194","적성면","적성면제4투","대통령선거","경기도","파주시",570,343,84,156,68,16,14,0,0,1,0,1,0,0,0,340,3,227
"8195","적성면","적성면제5투","대통령선거","경기도","파주시",580,393,78,145,118,30,17,1,0,1,0,1,0,0,1,392,1,187
"8196","파평면","관내사전투표","대통령선거","경기도","파주시",455,455,179,98,80,41,43,3,1,0,0,1,1,0,1,448,7,0
"8197","파평면","파평면제1투","대통령선거","경기도","파주시",454,280,68,134,52,10,15,0,0,0,0,0,0,0,0,279,1,174
"8198","파평면","파평면제2투","대통령선거","경기도","파주시",349,245,70,98,51,13,11,0,1,0,0,0,0,0,0,244,1,104
"8199","파평면","파평면제3투","대통령선거","경기도","파주시",421,259,48,110,69,15,13,0,0,1,0,0,1,1,1,259,0,162
"8200","파평면","파평면제4투","대통령선거","경기도","파주시",819,591,186,211,124,23,38,0,1,1,0,0,0,0,1,585,6,228
"8201","파평면","파평면제5투","대통령선거","경기도","파주시",505,358,77,175,73,12,17,1,0,0,0,0,1,0,0,356,2,147
"8202","파평면","파평면제6투","대통령선거","경기도","파주시",451,309,71,143,55,15,21,2,0,0,0,0,0,0,1,308,1,142
"8203","군내면","관내사전투표","대통령선거","경기도","파주시",333,333,143,51,82,28,18,1,1,0,0,0,0,1,2,327,6,0
"8204","군내면","군내면투표소","대통령선거","경기도","파주시",383,300,95,108,58,11,23,1,0,0,0,0,0,0,1,297,3,83
"8205","진동면","관내사전투표","대통령선거","경기도","파주시",125,125,46,31,22,15,2,0,1,0,1,2,0,1,2,123,2,0
"8206","진동면","진동면투표소","대통령선거","경기도","파주시",102,73,22,36,11,1,2,0,0,0,0,0,0,0,0,72,1,29
"8207","교하동","관내사전투표","대통령선거","경기도","파주시",2569,2569,1236,493,450,159,211,3,1,1,0,3,0,2,1,2560,9,0
"8208","교하동","교하동제1투","대통령선거","경기도","파주시",2005,1083,311,400,251,52,58,0,0,0,2,0,0,2,1,1077,6,922
"8209","교하동","교하동제2투","대통령선거","경기도","파주시",2990,2204,970,532,422,121,148,3,0,1,1,1,1,0,0,2200,4,786
"8210","교하동","교하동제3투","대통령선거","경기도","파주시",3453,2302,920,511,568,119,164,4,1,0,1,3,1,0,1,2293,9,1151
"8211","교하동","교하동제4투","대통령선거","경기도","파주시",1324,863,288,279,174,53,59,8,0,0,0,0,0,0,0,861,2,461
"8212","교하동","교하동제5투","대통령선거","경기도","파주시",2539,1760,821,308,370,111,141,5,0,1,0,0,0,0,0,1757,3,779
"8213","교하동","교하동제6투","대통령선거","경기도","파주시",2652,2016,842,434,457,143,127,6,0,3,1,0,0,0,1,2014,2,636
"8214","교하동","교하동제7투","대통령선거","경기도","파주시",2343,1846,896,305,371,140,121,4,0,1,2,0,0,1,1,1842,4,497
"8215","교하동","교하동제8투","대통령선거","경기도","파주시",2464,2056,1159,225,401,136,129,1,1,1,0,0,0,0,1,2054,2,408
"8216","교하동","교하동제9투","대통령선거","경기도","파주시",1906,1529,798,205,317,87,118,1,0,0,1,0,0,0,0,1527,2,377
"8217","교하동","교하동제10투","대통령선거","경기도","파주시",3082,2287,1097,410,483,117,168,3,0,0,0,3,0,0,1,2282,5,795
"8218","운정1동","관내사전투표","대통령선거","경기도","파주시",8517,8517,4346,1273,1575,557,730,4,0,8,1,7,0,1,3,8505,12,0
"8219","운정1동","운정1동제1투","대통령선거","경기도","파주시",3909,2490,988,551,575,174,181,4,1,0,2,5,0,1,1,2483,7,1419
"8220","운정1동","운정1동제2투","대통령선거","경기도","파주시",2147,1783,870,271,384,137,113,1,0,2,0,1,0,0,2,1781,2,364
"8221","운정1동","운정1동제3투","대통령선거","경기도","파주시",3041,1965,882,364,432,113,167,1,0,1,0,1,0,1,0,1962,3,1076
"8222","운정1동","운정1동제4투","대통령선거","경기도","파주시",3369,2456,1090,455,572,161,165,2,0,2,0,4,0,1,1,2453,3,913
"8223","운정1동","운정1동제5투","대통령선거","경기도","파주시",3027,2292,1019,406,530,167,156,2,0,1,0,0,1,1,3,2286,6,735
"8224","운정1동","운정1동제6투","대통령선거","경기도","파주시",2585,2115,1061,293,450,142,158,2,0,2,0,2,0,0,2,2112,3,470
"8225","운정1동","운정1동제7투","대통령선거","경기도","파주시",3418,2469,1122,398,578,160,189,6,0,2,0,4,0,0,3,2462,7,949
"8226","운정1동","운정1동제8투","대통령선거","경기도","파주시",3079,2433,1148,371,565,192,145,4,0,0,0,1,0,1,4,2431,2,646
"8227","운정2동","관내사전투표","대통령선거","경기도","파주시",3492,3492,1966,361,625,210,315,4,0,3,0,1,0,2,2,3489,3,0
"8228","운정2동","운정2동제1투","대통령선거","경기도","파주시",2082,1371,533,296,338,90,99,2,0,4,0,2,0,0,1,1365,6,711
"8229","운정2동","운정2동제2투","대통령선거","경기도","파주시",1507,1234,596,158,257,117,102,0,0,0,1,1,0,0,1,1233,1,273
"8230","운정2동","운정2동제3투","대통령선거","경기도","파주시",1055,842,440,105,166,52,74,0,0,0,0,0,0,0,1,838,4,213
"8231","운정2동","운정2동제4투","대통령선거","경기도","파주시",2682,2121,952,351,494,144,174,1,0,1,0,0,0,1,0,2118,3,561
"8232","운정2동","운정2동제5투","대통령선거","경기도","파주시",2143,1555,649,332,346,108,111,3,0,0,1,2,0,0,0,1552,3,588
"8233","운정2동","운정2동제6투","대통령선거","경기도","파주시",2494,2038,959,331,430,170,142,3,0,0,0,0,0,1,0,2036,2,456
"8234","운정2동","운정2동제7투","대통령선거","경기도","파주시",1843,1305,579,248,310,90,76,1,0,0,0,1,0,0,0,1305,0,538
"8235","운정2동","운정2동제8투","대통령선거","경기도","파주시",3474,2673,1209,508,566,185,183,7,0,1,1,2,1,0,1,2664,9,801
"8236","운정2동","운정2동제9투","대통령선거","경기도","파주시",1596,1292,626,188,296,80,97,0,0,0,1,2,0,0,0,1290,2,304
"8237","운정2동","운정2동제10투","대통령선거","경기도","파주시",2019,1388,559,282,333,97,111,2,0,0,0,0,1,0,1,1386,2,631
"8238","운정3동","관내사전투표","대통령선거","경기도","파주시",6316,6316,3341,834,1172,389,521,8,0,3,3,12,0,6,2,6291,25,0
"8239","운정3동","운정3동제1투","대통령선거","경기도","파주시",3630,2807,1299,455,638,198,204,0,0,2,0,2,0,2,2,2802,5,823
"8240","운정3동","운정3동제2투","대통령선거","경기도","파주시",3816,3052,1499,430,657,242,214,5,0,0,0,1,0,0,1,3049,3,764
"8241","운정3동","운정3동제3투","대통령선거","경기도","파주시",4413,2812,1193,568,638,168,216,8,0,2,2,2,2,0,2,2801,11,1601
"8242","운정3동","운정3동제4투","대통령선거","경기도","파주시",3409,2431,1009,505,544,161,197,3,1,4,0,1,0,0,1,2426,5,978
"8243","운정3동","운정3동제5투","대통령선거","경기도","파주시",3616,2558,1030,502,632,167,199,6,0,3,0,6,1,1,1,2548,10,1058
"8244","운정3동","운정3동제6투","대통령선거","경기도","파주시",3705,2488,1186,415,514,165,189,5,0,0,0,7,1,0,0,2482,6,1217
"8245","운정3동","운정3동제7투","대통령선거","경기도","파주시",1852,1422,625,274,349,94,74,0,0,1,0,0,0,0,0,1417,5,430
"8246","운정3동","운정3동제8투","대통령선거","경기도","파주시",2131,1384,556,287,349,91,92,4,1,0,0,1,0,0,0,1381,3,747
"8247","운정3동","운정3동제9투","대통령선거","경기도","파주시",2174,1561,697,268,356,125,97,5,1,1,0,0,0,0,1,1551,10,613
"8248","운정3동","운정3동제10투","대통령선거","경기도","파주시",3209,2165,972,310,525,155,195,1,0,0,0,1,0,0,2,2161,4,1044
"8249","금촌1동","관내사전투표","대통령선거","경기도","파주시",2514,2514,1082,544,486,171,212,1,0,1,0,4,0,0,4,2505,9,0
"8250","금촌1동","금촌1동제1투","대통령선거","경기도","파주시",3340,2056,786,503,463,141,149,2,0,1,2,1,0,1,2,2051,5,1284
"8251","금촌1동","금촌1동제2투","대통령선거","경기도","파주시",2044,1298,404,397,327,71,88,1,0,1,0,0,1,1,1,1292,6,746
"8252","금촌1동","금촌1동제3투","대통령선거","경기도","파주시",2238,1287,344,476,332,52,68,7,0,1,2,0,0,0,0,1282,5,951
"8253","금촌1동","금촌1동제4투","대통령선거","경기도","파주시",2823,1611,510,518,367,97,99,3,1,4,0,1,2,2,2,1606,5,1212
"8254","금촌1동","금촌1동제5투","대통령선거","경기도","파주시",2563,1345,455,362,300,88,128,1,0,0,0,3,0,1,0,1338,7,1218
"8255","금촌1동","금촌1동제6투","대통령선거","경기도","파주시",2487,1536,586,376,339,79,132,2,0,2,0,3,1,0,2,1522,14,951
"8256","금촌2동","관내사전투표","대통령선거","경기도","파주시",5243,5243,2569,795,947,360,534,6,0,2,0,1,1,0,10,5225,18,0
"8257","금촌2동","금촌2동제1투","대통령선거","경기도","파주시",1893,1298,525,257,291,105,115,0,0,1,1,1,0,0,0,1296,2,595
"8258","금촌2동","금촌2동제2투","대통령선거","경기도","파주시",2165,1343,491,292,303,108,129,3,1,4,0,1,2,0,3,1337,6,822
"8259","금촌2동","금촌2동제3투","대통령선거","경기도","파주시",2471,1634,658,332,405,99,119,1,0,2,2,2,2,1,3,1626,8,837
"8260","금촌2동","금촌2동제4투","대통령선거","경기도","파주시",3020,2234,970,412,495,168,178,4,0,2,0,1,0,0,1,2231,3,786
"8261","금촌2동","금촌2동제5투","대통령선거","경기도","파주시",1907,1201,403,346,295,65,77,2,0,3,0,1,1,0,1,1194,7,706
"8262","금촌2동","금촌2동제6투","대통령선거","경기도","파주시",2972,2357,1101,417,493,140,184,7,0,4,1,4,0,0,2,2353,4,615
"8263","금촌2동","금촌2동제7투","대통령선거","경기도","파주시",2895,2213,1028,335,491,164,181,4,0,7,0,0,0,1,0,2211,2,682
"8264","금촌2동","금촌2동제8투","대통령선거","경기도","파주시",2750,1941,915,272,415,145,183,3,0,0,1,0,1,0,1,1936,5,809
"8265","금촌3동","관내사전투표","대통령선거","경기도","파주시",4786,4786,2149,889,926,339,446,8,1,3,1,6,0,1,4,4773,13,0
"8266","금촌3동","금촌3동제1투","대통령선거","경기도","파주시",2577,1735,662,383,368,126,179,1,0,2,0,2,0,2,1,1726,9,842
"8267","금촌3동","금촌3동제2투","대통령선거","경기도","파주시",2308,1391,517,293,348,94,130,2,0,0,0,1,0,0,2,1387,4,917
"8268","금촌3동","금촌3동제3투","대통령선거","경기도","파주시",2982,1861,747,403,416,131,146,5,0,1,0,2,1,0,2,1854,7,1121
"8269","금촌3동","금촌3동제4투","대통령선거","경기도","파주시",3279,2282,900,462,556,160,184,5,0,1,0,3,1,0,1,2273,9,997
"8270","금촌3동","금촌3동제5투","대통령선거","경기도","파주시",3221,2326,960,474,535,141,199,4,0,1,1,0,3,0,1,2319,7,895
"8271","금촌3동","금촌3동제6투","대통령선거","경기도","파주시",2435,1599,580,459,359,80,105,4,1,0,1,3,0,0,2,1594,5,836
"8272","잘못 투입·구분된 투표지","잘못 투입·구분된 투표지","대통령선거","경기도","파주시",0,1,0,1,0,0,0,0,0,0,0,0,0,0,0,1,0,-1
"8273","거소·선상투표","거소·선상투표","대통령선거","경기도","여주시",184,170,53,37,59,10,4,0,0,0,0,1,0,0,1,165,5,14
"8274","관외사전투표","관외사전투표","대통령선거","경기도","여주시",7706,7706,2932,1626,1762,631,646,14,0,10,2,4,2,3,19,7651,55,0
"8275","재외투표","재외투표","대통령선거","경기도","여주시",428,320,198,27,48,9,33,3,0,0,0,1,0,0,0,319,1,108
"8276","점동면","관내사전투표","대통령선거","경기도","여주시",710,710,258,233,126,41,28,0,1,0,2,3,1,1,0,694,16,0
"8277","점동면","점동면제1투","대통령선거","경기도","여주시",2174,1305,302,584,288,59,57,3,0,2,0,2,0,2,0,1299,6,869
"8278","점동면","점동면제2투","대통령선거","경기도","여주시",663,456,91,219,97,21,21,0,1,1,0,1,1,1,0,454,2,207
"8279","점동면","점동면제3투","대통령선거","경기도","여주시",480,350,70,160,79,14,18,1,0,1,0,0,1,0,1,345,5,130
"8280","가남읍","관내사전투표","대통령선거","경기도","여주시",1410,1410,557,318,321,66,129,3,0,2,0,1,1,2,2,1402,8,0
"8281","가남읍","가남읍제1투","대통령선거","경기도","여주시",2397,1281,324,458,312,89,90,0,0,1,1,1,0,2,0,1278,3,1116
"8282","가남읍","가남읍제2투","대통령선거","경기도","여주시",1774,1110,292,439,248,55,60,2,0,3,1,0,0,2,1,1103,7,664
"8283","가남읍","가남읍제3투","대통령선거","경기도","여주시",1011,632,141,259,162,30,36,0,0,1,0,0,0,1,1,631,1,379
"8284","가남읍","가남읍제4투","대통령선거","경기도","여주시",465,283,67,128,56,11,13,4,0,0,0,0,2,0,0,281,2,182
"8285","가남읍","가남읍제5투","대통령선거","경기도","여주시",2828,1907,681,496,440,138,140,0,0,0,2,1,0,1,3,1902,5,921
"8286","가남읍","가남읍제6투","대통령선거","경기도","여주시",2290,1332,353,441,367,81,78,0,1,0,1,0,4,1,2,1329,3,958
"8287","능서면","관내사전투표","대통령선거","경기도","여주시",585,585,200,177,113,42,48,0,0,2,1,2,0,0,0,585,0,0
"8288","능서면","능서면제1투","대통령선거","경기도","여주시",1829,1104,273,469,269,26,53,0,0,2,0,0,1,0,4,1097,7,725
"8289","능서면","능서면제2투","대통령선거","경기도","여주시",1715,1142,273,481,246,56,64,2,0,2,2,1,0,1,3,1131,11,573
"8290","능서면","능서면제3투","대통령선거","경기도","여주시",967,666,153,309,127,39,27,3,0,1,1,0,0,1,1,662,4,301
"8291","흥천면","관내사전투표","대통령선거","경기도","여주시",466,466,140,160,107,28,28,3,0,0,0,0,0,0,0,466,0,0
"8292","흥천면","흥천면제1투","대통령선거","경기도","여주시",2058,1297,255,576,319,79,48,4,0,1,1,1,2,1,1,1288,9,761
"8293","흥천면","흥천면제2투","대통령선거","경기도","여주시",1462,963,199,461,212,37,44,1,0,0,1,2,0,2,1,960,3,499
"8294","금사면","관내사전투표","대통령선거","경기도","여주시",422,422,94,196,85,18,24,0,0,0,0,0,0,1,1,419,3,0
"8295","금사면","금사면제1투","대통령선거","경기도","여주시",1308,870,136,473,185,32,26,3,1,5,0,1,1,2,1,866,4,438
"8296","금사면","금사면제2투","대통령선거","경기도","여주시",693,459,92,218,107,23,15,0,0,0,0,0,0,1,0,456,3,234
"8297","산북면","관내사전투표","대통령선거","경기도","여주시",434,434,131,184,77,14,24,0,0,0,0,1,0,0,0,431,3,0
"8298","산북면","산북면투표소","대통령선거","경기도","여주시",1594,1085,252,477,236,57,49,0,0,3,1,0,2,2,2,1081,4,509
"8299","대신면","관내사전투표","대통령선거","경기도","여주시",669,668,211,238,133,37,38,2,0,0,1,1,1,0,1,663,5,1
"8300","대신면","대신면제1투","대통령선거","경기도","여주시",2049,1202,206,563,323,45,49,4,0,2,0,3,1,0,0,1196,6,847
"8301","대신면","대신면제2투","대통령선거","경기도","여주시",1587,991,255,447,187,42,54,0,0,0,0,0,0,1,1,987,4,596
"8302","대신면","대신면제3투","대통령선거","경기도","여주시",988,609,111,285,143,40,24,0,0,0,0,2,1,0,1,607,2,379
"8303","대신면","대신면제4투","대통령선거","경기도","여주시",732,469,116,212,102,18,17,1,0,0,0,0,1,1,0,468,1,263
"8304","북내면","관내사전투표","대통령선거","경기도","여주시",472,472,156,159,81,34,32,2,1,0,2,1,1,0,1,470,2,0
"8305","북내면","북내면제1투","대통령선거","경기도","여주시",2169,1314,320,543,283,54,99,4,0,1,0,0,1,2,2,1309,5,855
"8306","북내면","북내면제2투","대통령선거","경기도","여주시",929,529,99,236,143,30,9,2,0,2,0,1,1,2,1,526,3,400
"8307","북내면","북내면제3투","대통령선거","경기도","여주시",522,338,67,151,89,16,9,0,0,0,1,0,1,0,0,334,4,184
"8308","강천면","관내사전투표","대통령선거","경기도","여주시",431,431,158,146,71,21,27,0,0,1,0,1,0,0,2,427,4,0
"8309","강천면","강천면제1투","대통령선거","경기도","여주시",861,541,124,249,119,20,17,0,0,0,0,1,0,3,2,535,6,320
"8310","강천면","강천면제2투","대통령선거","경기도","여주시",705,429,111,189,95,15,14,0,0,1,0,1,1,1,0,428,1,276
"8311","강천면","강천면제3투","대통령선거","경기도","여주시",528,351,85,160,68,11,12,0,2,1,0,3,2,0,1,345,6,177
"8312","강천면","강천면제4투","대통령선거","경기도","여주시",646,449,96,213,92,19,23,0,0,0,0,0,0,2,1,446,3,197
"8313","여흥동","관내사전투표","대통령선거","경기도","여주시",3317,3317,1312,864,616,228,271,3,1,2,1,2,0,0,6,3306,11,0
"8314","여흥동","여흥동제1투","대통령선거","경기도","여주시",2014,945,248,358,200,64,62,1,0,1,0,1,0,1,4,940,5,1069
"8315","여흥동","여흥동제2투","대통령선거","경기도","여주시",2056,1340,439,387,321,79,104,1,0,2,1,0,1,0,1,1336,4,716
"8316","여흥동","여흥동제3투","대통령선거","경기도","여주시",2577,1551,443,567,318,96,111,3,0,0,1,1,1,2,2,1545,6,1026
"8317","여흥동","여흥동제4투","대통령선거","경기도","여주시",1560,1024,297,348,225,72,66,2,1,2,0,0,3,0,0,1016,8,536
"8318","여흥동","여흥동제5투","대통령선거","경기도","여주시",3804,2154,746,626,485,124,150,0,0,5,0,4,2,1,4,2147,7,1650
"8319","여흥동","여흥동제6투","대통령선거","경기도","여주시",1737,1125,363,393,249,62,49,3,0,0,1,1,0,0,0,1121,4,612
"8320","중앙동","관내사전투표","대통령선거","경기도","여주시",2291,2291,899,573,424,158,219,1,0,3,0,0,1,3,2,2283,8,0
"8321","중앙동","중앙동제1투","대통령선거","경기도","여주시",2286,1308,336,536,253,76,86,1,1,6,0,1,0,0,4,1300,8,978
"8322","중앙동","중앙동제2투","대통령선거","경기도","여주시",3206,1970,646,546,481,138,140,4,0,0,1,1,1,1,2,1961,9,1236
"8323","중앙동","중앙동제3투","대통령선거","경기도","여주시",3420,2239,840,531,501,162,189,2,0,2,0,4,0,0,1,2232,7,1181
"8324","중앙동","중앙동제4투","대통령선거","경기도","여주시",2699,1647,466,558,399,94,120,0,0,0,0,3,0,0,1,1641,6,1052
"8325","오학동","관내사전투표","대통령선거","경기도","여주시",2276,2276,957,484,481,151,182,2,1,0,0,5,1,2,4,2270,6,0
"8326","오학동","오학동제1투","대통령선거","경기도","여주시",1756,1083,347,374,218,56,83,0,0,1,0,1,0,1,0,1081,2,673
"8327","오학동","오학동제2투","대통령선거","경기도","여주시",3270,1976,696,505,475,122,163,5,0,1,0,2,1,0,0,1970,6,1294
"8328","오학동","오학동제3투","대통령선거","경기도","여주시",3535,2191,807,534,522,146,165,1,2,2,0,3,0,0,2,2184,7,1344
"8329","잘못 투입·구분된 투표지","잘못 투입·구분된 투표지","대통령선거","경기도","여주시",0,0,0,0,0,0,0,0,0,0,0,0,0,0,0,0,0,0
"8330","거소·선상투표","거소·선상투표","대통령선거","경기도","이천시",501,469,139,94,97,30,20,2,3,7,3,3,2,4,3,407,62,32
"8331","관외사전투표","관외사전투표","대통령선거","경기도","이천시",13137,13132,5584,2199,2876,1188,1112,14,2,5,1,11,4,4,36,13036,96,5
"8332","재외투표","재외투표","대통령선거","경기도","이천시",747,595,364,36,96,15,81,0,0,0,0,0,0,0,1,593,2,152
"8333","장호원읍","관내사전투표","대통령선거","경기도","이천시",1649,1649,673,452,321,93,92,0,1,1,0,0,2,2,3,1640,9,0
"8334","장호원읍","장호원읍제1투","대통령선거","경기도","이천시",2117,1216,288,533,266,60,55,4,0,2,0,0,0,0,3,1211,5,901
"8335","장호원읍","장호원읍제2투","대통령선거","경기도","이천시",1771,1053,273,453,227,48,43,0,0,2,0,1,1,0,1,1049,4,718
"8336","장호원읍","장호원읍제3투","대통령선거","경기도","이천시",891,602,143,294,113,26,18,2,0,0,0,0,0,1,2,599,3,289
"8337","장호원읍","장호원읍제4투","대통령선거","경기도","이천시",988,658,108,372,137,18,18,0,1,0,0,0,0,2,1,657,1,330
"8338","장호원읍","장호원읍제5투","대통령선거","경기도","이천시",947,644,148,247,163,56,21,1,0,1,0,0,1,0,0,638,6,303
"8339","장호원읍","장호원읍제6투","대통령선거","경기도","이천시",545,362,78,155,96,17,12,0,0,0,0,0,0,0,3,361,1,183
"8340","장호원읍","장호원읍제7투","대통령선거","경기도","이천시",2788,1783,591,564,402,96,115,1,0,0,0,0,1,2,3,1775,8,1005
"8341","부발읍","관내사전투표","대통령선거","경기도","이천시",3325,3324,1473,675,699,203,248,2,0,1,1,2,3,1,2,3310,14,1
"8342","부발읍","부발읍제1투","대통령선거","경기도","이천시",3858,2111,668,624,509,134,152,1,1,6,0,1,1,3,4,2104,7,1747
"8343","부발읍","부발읍제2투","대통령선거","경기도","이천시",1880,1102,269,437,278,56,52,0,1,1,0,2,1,0,0,1097,5,778
"8344","부발읍","부발읍제3투","대통령선거","경기도","이천시",501,335,71,155,75,19,12,1,0,0,0,0,0,0,0,333,2,166
"8345","부발읍","부발읍제4투","대통령선거","경기도","이천시",2910,2013,793,454,480,113,154,3,0,0,3,4,0,0,2,2006,7,897
"8346","부발읍","부발읍제5투","대통령선거","경기도","이천시",3135,2063,765,493,496,156,140,0,0,1,0,0,0,1,6,2058,5,1072
"8347","부발읍","부발읍제6투","대통령선거","경기도","이천시",2916,2136,1013,381,431,146,150,2,2,4,0,0,2,0,2,2133,3,780
"8348","부발읍","부발읍제7투","대통령선거","경기도","이천시",1208,942,574,64,132,63,101,2,0,0,0,1,1,0,2,940,2,266
"8349","부발읍","부발읍제8투","대통령선거","경기도","이천시",2749,1607,598,423,372,91,113,1,0,0,0,1,1,0,3,1603,4,1142
"8350","부발읍","부발읍제9투","대통령선거","경기도","이천시",2479,2063,1120,242,394,144,158,1,0,0,0,0,1,0,0,2060,3,416
"8351","신둔면","관내사전투표","대통령선거","경기도","이천시",1569,1569,629,398,337,87,106,1,0,1,0,1,0,0,4,1564,5,0
"8352","신둔면","신둔면제1투","대통령선거","경기도","이천시",2714,1658,509,536,393,96,107,1,0,2,0,1,1,0,3,1649,9,1056
"8353","신둔면","신둔면제2투","대통령선거","경기도","이천시",3034,2002,616,678,482,99,98,5,1,6,0,1,0,2,1,1989,13,1032
"8354","신둔면","신둔면제3투","대통령선거","경기도","이천시",1646,1079,278,439,272,45,36,1,1,0,0,0,0,0,2,1074,5,567
"8355","백사면","관내사전투표","대통령선거","경기도","이천시",1133,1133,386,378,221,64,76,0,0,0,0,2,1,1,0,1129,4,0
"8356","백사면","백사면제1투","대통령선거","경기도","이천시",3494,2036,567,752,481,106,108,6,1,2,1,3,0,1,0,2028,8,1458
"8357","백사면","백사면제2투","대통령선거","경기도","이천시",3176,1988,675,619,450,108,122,2,0,3,2,0,0,1,1,1983,5,1188
"8358","호법면","관내사전투표","대통령선거","경기도","이천시",994,994,311,380,188,56,50,1,0,0,0,3,0,0,0,989,5,0
"8359","호법면","호법면제1투","대통령선거","경기도","이천시",2706,1578,384,630,354,91,102,8,1,0,0,1,1,2,1,1575,3,1128
"8360","호법면","호법면제2투","대통령선거","경기도","이천시",1021,683,149,328,132,30,39,1,1,0,1,0,1,1,0,683,0,338
"8361","마장면","관내사전투표","대통령선거","경기도","이천시",1720,1720,588,477,374,142,115,3,2,1,1,0,0,1,3,1707,13,0
"8362","마장면","마장면제1투","대통령선거","경기도","이천시",2594,1532,418,540,352,111,87,3,0,0,1,2,1,0,3,1518,14,1062
"8363","마장면","마장면제2투","대통령선거","경기도","이천시",1937,1103,282,407,290,66,47,0,0,0,0,0,2,0,2,1096,7,834
"8364","마장면","마장면제3투","대통령선거","경기도","이천시",1448,919,218,381,208,43,52,0,0,1,0,0,2,1,0,906,13,529
"8365","대월면","관내사전투표","대통령선거","경기도","이천시",2353,2353,1131,417,429,147,213,1,1,1,1,1,0,0,2,2344,9,0
"8366","대월면","대월면제1투","대통령선거","경기도","이천시",2403,1402,397,523,309,60,94,6,0,1,1,0,0,2,2,1395,7,1001
"8367","대월면","대월면제2투","대통령선거","경기도","이천시",1043,657,115,305,173,25,30,2,0,0,0,0,0,0,0,650,7,386
"8368","대월면","대월면제3투","대통령선거","경기도","이천시",2401,1342,459,323,326,76,136,1,1,3,0,6,2,2,0,1335,7,1059
"8369","대월면","대월면제4투","대통령선거","경기도","이천시",2383,1752,929,209,344,101,162,3,0,1,0,0,1,0,0,1750,2,631
"8370","모가면","관내사전투표","대통령선거","경기도","이천시",809,809,240,236,183,51,72,0,1,1,1,1,0,1,4,791,18,0
"8371","모가면","모가면제1투","대통령선거","경기도","이천시",1941,1208,284,508,289,50,63,3,0,1,1,0,1,2,2,1204,4,733
"8372","모가면","모가면제2투","대통령선거","경기도","이천시",1233,806,148,402,182,36,23,1,0,2,2,1,3,1,1,802,4,427
"8373","설성면","관내사전투표","대통령선거","경기도","이천시",637,637,184,251,132,30,31,0,0,2,0,0,1,0,3,634,3,0
"8374","설성면","설성면제1투","대통령선거","경기도","이천시",1230,737,175,302,166,40,46,0,0,0,0,1,0,3,2,735,2,493
"8375","설성면","설성면제2투","대통령선거","경기도","이천시",949,621,154,277,109,31,24,0,0,4,0,0,1,0,0,600,21,328
"8376","설성면","설성면제3투","대통령선거","경기도","이천시",1276,792,160,350,190,54,34,0,0,0,0,0,1,0,1,790,2,484
"8377","율면","관내사전투표","대통령선거","경기도","이천시",519,519,170,174,110,29,26,2,0,0,0,0,0,1,2,514,5,0
"8378","율면","율면투표소","대통령선거","경기도","이천시",1935,1192,320,465,286,47,62,1,0,2,0,1,0,1,4,1189,3,743
"8379","창전동","관내사전투표","대통령선거","경기도","이천시",2838,2838,1225,580,542,208,246,2,0,2,1,1,4,2,6,2819,19,0
"8380","창전동","창전동제1투","대통령선거","경기도","이천시",3138,1770,455,663,404,99,133,3,1,2,2,0,0,1,2,1765,5,1368
"8381","창전동","창전동제2투","대통령선거","경기도","이천시",2392,1295,375,477,252,76,100,2,1,2,0,0,2,2,4,1293,2,1097
"8382","창전동","창전동제3투","대통령선거","경기도","이천시",2215,1310,353,494,288,94,67,1,0,2,1,2,2,3,1,1308,2,905
"8383","창전동","창전동제4투","대통령선거","경기도","이천시",2269,1474,411,497,335,108,107,4,0,0,1,2,0,0,4,1469,5,795
"8384","창전동","창전동제5투","대통령선거","경기도","이천시",2090,1235,345,403,298,82,96,0,0,1,1,0,0,1,2,1229,6,855
"8385","증포동","관내사전투표","대통령선거","경기도","이천시",5595,5595,2654,994,1094,387,431,2,1,1,0,6,1,2,2,5575,20,0
"8386","증포동","증포동제1투","대통령선거","경기도","이천시",3068,2061,824,411,485,171,151,1,2,0,2,4,0,1,1,2053,8,1007
"8387","증포동","증포동제2투","대통령선거","경기도","이천시",2609,1565,483,467,409,92,93,1,0,0,2,0,1,1,2,1551,14,1044
"8388","증포동","증포동제3투","대통령선거","경기도","이천시",3937,2699,1157,494,619,195,218,1,0,2,0,1,0,0,3,2690,9,1238
"8389","증포동","증포동제4투","대통령선거","경기도","이천시",2236,1542,664,283,356,103,119,5,1,1,1,1,1,0,1,1536,6,694
"8390","증포동","증포동제5투","대통령선거","경기도","이천시",3193,2132,858,489,445,162,167,3,0,0,0,0,1,1,3,2129,3,1061
"8391","증포동","증포동제6투","대통령선거","경기도","이천시",2675,1916,747,424,444,149,142,3,0,0,1,2,1,0,1,1914,2,759
"8392","증포동","증포동제7투","대통령선거","경기도","이천시",2554,1785,749,338,397,122,167,2,0,1,0,3,0,0,0,1779,6,769
"8393","증포동","증포동제8투","대통령선거","경기도","이천시",2743,1851,753,337,447,137,161,2,1,2,0,3,0,1,1,1845,6,892
"8394","증포동","증포동제9투","대통령선거","경기도","이천시",1783,1372,582,275,326,99,80,2,0,0,0,0,1,0,4,1369,3,411
"8395","중리동","관내사전투표","대통령선거","경기도","이천시",2929,2929,1087,905,566,152,187,4,0,3,1,2,4,4,0,2915,14,0
"8396","중리동","중리동제1투","대통령선거","경기도","이천시",2225,1115,334,420,234,48,67,1,0,2,0,0,1,1,2,1110,5,1110
"8397","중리동","중리동제2투","대통령선거","경기도","이천시",2265,1365,394,471,323,83,82,1,0,1,1,1,0,0,3,1360,5,900
"8398","중리동","중리동제3투","대통령선거","경기도","이천시",1986,1326,445,395,301,113,65,1,0,2,0,0,0,1,0,1323,3,660
"8399","중리동","중리동제4투","대통령선거","경기도","이천시",2450,1557,436,550,355,111,84,0,0,0,1,2,2,2,4,1547,10,893
"8400","관고동","관내사전투표","대통령선거","경기도","이천시",2520,2520,1054,590,453,178,214,6,0,1,0,6,0,0,2,2504,16,0
"8401","관고동","관고동제1투","대통령선거","경기도","이천시",2501,1497,432,483,336,100,127,2,1,1,0,1,1,2,1,1487,10,1004
"8402","관고동","관고동제2투","대통령선거","경기도","이천시",2307,1366,392,477,314,87,83,5,0,0,0,0,1,1,1,1361,5,941
"8403","관고동","관고동제3투","대통령선거","경기도","이천시",1725,1046,291,352,250,64,74,2,0,2,0,1,0,0,1,1037,9,679
"8404","잘못 투입·구분된 투표지","잘못 투입·구분된 투표지","대통령선거","경기도","이천시",0,0,0,0,0,0,0,0,0,0,0,0,0,0,0,0,0,0
"8405","거소·선상투표","거소·선상투표","대통령선거","경기도","용인시처인구",416,390,145,76,108,19,11,2,2,2,1,0,0,1,3,370,20,26
"8406","관외사전투표","관외사전투표","대통령선거","경기도","용인시처인구",15594,15592,6586,2758,3428,1322,1299,17,3,12,6,8,9,4,28,15480,112,2
"8407","재외투표","재외투표","대통령선거","경기도","용인시처인구",1026,801,473,77,108,43,91,2,0,1,0,0,0,1,0,796,5,225
"8408","포곡읍","관내사전투표","대통령선거","경기도","용인시처인구",4061,4061,1865,742,841,283,293,6,0,2,1,6,0,1,3,4043,18,0
"8409","포곡읍","포곡읍제1투","대통령선거","경기도","용인시처인구",3068,1732,636,450,433,87,108,1,1,2,1,0,0,1,4,1724,8,1336
"8410","포곡읍","포곡읍제2투","대통령선거","경기도","용인시처인구",1242,913,358,248,191,54,53,5,0,0,0,2,0,0,0,911,2,329
"8411","포곡읍","포곡읍제3투","대통령선거","경기도","용인시처인구",1765,1212,389,331,328,69,88,0,0,1,0,2,0,1,2,1211,1,553
"8412","포곡읍","포곡읍제4투","대통령선거","경기도","용인시처인구",3823,2392,876,573,580,149,184,3,1,0,4,1,3,1,6,2381,11,1431
"8413","포곡읍","포곡읍제5투","대통령선거","경기도","용인시처인구",824,558,93,269,153,23,16,1,0,0,0,0,1,0,0,556,2,266
"8414","포곡읍","포곡읍제6투","대통령선거","경기도","용인시처인구",3290,2107,846,408,524,146,167,1,1,1,2,1,1,0,0,2098,9,1183
"8415","포곡읍","포곡읍제7투","대통령선거","경기도","용인시처인구",3662,2270,846,555,575,124,146,2,1,0,0,2,2,3,3,2259,11,1392
"8416","포곡읍","포곡읍제8투","대통령선거","경기도","용인시처인구",3731,2686,1126,479,675,192,196,2,0,1,0,2,0,1,3,2677,9,1045
"8417","모현면","관내사전투표","대통령선거","경기도","용인시처인구",2417,2417,1012,530,522,157,176,2,0,1,0,2,1,1,3,2407,10,0
"8418","모현면","모현면제1투","대통령선거","경기도","용인시처인구",3228,2154,863,460,568,109,139,1,0,1,0,1,2,1,3,2148,6,1074
"8419","모현면","모현면제2투","대통령선거","경기도","용인시처인구",2299,1406,394,487,366,61,91,1,0,0,1,0,0,0,1,1402,4,893
"8420","모현면","모현면제3투","대통령선거","경기도","용인시처인구",3005,2141,855,510,523,123,116,4,0,0,0,1,0,1,1,2134,7,864
"8421","모현면","모현면제4투","대통령선거","경기도","용인시처인구",3295,2119,708,605,539,121,128,3,0,1,1,0,0,1,3,2110,9,1176
"8422","모현면","모현면제5투","대통령선거","경기도","용인시처인구",2259,1399,445,375,380,89,96,1,0,0,0,0,0,3,1,1390,9,860
"8423","모현면","모현면제6투","대통령선거","경기도","용인시처인구",2303,1485,547,349,374,107,100,1,0,1,2,1,1,0,2,1485,0,818
"8424","남사면","관내사전투표","대통령선거","경기도","용인시처인구",738,738,256,239,159,39,38,0,1,0,0,0,0,0,2,734,4,0
"8425","남사면","남사면제1투","대통령선거","경기도","용인시처인구",1245,787,199,292,226,34,29,2,0,0,0,0,0,0,2,784,3,458
"8426","남사면","남사면제2투","대통령선거","경기도","용인시처인구",790,499,116,194,120,29,33,0,1,1,0,0,1,2,0,497,2,291
"8427","남사면","남사면제3투","대통령선거","경기도","용인시처인구",1186,819,225,299,216,34,37,0,0,0,0,1,3,0,0,815,4,367
"8428","남사면","남사면제4투","대통령선거","경기도","용인시처인구",1450,911,254,341,234,43,29,1,0,0,1,0,0,3,1,907,4,539
"8429","이동면","관내사전투표","대통령선거","경기도","용인시처인구",2048,2048,912,497,381,120,106,4,0,2,0,2,2,2,6,2034,14,0
"8430","이동면","이동면제1투","대통령선거","경기도","용인시처인구",3131,1940,675,517,494,108,126,1,0,4,0,0,2,0,4,1931,9,1191
"8431","이동면","이동면제2투","대통령선거","경기도","용인시처인구",700,449,93,200,129,14,6,1,0,0,1,0,0,3,1,448,1,251
"8432","이동면","이동면제3투","대통령선거","경기도","용인시처인구",1155,742,190,290,187,34,31,3,0,0,1,1,0,0,2,739,3,413
"8433","이동면","이동면제4투","대통령선거","경기도","용인시처인구",4011,2526,802,761,632,149,162,1,0,1,0,2,1,0,4,2515,11,1485
"8434","이동면","이동면제5투","대통령선거","경기도","용인시처인구",4462,2636,1016,599,683,150,163,5,1,2,0,3,1,0,3,2626,10,1826
"8435","원삼면","관내사전투표","대통령선거","경기도","용인시처인구",965,965,310,324,213,47,65,1,0,0,1,1,1,0,1,964,1,0
"8436","원삼면","원삼면제1투","대통령선거","경기도","용인시처인구",1475,921,205,372,243,55,37,2,1,1,0,0,1,1,0,918,3,554
"8437","원삼면","원삼면제2투","대통령선거","경기도","용인시처인구",1257,906,242,340,211,43,57,5,0,1,0,1,1,0,2,903,3,351
"8438","원삼면","원삼면제3투","대통령선거","경기도","용인시처인구",1780,1200,339,445,257,74,69,2,2,0,1,1,0,2,2,1194,6,580
"8439","원삼면","원삼면제4투","대통령선거","경기도","용인시처인구",754,443,111,181,112,23,11,1,0,0,1,0,0,0,0,440,3,311
"8440","백암면","관내사전투표","대통령선거","경기도","용인시처인구",1131,1131,418,312,248,74,67,1,0,2,0,0,1,0,1,1124,7,0
"8441","백암면","백암면제1투","대통령선거","경기도","용인시처인구",1573,918,213,370,217,60,51,0,0,3,0,0,0,0,0,914,4,655
"8442","백암면","백암면제2투","대통령선거","경기도","용인시처인구",813,557,121,239,134,28,25,2,0,0,1,2,1,2,0,555,2,256
"8443","백암면","백암면제3투","대통령선거","경기도","용인시처인구",1092,656,134,273,156,35,46,0,1,1,0,2,1,1,2,652,4,436
"8444","백암면","백암면제4투","대통령선거","경기도","용인시처인구",1409,899,245,310,220,41,32,2,3,4,4,2,4,3,4,874,25,510
"8445","백암면","백암면제5투","대통령선거","경기도","용인시처인구",1387,829,220,302,200,49,41,4,0,2,0,0,0,0,3,821,8,558
"8446","양지면","관내사전투표","대통령선거","경기도","용인시처인구",2574,2574,1063,558,603,163,166,1,0,1,0,4,0,1,4,2564,10,0
"8447","양지면","양지면제1투","대통령선거","경기도","용인시처인구",3533,2135,671,660,501,137,150,2,1,1,1,0,3,0,2,2129,6,1398
"8448","양지면","양지면제2투","대통령선거","경기도","용인시처인구",2401,1553,487,515,357,91,83,6,0,0,0,1,1,0,3,1544,9,848
"8449","양지면","양지면제3투","대통령선거","경기도","용인시처인구",1630,1097,315,401,241,58,60,3,1,0,1,3,2,0,2,1087,10,533
"8450","양지면","양지면제4투","대통령선거","경기도","용인시처인구",3387,1980,710,485,507,129,127,2,0,4,2,1,0,2,2,1971,9,1407
"8451","중앙동","관내사전투표","대통령선거","경기도","용인시처인구",3518,3518,1486,730,707,284,280,2,1,2,0,3,1,1,5,3502,16,0
"8452","중앙동","중앙동제1투","대통령선거","경기도","용인시처인구",1926,1042,336,346,208,58,84,0,0,3,1,0,0,0,2,1038,4,884
"8453","중앙동","중앙동제2투","대통령선거","경기도","용인시처인구",1347,852,310,268,182,41,45,1,0,0,0,0,0,1,0,848,4,495
"8454","중앙동","중앙동제3투","대통령선거","경기도","용인시처인구",1494,1030,323,314,253,59,72,0,0,2,0,1,1,0,1,1026,4,464
"8455","중앙동","중앙동제4투","대통령선거","경기도","용인시처인구",1920,1148,388,279,309,92,68,0,0,1,0,0,0,1,1,1139,9,772
"8456","중앙동","중앙동제5투","대통령선거","경기도","용인시처인구",2065,1392,504,363,344,74,93,2,0,2,0,3,0,1,1,1387,5,673
"8457","중앙동","중앙동제6투","대통령선거","경기도","용인시처인구",3844,2418,856,579,603,177,180,2,0,1,0,0,0,1,3,2402,16,1426
"8458","중앙동","중앙동제7투","대통령선거","경기도","용인시처인구",2795,2062,736,550,501,134,120,1,0,1,0,2,1,2,2,2050,12,733
"8459","역삼동","관내사전투표","대통령선거","경기도","용인시처인구",4716,4716,2059,884,1002,357,376,5,0,1,1,6,0,1,5,4697,19,0
"8460","역삼동","역삼동제1투","대통령선거","경기도","용인시처인구",1930,1206,387,330,333,61,88,1,0,0,0,0,0,0,0,1200,6,724
"8461","역삼동","역삼동제2투","대통령선거","경기도","용인시처인구",3185,2027,762,455,519,142,132,3,0,0,0,4,2,1,0,2020,7,1158
"8462","역삼동","역삼동제3투","대통령선거","경기도","용인시처인구",3144,2119,726,495,572,166,143,1,0,1,1,1,1,0,3,2110,9,1025
"8463","역삼동","역삼동제4투","대통령선거","경기도","용인시처인구",2658,1949,736,515,432,114,136,5,1,0,0,0,0,0,1,1940,9,709
"8464","역삼동","역삼동제5투","대통령선거","경기도","용인시처인구",4341,3251,1403,635,756,216,225,1,0,1,0,1,1,1,1,3241,10,1090
"8465","역삼동","역삼동제6투","대통령선거","경기도","용인시처인구",2355,1599,632,334,373,117,136,0,1,0,0,2,0,0,0,1595,4,756
"8466","유림동","관내사전투표","대통령선거","경기도","용인시처인구",2995,2995,1413,510,666,181,204,3,0,2,0,2,1,0,3,2985,10,0
"8467","유림동","유림동제1투","대통령선거","경기도","용인시처인구",2860,1574,521,435,423,83,105,1,1,0,1,0,0,1,0,1571,3,1286
"8468","유림동","유림동제2투","대통령선거","경기도","용인시처인구",3006,2203,941,471,489,117,166,0,4,0,1,2,1,1,4,2197,6,803
"8469","유림동","유림동제3투","대통령선거","경기도","용인시처인구",2450,1535,480,465,397,84,92,3,1,0,0,1,1,1,1,1526,9,915
"8470","유림동","유림동제4투","대통령선거","경기도","용인시처인구",4136,2423,867,564,614,150,214,1,0,1,0,4,0,1,2,2418,5,1713
"8471","유림동","유림동제5투","대통령선거","경기도","용인시처인구",3809,2669,1122,482,661,176,207,3,0,1,0,3,0,1,3,2659,10,1140
"8472","유림동","유림동제6투","대통령선거","경기도","용인시처인구",3517,2588,1061,475,665,191,180,2,0,2,1,2,0,0,1,2580,8,929
"8473","동부동","관내사전투표","대통령선거","경기도","용인시처인구",2023,2023,845,443,432,123,164,1,0,1,2,1,0,0,1,2013,10,0
"8474","동부동","동부동제1투","대통령선거","경기도","용인시처인구",3249,2119,707,563,547,153,135,4,0,0,0,0,1,0,3,2113,6,1130
"8475","동부동","동부동제2투","대통령선거","경기도","용인시처인구",4186,2652,951,658,688,155,172,3,1,1,1,4,0,1,1,2636,16,1534
"8476","동부동","동부동제3투","대통령선거","경기도","용인시처인구",1552,1068,266,412,254,63,65,0,1,1,1,0,0,0,1,1064,4,484
"8477","잘못 투입·구분된 투표지","잘못 투입·구분된 투표지","대통령선거","경기도","용인시처인구",0,0,0,0,0,0,0,0,0,0,0,0,0,0,0,0,0,0
"8478","거소·선상투표","거소·선상투표","대통령선거","경기도","용인시수지구",374,352,121,56,134,18,8,1,0,1,1,0,1,0,1,342,10,22
"8479","관외사전투표","관외사전투표","대통령선거","경기도","용인시수지구",26482,26461,12257,4200,5463,2378,1950,29,4,9,0,17,4,7,19,26337,124,21
"8480","재외투표","재외투표","대통령선거","경기도","용인시수지구",4043,3212,1828,283,560,148,362,13,0,3,0,0,0,1,2,3200,12,831
"8481","풍덕천1동","관내사전투표","대통령선거","경기도","용인시수지구",6943,6943,3273,1272,1330,574,456,7,0,3,0,4,0,3,2,6924,19,0
"8482","풍덕천1동","풍덕천1동제1투","대통령선거","경기도","용인시수지구",3349,1978,872,387,403,160,138,8,0,1,0,2,0,0,2,1973,5,1371
"8483","풍덕천1동","풍덕천1동제2투","대통령선거","경기도","용인시수지구",2900,1996,745,518,467,131,120,5,0,2,0,1,1,0,1,1991,5,904
"8484","풍덕천1동","풍덕천1동제3투","대통령선거","경기도","용인시수지구",3986,3234,1500,576,764,215,155,10,0,6,0,2,1,1,0,3230,4,752
"8485","풍덕천1동","풍덕천1동제4투","대통령선거","경기도","용인시수지구",3060,2420,1014,480,567,206,142,2,0,1,0,1,1,1,1,2416,4,640
"8486","풍덕천1동","풍덕천1동제5투","대통령선거","경기도","용인시수지구",2883,2251,1033,421,460,178,152,3,0,0,0,1,0,0,1,2249,2,632
"8487","풍덕천1동","풍덕천1동제6투","대통령선거","경기도","용인시수지구",2628,2104,830,504,465,181,116,2,0,1,0,2,1,0,0,2102,2,524
"8488","풍덕천1동","풍덕천1동제7투","대통령선거","경기도","용인시수지구",2641,2112,992,399,440,166,106,6,0,1,0,0,0,0,0,2110,2,529
"8489","풍덕천2동","관내사전투표","대통령선거","경기도","용인시수지구",5156,5156,2635,792,937,385,374,6,1,3,1,2,0,0,2,5138,18,0
"8490","풍덕천2동","풍덕천2동제1투","대통령선거","경기도","용인시수지구",2268,1923,858,401,390,149,115,4,0,0,0,2,0,0,1,1920,3,345
"8491","풍덕천2동","풍덕천2동제2투","대통령선거","경기도","용인시수지구",1973,1315,544,265,297,114,82,2,0,0,0,1,1,0,2,1308,7,658
"8492","풍덕천2동","풍덕천2동제3투","대통령선거","경기도","용인시수지구",2731,2272,960,468,488,200,140,7,0,0,2,2,0,0,0,2267,5,459
"8493","풍덕천2동","풍덕천2동제4투","대통령선거","경기도","용인시수지구",2379,1720,870,267,327,131,114,4,0,0,0,3,0,0,1,1717,3,659
"8494","풍덕천2동","풍덕천2동제5투","대통령선거","경기도","용인시수지구",2850,2287,1103,303,520,206,142,4,0,2,0,0,0,1,2,2283,4,563
"8495","풍덕천2동","풍덕천2동제6투","대통령선거","경기도","용인시수지구",2611,2162,995,367,466,203,123,2,0,2,0,0,0,1,0,2159,3,449
"8496","풍덕천2동","풍덕천2동제7투","대통령선거","경기도","용인시수지구",2201,1757,812,327,377,135,100,1,1,0,0,0,0,0,0,1753,4,444
"8497","풍덕천2동","풍덕천2동제8투","대통령선거","경기도","용인시수지구",3239,2580,946,700,565,254,105,4,1,1,0,0,0,0,0,2576,4,659
"8498","신봉동","관내사전투표","대통령선거","경기도","용인시수지구",4921,4921,2245,1090,907,355,295,7,0,2,1,2,0,2,3,4909,12,0
"8499","신봉동","신봉동제1투","대통령선거","경기도","용인시수지구",1917,1482,674,278,294,135,92,3,0,2,0,0,1,0,0,1479,3,435
"8500","신봉동","신봉동제2투","대통령선거","경기도","용인시수지구",2249,1845,837,337,397,177,94,2,0,0,0,0,0,0,1,1845,0,404
"8501","신봉동","신봉동제3투","대통령선거","경기도","용인시수지구",3598,2901,1083,813,640,216,134,1,0,1,0,3,0,0,1,2892,9,697
"8502","신봉동","신봉동제4투","대통령선거","경기도","용인시수지구",2985,2360,855,683,461,235,113,9,0,0,1,0,0,0,0,2357,3,625
"8503","신봉동","신봉동제5투","대통령선거","경기도","용인시수지구",4142,3064,967,1058,641,239,141,8,0,0,0,0,0,0,3,3057,7,1078
"8504","신봉동","신봉동제6투","대통령선거","경기도","용인시수지구",3181,2466,898,703,555,204,92,5,0,1,0,0,0,1,1,2460,6,715
"8505","신봉동","신봉동제7투","대통령선거","경기도","용인시수지구",2276,1810,680,439,416,177,90,3,0,0,0,2,0,1,1,1809,1,466
"8506","죽전1동","관내사전투표","대통령선거","경기도","용인시수지구",7409,7409,3516,1503,1404,540,418,4,0,2,1,5,2,4,1,7400,9,0
"8507","죽전1동","죽전1동제1투","대통령선거","경기도","용인시수지구",3298,2351,1027,482,494,196,134,7,1,0,1,2,0,1,2,2347,4,947
"8508","죽전1동","죽전1동제2투","대통령선거","경기도","용인시수지구",3482,2721,1233,522,564,227,160,3,0,0,0,1,1,0,1,2712,9,761
"8509","죽전1동","죽전1동제3투","대통령선거","경기도","용인시수지구",3315,2688,1238,546,545,225,130,1,0,0,0,0,0,0,0,2685,3,627
"8510","죽전1동","죽전1동제4투","대통령선거","경기도","용인시수지구",3390,2617,1050,630,545,214,162,6,0,3,2,1,0,0,0,2613,4,773
"8511","죽전1동","죽전1동제5투","대통령선거","경기도","용인시수지구",3288,2703,1241,511,581,206,156,1,0,0,1,2,0,1,0,2700,3,585
"8512","죽전1동","죽전1동제6투","대통령선거","경기도","용인시수지구",3263,2601,1022,675,560,241,97,0,0,2,0,0,0,1,0,2598,3,662
"8513","죽전1동","죽전1동제7투","대통령선거","경기도","용인시수지구",2799,2146,811,609,434,167,109,3,1,2,1,2,0,2,1,2142,4,653
"8514","죽전1동","죽전1동제8투","대통령선거","경기도","용인시수지구",3102,2359,1003,504,533,191,117,2,0,0,0,3,0,0,1,2354,5,743
"8515","죽전1동","죽전1동제9투","대통령선거","경기도","용인시수지구",3233,2480,1133,491,485,230,132,4,0,0,0,0,0,0,0,2475,5,753
"8516","죽전1동","죽전1동제10투","대통령선거","경기도","용인시수지구",2511,1997,945,357,405,172,109,3,0,1,0,0,0,1,0,1993,4,514
"8517","죽전2동","관내사전투표","대통령선거","경기도","용인시수지구",2363,2363,1137,433,427,207,149,3,0,0,0,2,0,0,0,2358,5,0
"8518","죽전2동","죽전2동제1투","대통령선거","경기도","용인시수지구",3122,2358,1041,470,508,178,147,5,0,1,0,1,0,0,1,2352,6,764
"8519","죽전2동","죽전2동제2투","대통령선거","경기도","용인시수지구",2652,2042,887,394,451,191,114,1,0,1,0,1,0,0,0,2040,2,610
"8520","죽전2동","죽전2동제3투","대통령선거","경기도","용인시수지구",2669,2125,846,471,490,193,114,3,0,0,0,1,0,0,2,2120,5,544
"8521","죽전2동","죽전2동제4투","대통령선거","경기도","용인시수지구",2600,2065,958,395,434,160,109,2,1,0,1,0,0,1,1,2062,3,535
"8522","동천동","관내사전투표","대통령선거","경기도","용인시수지구",5617,5617,2581,1127,1070,430,377,6,0,0,3,6,1,0,4,5605,12,0
"8523","동천동","동천동제1투","대통령선거","경기도","용인시수지구",3225,2373,999,515,496,191,157,6,0,0,0,2,0,2,0,2368,5,852
"8524","동천동","동천동제2투","대통령선거","경기도","용인시수지구",1336,960,367,240,208,62,77,3,0,0,0,0,0,0,1,958,2,376
"8525","동천동","동천동제3투","대통령선거","경기도","용인시수지구",2639,2132,867,498,460,171,126,5,0,0,0,1,0,0,1,2129,3,507
"8526","동천동","동천동제4투","대통령선거","경기도","용인시수지구",3690,2911,1319,521,607,234,205,8,1,1,0,1,0,2,5,2904,7,779
"8527","동천동","동천동제5투","대통령선거","경기도","용인시수지구",1597,1206,427,381,247,69,74,2,0,1,1,0,0,1,1,1204,2,391
"8528","동천동","동천동제6투","대통령선거","경기도","용인시수지구",1911,1482,675,253,337,118,93,2,0,1,0,2,0,0,0,1481,1,429
"8529","동천동","동천동제7투","대통령선거","경기도","용인시수지구",2282,1815,667,469,416,164,94,1,0,0,0,0,0,0,0,1811,4,467
"8530","동천동","동천동제8투","대통령선거","경기도","용인시수지구",2833,2260,694,726,538,213,78,4,0,1,0,0,0,2,1,2257,3,573
"8531","상현1동","관내사전투표","대통령선거","경기도","용인시수지구",4184,4184,2027,699,813,344,281,7,0,0,0,1,0,1,2,4175,9,0
"8532","상현1동","상현1동제1투","대통령선거","경기도","용인시수지구",2821,2201,865,551,481,188,106,2,0,0,0,2,0,0,1,2196,5,620
"8533","상현1동","상현1동제2투","대통령선거","경기도","용인시수지구",3048,2394,946,542,589,196,113,1,1,0,0,1,0,0,0,2389,5,654
"8534","상현1동","상현1동제3투","대통령선거","경기도","용인시수지구",2955,2390,954,566,540,192,126,6,0,0,0,0,0,1,1,2386,4,565
"8535","상현1동","상현1동제4투","대통령선거","경기도","용인시수지구",2269,1772,569,611,352,151,83,3,0,0,0,2,0,0,1,1772,0,497
"8536","상현1동","상현1동제5투","대통령선거","경기도","용인시수지구",2304,1789,697,461,387,145,91,4,0,0,0,0,0,0,1,1786,3,515
"8537","상현1동","상현1동제6투","대통령선거","경기도","용인시수지구",2239,1781,537,537,448,172,79,4,0,0,0,0,0,1,0,1778,3,458
"8538","상현1동","상현1동제7투","대통령선거","경기도","용인시수지구",3404,2606,1009,642,570,218,155,3,0,1,0,0,0,0,2,2600,6,798
"8539","상현1동","상현1동제8투","대통령선거","경기도","용인시수지구",3642,2811,1386,366,647,244,161,3,0,0,0,0,0,0,1,2808,3,831
"8540","상현1동","상현1동제9투","대통령선거","경기도","용인시수지구",3494,2672,1281,473,536,209,159,5,0,1,0,0,0,0,2,2666,6,822
"8541","상현2동","관내사전투표","대통령선거","경기도","용인시수지구",6285,6284,2705,1507,1234,461,353,5,1,1,0,0,1,0,1,6269,15,1
"8542","상현2동","상현2동제1투","대통령선거","경기도","용인시수지구",3071,2250,937,537,451,190,123,5,1,0,1,0,0,0,2,2247,3,821
"8543","상현2동","상현2동제2투","대통령선거","경기도","용인시수지구",2874,2251,874,615,459,171,122,2,0,1,1,1,1,0,0,2247,4,623
"8544","상현2동","상현2동제3투","대통령선거","경기도","용인시수지구",2409,1854,679,488,430,160,89,1,0,0,0,0,0,1,0,1848,6,555
"8545","상현2동","상현2동제4투","대통령선거","경기도","용인시수지구",2864,2300,972,581,459,168,114,2,0,1,0,0,0,0,0,2297,3,564
"8546","상현2동","상현2동제5투","대통령선거","경기도","용인시수지구",3144,2508,1025,588,542,191,148,4,0,0,0,0,1,0,1,2500,8,636
"8547","상현2동","상현2동제6투","대통령선거","경기도","용인시수지구",3336,2793,1128,661,599,221,173,3,1,2,0,1,0,0,1,2790,3,543
"8548","성복동","관내사전투표","대통령선거","경기도","용인시수지구",5794,5794,1947,2016,1073,491,230,24,0,0,0,1,0,2,0,5784,10,0
"8549","성복동","성복동제1투","대통령선거","경기도","용인시수지구",2785,2191,596,849,455,177,107,4,0,0,0,0,0,0,0,2188,3,594
"8550","성복동","성복동제2투","대통령선거","경기도","용인시수지구",3269,2586,621,1110,529,209,102,10,0,1,0,0,0,0,1,2583,3,683
"8551","성복동","성복동제3투","대통령선거","경기도","용인시수지구",2192,1598,354,724,331,138,44,3,0,0,0,0,0,2,0,1596,2,594
"8552","성복동","성복동제4투","대통령선거","경기도","용인시수지구",2379,1755,566,551,378,163,83,6,0,0,1,0,0,0,1,1749,6,624
"8553","성복동","성복동제5투","대통령선거","경기도","용인시수지구",2830,2089,559,852,443,159,67,2,1,1,0,2,1,0,0,2087,2,741
"8554","성복동","성복동제6투","대통령선거","경기도","용인시수지구",3840,2892,959,799,715,279,122,14,0,2,0,1,0,0,0,2891,1,948
"8555","성복동","성복동제7투","대통령선거","경기도","용인시수지구",3785,2903,1021,793,694,258,122,9,0,0,0,2,0,0,1,2900,3,882
"8556","잘못 투입·구분된 투표지","잘못 투입·구분된 투표지","대통령선거","경기도","용인시수지구",0,0,0,0,0,0,0,0,0,0,0,0,0,0,0,0,0,0
"8557","거소·선상투표","거소·선상투표","대통령선거","경기도","용인시기흥구",428,402,133,69,149,20,17,3,1,1,1,0,0,1,1,396,6,26
"8558","관외사전투표","관외사전투표","대통령선거","경기도","용인시기흥구",32179,32174,15281,5043,6627,2577,2370,40,1,19,8,13,7,7,32,32025,149,5
"8559","재외투표","재외투표","대통령선거","경기도","용인시기흥구",3464,2798,1697,195,423,143,318,5,0,0,1,2,1,1,1,2787,11,666
"8560","신갈동","관내사전투표","대통령선거","경기도","용인시기흥구",5125,5125,2373,975,1098,313,329,9,1,1,0,9,0,3,3,5114,11,0
"8561","신갈동","신갈동제1투","대통령선거","경기도","용인시기흥구",2506,1404,467,417,334,94,75,2,0,2,2,0,1,0,0,1394,10,1102
"8562","신갈동","신갈동제2투","대통령선거","경기도","용인시기흥구",2613,1797,680,431,415,143,120,3,0,0,0,2,0,1,0,1795,2,816
"8563","신갈동","신갈동제3투","대통령선거","경기도","용인시기흥구",2594,1663,640,353,467,80,108,3,0,1,0,2,1,0,1,1656,7,931
"8564","신갈동","신갈동제4투","대통령선거","경기도","용인시기흥구",2725,2116,943,366,494,160,142,0,0,5,0,0,0,0,1,2111,5,609
"8565","신갈동","신갈동제5투","대통령선거","경기도","용인시기흥구",2903,2237,876,557,489,173,126,6,0,0,0,1,2,1,0,2231,6,666
"8566","신갈동","신갈동제6투","대통령선거","경기도","용인시기흥구",2447,2019,1012,303,426,145,129,3,0,0,0,0,0,0,0,2018,1,428
"8567","신갈동","신갈동제7투","대통령선거","경기도","용인시기흥구",3866,2993,1286,661,697,180,158,1,1,0,0,4,0,0,1,2989,4,873
"8568","신갈동","신갈동제8투","대통령선거","경기도","용인시기흥구",2405,2049,954,426,438,132,89,3,0,1,1,0,1,1,1,2047,2,356
"8569","영덕동","관내사전투표","대통령선거","경기도","용인시기흥구",3928,3927,2221,510,668,259,249,5,0,0,0,4,0,2,1,3919,8,1
"8570","영덕동","영덕동제1투","대통령선거","경기도","용인시기흥구",3082,2205,792,617,510,152,127,3,0,1,0,1,0,0,0,2203,2,877
"8571","영덕동","영덕동제2투","대통령선거","경기도","용인시기흥구",1821,1472,654,294,306,110,101,1,0,1,0,1,2,0,0,1470,2,349
"8572","영덕동","영덕동제3투","대통령선거","경기도","용인시기흥구",2511,1996,914,344,444,151,132,3,0,1,0,1,0,0,0,1990,6,515
"8573","영덕동","영덕동제4투","대통령선거","경기도","용인시기흥구",2558,1929,841,325,477,149,128,3,1,2,0,0,0,0,1,1927,2,629
"8574","영덕동","영덕동제5투","대통령선거","경기도","용인시기흥구",4741,3567,1669,620,736,308,222,5,0,1,0,2,0,1,1,3565,2,1174
"8575","영덕동","영덕동제6투","대통령선거","경기도","용인시기흥구",4166,3472,1795,488,665,279,229,5,0,2,0,0,1,2,1,3467,5,694
"8576","영덕동","영덕동제7투","대통령선거","경기도","용인시기흥구",3525,2299,1020,424,525,142,167,8,0,3,1,3,0,2,0,2295,4,1226
"8577","영덕동","영덕동제8투","대통령선거","경기도","용인시기흥구",2582,2188,1232,203,433,178,138,0,0,0,0,0,0,0,0,2184,4,394
"8578","구갈동","관내사전투표","대통령선거","경기도","용인시기흥구",3159,3159,1581,489,552,237,279,4,0,1,1,3,1,1,0,3149,10,0
"8579","구갈동","구갈동제1투","대통령선거","경기도","용인시기흥구",2525,1570,687,303,328,117,123,3,0,0,0,0,1,2,0,1564,6,955
"8580","구갈동","구갈동제2투","대통령선거","경기도","용인시기흥구",2486,1643,658,340,384,118,130,3,0,0,0,3,1,0,1,1638,5,843
"8581","구갈동","구갈동제3투","대통령선거","경기도","용인시기흥구",2575,1772,715,377,435,104,116,11,0,3,0,2,1,1,0,1765,7,803
"8582","구갈동","구갈동제4투","대통령선거","경기도","용인시기흥구",2548,2016,855,420,420,146,165,1,0,1,1,2,0,0,0,2011,5,532
"8583","구갈동","구갈동제5투","대통령선거","경기도","용인시기흥구",2956,2200,910,457,539,153,122,5,0,0,1,3,1,0,1,2192,8,756
"8584","구갈동","구갈동제6투","대통령선거","경기도","용인시기흥구",1549,1259,607,223,266,85,74,0,0,1,0,0,0,0,0,1256,3,290
"8585","구갈동","구갈동제7투","대통령선거","경기도","용인시기흥구",1661,1312,533,272,293,115,93,1,0,0,0,1,0,0,1,1309,3,349
"8586","상갈동","관내사전투표","대통령선거","경기도","용인시기흥구",4457,4457,2133,812,862,282,336,6,0,2,1,3,2,1,4,4444,13,0
"8587","상갈동","상갈동제1투","대통령선거","경기도","용인시기흥구",2807,1884,794,356,437,156,134,0,0,0,0,3,0,0,0,1880,4,923
"8588","상갈동","상갈동제2투","대통령선거","경기도","용인시기흥구",3133,2038,969,320,467,143,122,5,0,0,0,3,0,1,2,2032,6,1095
"8589","상갈동","상갈동제3투","대통령선거","경기도","용인시기흥구",2512,2053,885,435,434,159,128,1,0,0,0,1,1,0,2,2046,7,459
"8590","상갈동","상갈동제4투","대통령선거","경기도","용인시기흥구",1519,1017,390,246,246,69,51,3,0,1,0,3,1,1,0,1011,6,502
"8591","상갈동","상갈동제5투","대통령선거","경기도","용인시기흥구",1935,1481,608,404,299,94,70,2,1,0,0,0,0,0,0,1478,3,454
"8592","상갈동","상갈동제6투","대통령선거","경기도","용인시기흥구",2195,1715,724,362,391,122,102,5,0,2,0,1,0,0,0,1709,6,480
"8593","상갈동","상갈동제7투","대통령선거","경기도","용인시기흥구",3302,2620,943,789,565,167,144,1,0,2,1,2,0,1,0,2615,5,682
"8594","상갈동","상갈동제8투","대통령선거","경기도","용인시기흥구",2234,1790,728,431,390,124,109,3,0,1,0,0,0,0,0,1786,4,444
"8595","상갈동","상갈동제9투","대통령선거","경기도","용인시기흥구",2909,2057,860,459,455,136,134,3,0,1,0,4,0,1,1,2054,3,852
"8596","상갈동","상갈동제10투","대통령선거","경기도","용인시기흥구",2162,1800,1001,212,368,100,111,1,0,1,0,2,2,0,0,1798,2,362
"8597","상갈동","상갈동제11투","대통령선거","경기도","용인시기흥구",2738,2078,827,539,462,118,116,4,0,2,1,2,1,0,1,2073,5,660
"8598","기흥동","관내사전투표","대통령선거","경기도","용인시기흥구",2800,2800,1260,592,602,179,137,13,0,2,2,1,0,0,0,2788,12,0
"8599","기흥동","기흥동제1투","대통령선거","경기도","용인시기흥구",2634,1735,635,395,465,127,100,0,0,1,0,0,2,1,1,1727,8,899
"8600","기흥동","기흥동제2투","대통령선거","경기도","용인시기흥구",2711,1987,928,360,463,123,103,1,0,0,1,1,0,1,1,1982,5,724
"8601","기흥동","기흥동제3투","대통령선거","경기도","용인시기흥구",887,534,129,248,100,37,16,3,0,0,0,0,1,0,0,534,0,353
"8602","기흥동","기흥동제4투","대통령선거","경기도","용인시기흥구",3345,2185,886,506,507,134,141,4,0,0,0,2,1,1,1,2183,2,1160
"8603","기흥동","기흥동제5투","대통령선거","경기도","용인시기흥구",3585,2574,899,719,636,188,118,7,0,2,0,1,0,0,0,2570,4,1011
"8604","서농동","관내사전투표","대통령선거","경기도","용인시기흥구",3584,3584,2001,416,611,275,265,5,0,2,1,1,0,1,0,3578,6,0
"8605","서농동","서농동제1투","대통령선거","경기도","용인시기흥구",916,548,250,47,90,99,62,0,0,0,0,0,0,0,0,548,0,368
"8606","서농동","서농동제2투","대통령선거","경기도","용인시기흥구",2120,1736,740,334,372,174,108,2,0,1,0,0,0,0,1,1732,4,384
"8607","서농동","서농동제3투","대통령선거","경기도","용인시기흥구",1951,1473,589,333,326,133,86,0,0,2,0,0,0,1,0,1470,3,478
"8608","서농동","서농동제4투","대통령선거","경기도","용인시기흥구",2808,1909,869,327,446,142,121,1,1,0,0,0,0,0,0,1907,2,899
"8609","서농동","서농동제5투","대통령선거","경기도","용인시기흥구",2573,2146,1190,208,430,174,135,5,0,1,0,1,0,0,0,2144,2,427
"8610","서농동","서농동제6투","대통령선거","경기도","용인시기흥구",2002,1679,929,169,327,140,105,5,0,1,0,0,0,0,1,1677,2,323
"8611","구성동","관내사전투표","대통령선거","경기도","용인시기흥구",5569,5569,2235,1516,1053,408,319,7,0,3,1,7,0,0,3,5552,17,0
"8612","구성동","구성동제1투","대통령선거","경기도","용인시기흥구",2890,2045,593,796,396,143,105,1,0,0,1,0,1,0,3,2039,6,845
"8613","구성동","구성동제2투","대통령선거","경기도","용인시기흥구",3047,2307,807,762,491,149,84,4,0,1,0,0,0,3,1,2302,5,740
"8614","구성동","구성동제3투","대통령선거","경기도","용인시기흥구",3247,2313,918,622,491,134,132,3,0,3,1,0,0,0,2,2306,7,934
"8615","구성동","구성동제4투","대통령선거","경기도","용인시기흥구",2910,2405,908,737,504,146,96,3,0,3,0,1,0,1,2,2401,4,505
"8616","구성동","구성동제5투","대통령선거","경기도","용인시기흥구",1700,1391,609,342,287,86,61,2,0,0,0,0,1,1,0,1389,2,309
"8617","구성동","구성동제6투","대통령선거","경기도","용인시기흥구",3457,2619,1270,468,568,155,141,6,0,1,0,1,1,1,1,2613,6,838
"8618","구성동","구성동제7투","대통령선거","경기도","용인시기흥구",3089,2282,884,560,535,149,141,3,0,2,0,0,0,0,1,2275,7,807
"8619","구성동","구성동제8투","대통령선거","경기도","용인시기흥구",2714,1967,872,422,446,125,89,8,0,1,0,0,0,1,1,1965,2,747
"8620","마북동","관내사전투표","대통령선거","경기도","용인시기흥구",4386,4386,1807,1162,857,314,228,4,0,2,0,3,1,0,0,4378,8,0
"8621","마북동","마북동제1투","대통령선거","경기도","용인시기흥구",2663,1798,652,534,388,130,79,6,2,0,1,0,0,0,0,1792,6,865
"8622","마북동","마북동제2투","대통령선거","경기도","용인시기흥구",2720,2059,658,731,424,139,99,4,0,0,0,0,0,1,1,2057,2,661
"8623","마북동","마북동제3투","대통령선거","경기도","용인시기흥구",2809,2165,862,463,547,155,122,4,0,0,0,2,0,0,1,2156,9,644
"8624","마북동","마북동제4투","대통령선거","경기도","용인시기흥구",2704,2190,648,797,460,186,91,2,0,1,1,0,0,0,0,2186,4,514
"8625","마북동","마북동제5투","대통령선거","경기도","용인시기흥구",2766,2218,957,474,469,191,117,1,0,3,0,1,0,0,0,2213,5,548
"8626","마북동","마북동제6투","대통령선거","경기도","용인시기흥구",2068,1580,539,487,337,127,80,5,1,0,0,1,1,0,0,1578,2,488
"8627","마북동","마북동제7투","대통령선거","경기도","용인시기흥구",2732,2088,767,610,421,163,120,2,0,2,0,0,0,0,0,2085,3,644
"8628","동백동","관내사전투표","대통령선거","경기도","용인시기흥구",7220,7220,3827,1119,1267,512,458,13,0,3,2,3,0,2,2,7208,12,0
"8629","동백동","동백동제1투","대통령선거","경기도","용인시기흥구",1884,1487,674,315,311,105,72,0,0,3,0,1,0,0,0,1481,6,397
"8630","동백동","동백동제2투","대통령선거","경기도","용인시기흥구",3177,2633,1353,350,545,205,163,6,0,0,0,1,0,1,1,2625,8,544
"8631","동백동","동백동제3투","대통령선거","경기도","용인시기흥구",2924,2198,986,460,457,153,131,3,0,0,0,1,0,1,2,2194,4,726
"8632","동백동","동백동제4투","대통령선거","경기도","용인시기흥구",3147,2472,1246,366,521,169,153,7,0,0,1,0,0,0,4,2467,5,675
"8633","동백동","동백동제5투","대통령선거","경기도","용인시기흥구",3033,2358,1146,424,494,146,136,4,1,1,0,2,0,0,0,2354,4,675
"8634","동백동","동백동제6투","대통령선거","경기도","용인시기흥구",3288,2535,1330,329,499,207,161,7,0,0,0,1,0,0,1,2535,0,753
"8635","동백동","동백동제7투","대통령선거","경기도","용인시기흥구",2541,2055,1042,303,451,137,112,2,0,0,0,3,0,0,0,2050,5,486
"8636","동백동","동백동제8투","대통령선거","경기도","용인시기흥구",2951,2429,1108,442,518,212,141,1,0,1,0,2,0,1,1,2427,2,522
"8637","동백동","동백동제9투","대통령선거","경기도","용인시기흥구",4102,3015,1334,613,651,238,166,4,0,0,1,0,0,0,1,3008,7,1087
"8638","동백동","동백동제10투","대통령선거","경기도","용인시기흥구",1974,1630,817,254,353,104,92,0,0,0,0,2,0,0,1,1623,7,344
"8639","동백동","동백동제11투","대통령선거","경기도","용인시기흥구",2149,1713,842,236,383,133,110,5,0,0,0,0,0,0,0,1709,4,436
"8640","동백동","동백동제12투","대통령선거","경기도","용인시기흥구",3376,2568,1128,537,571,172,146,5,0,0,1,3,1,1,1,2566,2,808
"8641","동백동","동백동제13투","대통령선거","경기도","용인시기흥구",2624,2060,974,383,413,155,125,4,0,1,0,1,0,0,0,2056,4,564
"8642","동백동","동백동제14투","대통령선거","경기도","용인시기흥구",2693,2133,954,426,489,151,103,2,1,0,0,2,0,0,1,2129,4,560
"8643","동백동","동백동제15투","대통령선거","경기도","용인시기흥구",3453,2732,1217,564,586,207,144,5,1,1,1,2,1,0,2,2731,1,721
"8644","상하동","관내사전투표","대통령선거","경기도","용인시기흥구",3278,3278,1579,609,635,228,208,8,0,1,1,1,0,1,2,3273,5,0
"8645","상하동","상하동제1투","대통령선거","경기도","용인시기흥구",3373,2371,989,455,574,192,152,5,0,0,1,0,0,0,1,2369,2,1002
"8646","상하동","상하동제2투","대통령선거","경기도","용인시기흥구",3162,2377,902,549,602,160,146,4,0,1,1,4,0,2,1,2372,5,785
"8647","상하동","상하동제3투","대통령선거","경기도","용인시기흥구",2666,2081,889,475,450,133,118,10,0,0,1,1,0,0,1,2078,3,585
"8648","상하동","상하동제4투","대통령선거","경기도","용인시기흥구",3092,2184,911,501,507,124,130,2,0,1,1,1,0,0,2,2180,4,908
"8649","상하동","상하동제5투","대통령선거","경기도","용인시기흥구",2017,1593,656,319,391,135,79,3,0,0,1,1,1,1,2,1589,4,424
"8650","보정동","관내사전투표","대통령선거","경기도","용인시기흥구",4208,4208,2007,837,755,334,258,4,0,2,0,0,1,2,1,4201,7,0
"8651","보정동","보정동제1투","대통령선거","경기도","용인시기흥구",3567,2516,1036,550,567,217,137,3,0,1,1,1,0,0,1,2514,2,1051
"8652","보정동","보정동제2투","대통령선거","경기도","용인시기흥구",3430,2767,619,1241,605,185,98,9,0,0,0,0,0,2,0,2759,8,663
"8653","보정동","보정동제3투","대통령선거","경기도","용인시기흥구",3992,3196,1191,912,658,236,184,3,0,0,1,1,0,1,0,3187,9,796
"8654","보정동","보정동제4투","대통령선거","경기도","용인시기흥구",3037,2400,946,606,527,199,107,3,0,0,1,0,0,1,1,2391,9,637
"8655","보정동","보정동제5투","대통령선거","경기도","용인시기흥구",2522,1987,706,572,460,145,95,2,0,2,0,0,0,0,2,1984,3,535
"8656","보정동","보정동제6투","대통령선거","경기도","용인시기흥구",2675,2206,1066,371,464,173,124,3,0,0,0,1,0,0,2,2204,2,469
"8657","보정동","보정동제7투","대통령선거","경기도","용인시기흥구",1338,987,363,283,226,67,43,0,0,0,1,0,0,1,0,984,3,351
"8658","잘못 투입·구분된 투표지","잘못 투입·구분된 투표지","대통령선거","경기도","용인시기흥구",0,0,0,0,0,0,0,0,0,0,0,0,0,0,0,0,0,0
"8659","거소·선상투표","거소·선상투표","대통령선거","경기도","안성시",221,209,65,32,66,20,9,2,2,1,0,0,0,1,1,199,10,12
"8660","관외사전투표","관외사전투표","대통령선거","경기도","안성시",10978,10978,4769,1835,2357,903,964,15,8,10,2,13,6,7,20,10909,69,0
"8661","재외투표","재외투표","대통령선거","경기도","안성시",675,507,310,42,69,17,65,2,0,0,0,0,0,1,0,506,1,168
"8662","공도읍","관내사전투표","대통령선거","경기도","안성시",5264,5264,2593,803,1058,344,421,4,0,6,2,8,2,1,6,5248,16,0
"8663","공도읍","공도읍제1투","대통령선거","경기도","안성시",1870,1095,268,464,255,42,48,0,1,0,1,4,0,2,2,1087,8,775
"8664","공도읍","공도읍제2투","대통령선거","경기도","안성시",1927,1242,501,247,332,69,86,0,0,1,0,0,1,0,2,1239,3,685
"8665","공도읍","공도읍제3투","대통령선거","경기도","안성시",2159,1333,515,349,317,63,79,2,0,1,0,0,0,1,0,1327,6,826
"8666","공도읍","공도읍제4투","대통령선거","경기도","안성시",3866,2164,811,467,552,127,185,6,0,1,2,1,1,1,3,2157,7,1702
"8667","공도읍","공도읍제5투","대통령선거","경기도","안성시",3471,2438,983,448,585,202,196,8,1,3,0,1,0,0,1,2428,10,1033
"8668","공도읍","공도읍제6투","대통령선거","경기도","안성시",2941,1909,795,344,482,113,158,1,0,2,1,1,0,0,3,1900,9,1032
"8669","공도읍","공도읍제7투","대통령선거","경기도","안성시",4118,2475,868,583,661,140,195,8,0,3,0,5,2,0,1,2466,9,1643
"8670","공도읍","공도읍제8투","대통령선거","경기도","안성시",3473,2294,980,385,578,159,176,3,0,3,0,2,0,0,2,2288,6,1179
"8671","공도읍","공도읍제9투","대통령선거","경기도","안성시",1932,1348,577,229,340,95,92,1,0,2,0,2,0,2,3,1343,5,584
"8672","공도읍","공도읍제10투","대통령선거","경기도","안성시",3211,2164,929,348,545,149,175,3,1,0,0,1,2,0,1,2154,10,1047
"8673","공도읍","공도읍제11투","대통령선거","경기도","안성시",3890,2923,1408,413,658,197,232,1,1,0,0,4,1,0,3,2918,5,967
"8674","보개면","관내사전투표","대통령선거","경기도","안성시",953,953,388,246,185,67,59,2,0,1,0,1,0,2,0,951,2,0
"8675","보개면","보개면제1투","대통령선거","경기도","안성시",1197,696,205,219,189,33,41,1,0,0,0,2,0,2,0,692,4,501
"8676","보개면","보개면제2투","대통령선거","경기도","안성시",749,467,110,177,118,26,25,0,0,4,0,4,0,1,0,465,2,282
"8677","보개면","보개면제3투","대통령선거","경기도","안성시",1295,867,237,284,227,49,62,2,0,0,2,1,0,1,0,865,2,428
"8678","보개면","보개면제4투","대통령선거","경기도","안성시",817,531,90,272,123,22,18,0,0,0,0,1,1,0,2,529,2,286
"8679","금광면","관내사전투표","대통령선거","경기도","안성시",752,752,348,141,154,42,62,1,0,0,0,1,0,0,2,751,1,0
"8680","금광면","금광면제1투","대통령선거","경기도","안성시",1303,823,220,280,215,44,46,6,1,2,0,0,0,0,3,817,6,480
"8681","금광면","금광면제2투","대통령선거","경기도","안성시",651,441,117,169,110,20,20,1,1,0,0,1,0,0,0,439,2,210
"8682","금광면","금광면제3투","대통령선거","경기도","안성시",636,407,120,145,111,13,11,0,0,2,0,1,0,1,2,406,1,229
"8683","금광면","금광면제4투","대통령선거","경기도","안성시",545,352,77,135,90,24,18,1,0,0,0,2,0,2,0,349,3,193
"8684","금광면","금광면제5투","대통령선거","경기도","안성시",2356,1635,782,288,324,95,140,0,0,1,0,0,0,1,0,1631,4,721
"8685","서운면","관내사전투표","대통령선거","경기도","안성시",790,790,307,243,153,32,48,0,0,1,0,3,0,0,1,788,2,0
"8686","서운면","서운면제1투","대통령선거","경기도","안성시",1291,725,185,281,161,39,50,1,0,0,0,2,0,0,1,720,5,566
"8687","서운면","서운면제2투","대통령선거","경기도","안성시",553,379,66,164,103,20,20,3,0,0,0,0,0,2,0,378,1,174
"8688","서운면","서운면제3투","대통령선거","경기도","안성시",646,403,112,128,111,27,22,0,0,0,0,0,0,0,0,400,3,243
"8689","미양면","관내사전투표","대통령선거","경기도","안성시",842,842,348,200,176,39,62,0,3,1,2,3,3,0,1,838,4,0
"8690","미양면","미양면제1투","대통령선거","경기도","안성시",1538,930,267,330,223,42,53,4,0,0,0,0,1,4,0,924,6,608
"8691","미양면","미양면제2투","대통령선거","경기도","안성시",1977,1167,421,311,283,59,78,1,0,0,1,3,1,1,1,1160,7,810
"8692","미양면","미양면제3투","대통령선거","경기도","안성시",1072,657,143,257,176,26,40,4,1,2,0,0,2,0,0,651,6,415
"8693","대덕면","관내사전투표","대통령선거","경기도","안성시",1947,1947,895,350,429,116,142,6,1,1,1,1,0,1,0,1943,4,0
"8694","대덕면","대덕면제1투","대통령선거","경기도","안성시",1644,894,252,320,232,32,54,0,0,1,0,0,0,0,0,891,3,750
"8695","대덕면","대덕면제2투","대통령선거","경기도","안성시",1524,971,293,290,262,59,54,1,1,0,0,1,1,3,0,965,6,553
"8696","대덕면","대덕면제3투","대통령선거","경기도","안성시",3579,1534,546,408,383,86,99,3,0,0,0,2,0,1,4,1532,2,2045
"8697","대덕면","대덕면제4투","대통령선거","경기도","안성시",3684,2659,1109,450,632,204,241,7,1,1,1,4,0,1,3,2654,5,1025
"8698","양성면","관내사전투표","대통령선거","경기도","안성시",818,818,252,278,190,42,48,0,0,2,0,1,1,1,2,817,1,0
"8699","양성면","양성면제1투","대통령선거","경기도","안성시",1450,843,219,319,202,40,52,2,0,0,2,1,0,1,0,838,5,607
"8700","양성면","양성면제2투","대통령선거","경기도","안성시",1000,676,125,278,189,40,37,0,0,1,0,0,0,0,0,670,6,324
"8701","양성면","양성면제3투","대통령선거","경기도","안성시",1283,755,182,304,195,23,27,2,1,2,1,4,2,0,2,745,10,528
"8702","원곡면","관내사전투표","대통령선거","경기도","안성시",551,551,201,168,104,39,29,1,0,3,0,1,0,0,1,547,4,0
"8703","원곡면","원곡면제1투","대통령선거","경기도","안성시",1771,1038,258,373,287,58,53,1,0,0,0,1,1,0,1,1033,5,733
"8704","원곡면","원곡면제2투","대통령선거","경기도","안성시",912,610,262,129,150,35,32,0,0,0,0,0,0,1,1,610,0,302
"8705","원곡면","원곡면제3투","대통령선거","경기도","안성시",591,401,85,178,96,21,14,1,0,0,0,0,1,2,0,398,3,190
"8706","일죽면","관내사전투표","대통령선거","경기도","안성시",999,999,337,306,234,60,50,3,0,1,0,1,0,1,1,994,5,0
"8707","일죽면","일죽면제1투","대통령선거","경기도","안성시",1655,989,298,331,248,53,49,0,0,3,1,0,2,0,2,987,2,666
"8708","일죽면","일죽면제2투","대통령선거","경기도","안성시",1441,871,246,328,200,35,50,2,2,2,0,0,0,1,0,866,5,570
"8709","일죽면","일죽면제3투","대통령선거","경기도","안성시",1407,879,216,350,232,43,25,2,0,0,1,0,1,2,1,873,6,528
"8710","일죽면","일죽면제4투","대통령선거","경기도","안성시",948,601,115,253,189,22,16,0,0,0,0,0,0,0,1,596,5,347
"8711","죽산면","관내사전투표","대통령선거","경기도","안성시",1290,1290,434,399,265,60,102,6,0,2,2,2,0,2,1,1275,15,0
"8712","죽산면","죽산면제1투","대통령선거","경기도","안성시",2515,1538,377,618,385,72,66,2,1,1,1,1,1,2,0,1527,11,977
"8713","죽산면","죽산면제2투","대통령선거","경기도","안성시",1511,834,238,294,223,38,33,1,0,0,0,0,0,3,0,830,4,677
"8714","죽산면","죽산면제3투","대통령선거","경기도","안성시",759,441,103,155,139,17,25,0,0,0,0,1,0,0,0,440,1,318
"8715","삼죽면","관내사전투표","대통령선거","경기도","안성시",528,528,220,142,99,34,26,1,0,0,0,3,0,0,1,526,2,0
"8716","삼죽면","삼죽면제1투","대통령선거","경기도","안성시",1513,915,214,356,247,47,43,0,0,3,0,0,0,0,1,911,4,598
"8717","삼죽면","삼죽면제2투","대통령선거","경기도","안성시",890,543,147,174,146,36,33,2,0,1,0,0,0,0,0,539,4,347
"8718","고삼면","관내사전투표","대통령선거","경기도","안성시",548,548,213,134,131,31,30,1,0,0,1,3,1,1,0,546,2,0
"8719","고삼면","고삼면제1투","대통령선거","경기도","안성시",946,624,165,228,160,29,33,0,0,3,0,0,0,1,2,621,3,322
"8720","고삼면","고삼면제2투","대통령선거","경기도","안성시",474,312,106,102,73,12,14,1,0,0,0,0,1,0,1,310,2,162
"8721","안성1동","관내사전투표","대통령선거","경기도","안성시",2447,2447,950,651,484,137,200,1,0,2,1,5,0,0,3,2434,13,0
"8722","안성1동","안성1동제1투","대통령선거","경기도","안성시",1644,1030,293,340,263,53,71,3,0,1,0,0,0,0,2,1026,4,614
"8723","안성1동","안성1동제2투","대통령선거","경기도","안성시",2043,1412,454,420,346,83,91,3,1,1,2,5,0,0,1,1407,5,631
"8724","안성1동","안성1동제3투","대통령선거","경기도","안성시",2416,1510,470,502,358,64,92,5,0,3,0,3,0,1,1,1499,11,906
"8725","안성1동","안성1동제4투","대통령선거","경기도","안성시",1755,1070,297,369,265,60,66,1,1,1,1,1,0,2,1,1065,5,685
"8726","안성2동","관내사전투표","대통령선거","경기도","안성시",2915,2915,1271,570,619,164,263,2,0,1,0,8,1,0,2,2901,14,0
"8727","안성2동","안성2동제1투","대통령선거","경기도","안성시",3280,1991,639,592,491,113,140,3,0,0,0,3,1,0,1,1983,8,1289
"8728","안성2동","안성2동제2투","대통령선거","경기도","안성시",3979,2236,783,555,566,130,182,0,2,4,2,1,0,1,3,2229,7,1743
"8729","안성2동","안성2동제3투","대통령선거","경기도","안성시",3411,2330,897,498,590,152,177,5,0,1,1,3,1,0,1,2326,4,1081
"8730","안성2동","안성2동제4투","대통령선거","경기도","안성시",763,519,179,142,123,32,37,0,0,0,1,0,0,1,0,515,4,244
"8731","안성3동","관내사전투표","대통령선거","경기도","안성시",2878,2878,1294,496,590,190,281,1,1,1,1,5,0,0,2,2862,16,0
"8732","안성3동","안성3동제1투","대통령선거","경기도","안성시",1554,1029,333,284,254,63,86,0,0,2,0,1,0,2,3,1028,1,525
"8733","안성3동","안성3동제2투","대통령선거","경기도","안성시",1597,1144,418,263,289,77,94,0,0,0,0,2,0,0,0,1143,1,453
"8734","안성3동","안성3동제3투","대통령선거","경기도","안성시",1440,970,276,334,254,50,49,2,0,0,0,0,0,0,0,965,5,470
"8735","안성3동","안성3동제4투","대통령선거","경기도","안성시",2300,1500,479,449,387,68,103,2,1,0,0,1,0,0,1,1491,9,800
"8736","안성3동","안성3동제5투","대통령선거","경기도","안성시",2548,1699,633,399,417,115,128,0,1,3,0,2,0,0,1,1699,0,849
"8737","안성3동","안성3동제6투","대통령선거","경기도","안성시",1383,840,253,263,210,47,63,1,1,0,0,0,0,0,1,839,1,543
"8738","안성3동","안성3동제7투","대통령선거","경기도","안성시",1681,1201,438,292,278,86,95,1,1,0,0,3,0,1,5,1200,1,480
"8739","잘못 투입·구분된 투표지","잘못 투입·구분된 투표지","대통령선거","경기도","안성시",0,0,0,0,0,0,0,0,0,0,0,0,0,0,0,0,0,0
"8740","거소·선상투표","거소·선상투표","대통령선거","경기도","김포시",397,368,126,65,110,26,15,0,1,0,0,0,2,2,1,348,20,29
"8741","관외사전투표","관외사전투표","대통령선거","경기도","김포시",23246,23240,10522,3961,4946,1723,1830,36,12,11,11,18,8,8,31,23117,123,6
"8742","재외투표","재외투표","대통령선거","경기도","김포시",1994,1570,942,118,239,67,192,7,0,0,0,0,0,0,0,1565,5,424
"8743","통진읍","관내사전투표","대통령선거","경기도","김포시",3298,3298,1248,827,703,221,245,5,5,6,3,1,1,4,6,3275,23,0
"8744","통진읍","통진읍제1투","대통령선거","경기도","김포시",1981,1419,455,458,336,79,82,1,0,1,0,0,0,1,2,1415,4,562
"8745","통진읍","통진읍제2투","대통령선거","경기도","김포시",1574,885,242,305,222,58,54,0,0,0,0,0,0,0,0,881,4,689
"8746","통진읍","통진읍제3투","대통령선거","경기도","김포시",3032,1861,580,563,464,130,103,3,0,3,0,2,0,0,2,1850,11,1171
"8747","통진읍","통진읍제4투","대통령선거","경기도","김포시",1376,889,207,372,206,52,46,1,0,1,0,0,0,0,0,885,4,487
"8748","통진읍","통진읍제5투","대통령선거","경기도","김포시",1743,1066,294,353,270,65,71,2,0,0,0,0,1,0,2,1058,8,677
"8749","통진읍","통진읍제6투","대통령선거","경기도","김포시",2744,1621,437,535,434,102,99,2,0,0,1,3,1,0,1,1615,6,1123
"8750","통진읍","통진읍제7투","대통령선거","경기도","김포시",1808,913,283,288,220,57,55,2,1,0,0,0,0,1,0,907,6,895
"8751","통진읍","통진읍제8투","대통령선거","경기도","김포시",3197,1668,640,387,421,110,99,1,1,0,0,0,1,0,2,1662,6,1529
"8752","고촌읍","관내사전투표","대통령선거","경기도","김포시",4043,4043,1770,950,756,293,247,3,1,2,1,2,2,0,2,4029,14,0
"8753","고촌읍","고촌읍제1투","대통령선거","경기도","김포시",2377,1676,592,494,376,113,98,0,0,0,0,0,0,0,0,1673,3,701
"8754","고촌읍","고촌읍제2투","대통령선거","경기도","김포시",1504,1013,237,444,223,59,45,1,1,1,0,0,0,0,1,1012,1,491
"8755","고촌읍","고촌읍제3투","대통령선거","경기도","김포시",3486,2582,964,689,563,200,148,5,0,0,0,0,0,3,3,2575,7,904
"8756","고촌읍","고촌읍제4투","대통령선거","경기도","김포시",3054,1930,696,528,461,123,108,2,0,1,1,3,0,2,1,1926,4,1124
"8757","고촌읍","고촌읍제5투","대통령선거","경기도","김포시",2176,1697,721,379,369,131,89,1,0,0,1,2,2,0,0,1695,2,479
"8758","고촌읍","고촌읍제6투","대통령선거","경기도","김포시",2400,1909,702,466,412,177,144,6,0,0,0,0,0,0,2,1909,0,491
"8759","양촌읍","관내사전투표","대통령선거","경기도","김포시",3348,3348,1348,804,759,198,207,2,1,5,4,4,1,0,4,3337,11,0
"8760","양촌읍","양촌읍제1투","대통령선거","경기도","김포시",4049,2047,656,636,528,99,118,1,0,2,0,1,1,1,2,2045,2,2002
"8761","양촌읍","양촌읍제2투","대통령선거","경기도","김포시",2099,1325,437,370,359,73,72,4,1,3,0,1,1,0,2,1323,2,774
"8762","양촌읍","양촌읍제3투","대통령선거","경기도","김포시",1104,697,180,245,190,44,32,0,1,1,1,2,0,1,0,697,0,407
"8763","양촌읍","양촌읍제4투","대통령선거","경기도","김포시",3091,1950,753,412,530,122,118,2,0,4,1,0,0,0,2,1944,6,1141
"8764","양촌읍","양촌읍제5투","대통령선거","경기도","김포시",451,283,81,114,71,5,11,0,0,0,0,0,0,0,0,282,1,168
"8765","양촌읍","양촌읍제6투","대통령선거","경기도","김포시",261,171,40,63,38,14,13,1,0,0,0,0,0,1,0,170,1,90
"8766","양촌읍","양촌읍제7투","대통령선거","경기도","김포시",769,492,121,189,121,29,25,0,0,2,0,1,0,2,0,490,2,277
"8767","양촌읍","양촌읍제8투","대통령선거","경기도","김포시",2728,1661,695,342,389,115,106,2,0,1,1,1,0,0,1,1653,8,1067
"8768","양촌읍","양촌읍제9투","대통령선거","경기도","김포시",1926,1233,524,283,276,80,63,1,0,1,0,0,0,0,2,1230,3,693
"8769","대곶면","관내사전투표","대통령선거","경기도","김포시",1180,1180,408,361,265,66,67,1,0,2,2,1,2,1,4,1180,0,0
"8770","대곶면","대곶면제1투","대통령선거","경기도","김포시",2514,1360,350,484,372,74,63,3,0,0,1,0,0,2,0,1349,11,1154
"8771","대곶면","대곶면제2투","대통령선거","경기도","김포시",1661,1015,257,401,231,64,48,0,1,2,1,1,0,0,1,1007,8,646
"8772","대곶면","대곶면제3투","대통령선거","경기도","김포시",1021,606,152,218,149,36,42,4,1,0,0,0,0,1,0,603,3,415
"8773","대곶면","대곶면제4투","대통령선거","경기도","김포시",852,499,135,184,123,28,25,2,0,0,0,0,0,0,0,497,2,353
"8774","대곶면","대곶면제5투","대통령선거","경기도","김포시",984,589,128,234,165,44,12,1,0,2,0,1,0,0,1,588,1,395
"8775","월곶면","관내사전투표","대통령선거","경기도","김포시",1029,1029,336,329,220,68,54,2,0,2,1,4,0,0,4,1020,9,0
"8776","월곶면","월곶면제1투","대통령선거","경기도","김포시",1104,610,146,228,168,37,20,3,2,1,0,0,0,0,1,606,4,494
"8777","월곶면","월곶면제2투","대통령선거","경기도","김포시",489,324,73,132,70,19,20,0,0,0,2,1,0,1,1,319,5,165
"8778","월곶면","월곶면제3투","대통령선거","경기도","김포시",497,304,50,151,62,24,15,0,0,0,0,0,0,0,0,302,2,193
"8779","월곶면","월곶면제4투","대통령선거","경기도","김포시",1844,1053,268,408,234,75,51,4,1,2,0,1,1,1,2,1048,5,791
"8780","하성면","관내사전투표","대통령선거","경기도","김포시",1446,1446,461,450,356,88,76,0,0,2,0,2,1,0,3,1439,7,0
"8781","하성면","하성면제1투","대통령선거","경기도","김포시",2256,1215,324,439,294,61,87,2,0,0,1,1,1,1,1,1212,3,1041
"8782","하성면","하성면제2투","대통령선거","경기도","김포시",1005,656,152,264,185,31,21,0,0,0,0,0,1,1,0,655,1,349
"8783","하성면","하성면제3투","대통령선거","경기도","김포시",932,558,143,240,125,20,23,1,0,0,1,0,1,1,1,556,2,374
"8784","하성면","하성면제4투","대통령선거","경기도","김포시",1098,661,135,286,169,26,40,0,0,2,0,0,0,1,0,659,2,437
"8785","하성면","하성면제5투","대통령선거","경기도","김포시",540,339,83,135,83,23,12,0,0,0,0,0,0,1,0,337,2,201
"8786","김포본동","관내사전투표","대통령선거","경기도","김포시",4820,4820,2037,1134,974,321,323,6,0,1,2,2,0,2,4,4806,14,0
"8787","김포본동","김포본동제1투","대통령선거","경기도","김포시",2713,1606,584,404,414,82,113,3,0,0,0,2,1,0,0,1603,3,1107
"8788","김포본동","김포본동제2투","대통령선거","경기도","김포시",1052,736,270,192,184,47,38,0,0,2,0,0,0,0,1,734,2,316
"8789","김포본동","김포본동제3투","대통령선거","경기도","김포시",1311,750,238,259,169,49,29,1,0,1,0,2,0,0,0,748,2,561
"8790","김포본동","김포본동제4투","대통령선거","경기도","김포시",1793,1126,384,307,272,88,65,1,0,3,0,2,0,1,1,1124,2,667
"8791","김포본동","김포본동제5투","대통령선거","경기도","김포시",2735,2046,754,487,480,162,148,1,0,2,0,3,0,0,1,2038,8,689
"8792","김포본동","김포본동제6투","대통령선거","경기도","김포시",2575,1863,689,459,457,125,113,4,0,0,0,4,1,0,1,1853,10,712
"8793","김포본동","김포본동제7투","대통령선거","경기도","김포시",2349,1699,631,386,449,95,121,2,0,1,0,4,1,2,0,1692,7,650
"8794","김포본동","김포본동제8투","대통령선거","경기도","김포시",1403,1060,444,215,261,64,72,0,0,2,0,0,1,1,0,1060,0,343
"8795","김포본동","김포본동제9투","대통령선거","경기도","김포시",2880,2124,811,507,503,142,146,7,0,0,0,0,1,1,0,2118,6,756
"8796","김포본동","김포본동제10투","대통령선거","경기도","김포시",3377,2643,1095,549,603,200,178,3,0,2,0,2,0,1,0,2633,10,734
"8797","김포본동","김포본동제11투","대통령선거","경기도","김포시",3042,2379,978,479,575,172,164,4,0,1,0,1,0,0,1,2375,4,663
"8798","김포본동","김포본동제12투","대통령선거","경기도","김포시",4010,2883,1098,652,704,221,192,6,0,0,0,1,0,0,1,2875,8,1127
"8799","김포본동","김포본동제13투","대통령선거","경기도","김포시",2032,1592,718,242,384,135,104,2,0,0,1,0,0,0,0,1586,6,440
"8800","장기본동","관내사전투표","대통령선거","경기도","김포시",4286,4286,1986,832,905,278,259,5,0,2,0,1,1,1,3,4273,13,0
"8801","장기본동","장기본동제1투","대통령선거","경기도","김포시",2380,1783,575,554,421,141,84,3,0,0,0,0,0,0,2,1780,3,597
"8802","장기본동","장기본동제2투","대통령선거","경기도","김포시",3008,1978,713,492,479,162,112,6,1,0,0,4,0,0,1,1970,8,1030
"8803","장기본동","장기본동제3투","대통령선거","경기도","김포시",1543,1079,450,210,268,76,70,0,0,0,0,0,2,0,1,1077,2,464
"8804","장기본동","장기본동제4투","대통령선거","경기도","김포시",3267,2381,1184,302,530,199,155,3,0,0,0,0,1,1,4,2379,2,886
"8805","장기본동","장기본동제5투","대통령선거","경기도","김포시",2482,1915,987,261,407,131,121,1,0,1,0,0,1,0,2,1912,3,567
"8806","장기본동","장기본동제6투","대통령선거","경기도","김포시",3219,2518,1305,330,502,205,171,0,0,1,0,0,0,0,1,2515,3,701
"8807","장기본동","장기본동제7투","대통령선거","경기도","김포시",2969,2266,1034,374,534,158,153,5,0,0,0,1,1,0,1,2261,5,703
"8808","사우동","관내사전투표","대통령선거","경기도","김포시",5945,5944,2620,1068,1257,466,482,8,1,2,1,13,1,1,4,5924,20,1
"8809","사우동","사우동제1투","대통령선거","경기도","김포시",2740,1436,544,374,312,88,101,2,0,1,3,3,0,1,1,1430,6,1304
"8810","사우동","사우동제2투","대통령선거","경기도","김포시",2384,1417,523,334,372,71,105,0,0,1,0,2,1,1,1,1411,6,967
"8811","사우동","사우동제3투","대통령선거","경기도","김포시",3126,2389,957,543,534,180,158,2,0,2,0,2,0,0,3,2381,8,737
"8812","사우동","사우동제4투","대통령선거","경기도","김포시",1645,1027,388,247,256,71,54,0,0,1,0,0,0,1,1,1019,8,618
"8813","사우동","사우동제5투","대통령선거","경기도","김포시",2930,2073,821,443,494,158,136,4,0,1,0,2,0,0,1,2060,13,857
"8814","풍무동","관내사전투표","대통령선거","경기도","김포시",6235,6235,3068,1047,1208,414,462,10,0,2,2,8,1,1,1,6224,11,0
"8815","풍무동","풍무동제1투","대통령선거","경기도","김포시",2542,1749,749,372,407,116,93,5,2,1,0,0,0,0,1,1746,3,793
"8816","풍무동","풍무동제2투","대통령선거","경기도","김포시",1546,1101,368,321,279,70,55,3,0,1,0,2,0,0,1,1100,1,445
"8817","풍무동","풍무동제3투","대통령선거","경기도","김포시",2936,2215,800,600,505,159,135,7,0,2,0,0,0,0,1,2209,6,721
"8818","풍무동","풍무동제4투","대통령선거","경기도","김포시",2395,1753,739,346,439,113,109,0,0,1,1,2,0,2,1,1753,0,642
"8819","풍무동","풍무동제5투","대통령선거","경기도","김포시",2487,1961,778,453,436,136,140,4,0,2,1,2,1,1,1,1955,6,526
"8820","풍무동","풍무동제6투","대통령선거","경기도","김포시",2494,1876,722,394,491,125,128,1,0,1,0,3,0,2,1,1868,8,618
"8821","풍무동","풍무동제7투","대통령선거","경기도","김포시",3357,2645,1179,527,592,148,170,5,1,1,2,7,0,1,1,2634,11,712
"8822","풍무동","풍무동제8투","대통령선거","경기도","김포시",2720,2027,798,522,450,131,117,3,0,0,1,0,0,0,0,2022,5,693
"8823","풍무동","풍무동제9투","대통령선거","경기도","김포시",2885,2203,1055,326,481,170,155,5,0,0,0,2,0,2,1,2197,6,682
"8824","풍무동","풍무동제10투","대통령선거","경기도","김포시",1271,945,316,259,259,69,38,1,0,1,0,0,0,1,0,944,1,326
"8825","풍무동","풍무동제11투","대통령선거","경기도","김포시",4628,3863,1807,598,921,302,221,8,0,1,0,1,0,0,0,3859,4,765
"8826","장기동","관내사전투표","대통령선거","경기도","김포시",6265,6265,3212,970,1153,457,438,7,1,2,0,3,0,2,5,6250,15,0
"8827","장기동","장기동제1투","대통령선거","경기도","김포시",3100,2290,1064,388,514,146,161,4,0,7,0,1,0,0,0,2285,5,810
"8828","장기동","장기동제2투","대통령선거","경기도","김포시",2882,2197,939,430,534,168,117,3,0,0,0,0,0,0,1,2192,5,685
"8829","장기동","장기동제3투","대통령선거","경기도","김포시",2403,1489,559,395,351,89,81,1,0,1,0,1,2,0,2,1482,7,914
"8830","장기동","장기동제4투","대통령선거","경기도","김포시",2600,2085,975,340,451,166,143,1,1,1,0,1,1,0,1,2081,4,515
"8831","장기동","장기동제5투","대통령선거","경기도","김포시",3550,2680,1102,590,599,197,182,3,0,0,0,0,0,0,1,2674,6,870
"8832","장기동","장기동제6투","대통령선거","경기도","김포시",3259,1943,844,403,460,118,110,2,0,1,0,0,0,0,2,1940,3,1316
"8833","장기동","장기동제7투","대통령선거","경기도","김포시",2158,1657,756,283,374,135,103,0,0,1,0,1,1,0,0,1654,3,501
"8834","장기동","장기동제8투","대통령선거","경기도","김포시",2258,1819,921,214,432,147,99,1,1,0,0,0,0,0,0,1815,4,439
"8835","장기동","장기동제9투","대통령선거","경기도","김포시",2233,1822,924,212,430,143,107,3,0,1,0,0,0,0,0,1820,2,411
"8836","구래동","관내사전투표","대통령선거","경기도","김포시",4309,4308,2283,594,842,266,300,5,0,1,2,1,2,0,2,4298,10,1
"8837","구래동","구래동제1투","대통령선거","경기도","김포시",1817,1294,516,228,344,116,84,1,0,1,0,1,1,0,0,1292,2,523
"8838","구래동","구래동제2투","대통령선거","경기도","김포시",3598,2519,1124,415,627,177,166,3,0,0,0,0,0,1,1,2514,5,1079
"8839","구래동","구래동제3투","대통령선거","경기도","김포시",2692,1821,739,416,459,88,102,4,0,3,2,2,1,0,1,1817,4,871
"8840","구래동","구래동제4투","대통령선거","경기도","김포시",2448,1869,895,289,455,100,119,7,0,1,0,1,1,0,0,1868,1,579
"8841","구래동","구래동제5투","대통령선거","경기도","김포시",2778,2154,1126,292,446,144,144,0,0,0,0,0,0,0,2,2154,0,624
"8842","구래동","구래동제6투","대통령선거","경기도","김포시",3566,2564,1248,353,622,166,162,2,2,4,0,2,1,0,1,2563,1,1002
"8843","구래동","구래동제7투","대통령선거","경기도","김포시",2210,1490,551,419,338,84,86,1,0,3,0,0,2,1,1,1486,4,720
"8844","운양동","관내사전투표","대통령선거","경기도","김포시",4367,4367,2181,653,854,363,293,3,1,1,0,2,1,1,3,4356,11,0
"8845","운양동","운양동제1투","대통령선거","경기도","김포시",1282,947,384,212,228,72,48,1,0,0,0,1,0,0,0,946,1,335
"8846","운양동","운양동제2투","대통령선거","경기도","김포시",1274,801,343,177,177,50,49,1,0,0,0,1,0,1,0,799,2,473
"8847","운양동","운양동제3투","대통령선거","경기도","김포시",3566,2672,1152,518,648,200,138,5,0,1,1,3,0,1,1,2668,4,894
"8848","운양동","운양동제4투","대통령선거","경기도","김포시",1963,1566,794,167,387,123,90,0,0,0,0,0,0,1,1,1563,3,397
"8849","운양동","운양동제5투","대통령선거","경기도","김포시",1945,1587,739,234,395,133,82,1,0,1,0,0,2,0,0,1587,0,358
"8850","운양동","운양동제6투","대통령선거","경기도","김포시",2672,2178,1035,313,530,177,112,5,0,1,0,0,0,0,2,2175,3,494
"8851","잘못 투입·구분된 투표지","잘못 투입·구분된 투표지","대통령선거","경기도","김포시",0,0,0,0,0,0,0,0,0,0,0,0,0,0,0,0,0,0
"8852","거소·선상투표","거소·선상투표","대통령선거","경기도","광주시",484,458,166,64,114,30,12,6,2,1,2,1,2,6,4,410,48,26
"8853","관외사전투표","관외사전투표","대통령선거","경기도","광주시",27677,27677,12856,4557,5693,2085,2190,33,5,16,6,30,13,8,49,27541,136,0
"8854","재외투표","재외투표","대통령선거","경기도","광주시",1648,1303,818,81,202,57,134,5,0,0,0,1,1,0,1,1300,3,345
"8855","오포읍","관내사전투표","대통령선거","경기도","광주시",6281,6281,3046,1093,1314,386,409,8,0,4,2,3,2,0,6,6273,8,0
"8856","오포읍","오포읍제1투","대통령선거","경기도","광주시",1589,1100,406,263,276,79,68,2,0,1,0,1,0,0,3,1099,1,489
"8857","오포읍","오포읍제2투","대통령선거","경기도","광주시",4447,3104,1244,619,801,213,203,3,2,0,2,4,2,2,4,3099,5,1343
"8858","오포읍","오포읍제3투","대통령선거","경기도","광주시",2980,1933,794,425,441,146,117,2,0,0,0,4,0,0,0,1929,4,1047
"8859","오포읍","오포읍제4투","대통령선거","경기도","광주시",2094,1488,577,316,395,85,100,3,1,1,0,1,0,2,2,1483,5,606
"8860","오포읍","오포읍제5투","대통령선거","경기도","광주시",3185,2121,744,528,572,134,125,2,0,3,1,1,0,2,2,2114,7,1064
"8861","오포읍","오포읍제6투","대통령선거","경기도","광주시",4320,2930,1274,621,653,188,175,3,0,2,1,0,0,0,2,2919,11,1390
"8862","오포읍","오포읍제7투","대통령선거","경기도","광주시",2678,1867,796,359,438,154,110,3,0,0,0,1,0,0,2,1863,4,811
"8863","오포읍","오포읍제8투","대통령선거","경기도","광주시",3584,2670,1192,483,610,189,188,1,0,0,0,3,0,0,2,2668,2,914
"8864","오포읍","오포읍제9투","대통령선거","경기도","광주시",4096,2891,1152,709,624,193,196,10,0,0,1,3,0,0,1,2889,2,1205
"8865","오포읍","오포읍제10투","대통령선거","경기도","광주시",4700,3063,1090,801,782,176,186,6,2,1,2,1,1,1,2,3051,12,1637
"8866","오포읍","오포읍제11투","대통령선거","경기도","광주시",6368,4312,1995,752,954,319,261,5,1,0,0,4,1,3,3,4298,14,2056
"8867","오포읍","오포읍제12투","대통령선거","경기도","광주시",2389,1779,727,392,457,108,84,4,0,1,0,2,0,1,1,1777,2,610
"8868","오포읍","오포읍제13투","대통령선거","경기도","광주시",2371,1809,787,325,445,111,121,4,0,1,0,3,0,1,4,1802,7,562
"8869","오포읍","오포읍제14투","대통령선거","경기도","광주시",3283,1947,652,545,500,122,117,0,0,2,1,2,0,1,0,1942,5,1336
"8870","오포읍","오포읍제15투","대통령선거","경기도","광주시",4051,2778,1161,608,621,202,162,1,2,2,1,2,1,0,5,2768,10,1273
"8871","오포읍","오포읍제16투","대통령선거","경기도","광주시",4458,2994,1297,584,688,218,195,1,0,0,1,1,0,0,2,2987,7,1464
"8872","오포읍","오포읍제17투","대통령선거","경기도","광주시",2163,1574,638,375,346,118,91,2,0,0,0,0,0,0,1,1571,3,589
"8873","초월읍","관내사전투표","대통령선거","경기도","광주시",5011,5011,2319,912,1105,298,338,13,1,2,1,3,1,1,6,5000,11,0
"8874","초월읍","초월읍제1투","대통령선거","경기도","광주시",4099,2587,923,679,680,137,148,3,1,1,1,2,3,2,3,2583,4,1512
"8875","초월읍","초월읍제2투","대통령선거","경기도","광주시",2620,1904,793,382,474,120,122,3,1,1,0,0,0,0,1,1897,7,716
"8876","초월읍","초월읍제3투","대통령선거","경기도","광주시",2722,1929,735,445,504,125,108,2,0,0,0,1,0,1,1,1922,7,793
"8877","초월읍","초월읍제4투","대통령선거","경기도","광주시",4349,3009,1138,713,747,193,191,12,1,2,0,3,0,1,2,3003,6,1340
"8878","초월읍","초월읍제5투","대통령선거","경기도","광주시",2527,1537,457,565,356,70,76,0,0,5,0,0,0,1,2,1532,5,990
"8879","초월읍","초월읍제6투","대통령선거","경기도","광주시",3587,2243,805,639,520,138,120,2,1,3,2,2,1,0,3,2236,7,1344
"8880","초월읍","초월읍제7투","대통령선거","경기도","광주시",1700,1078,281,414,257,58,64,0,0,0,0,2,1,0,0,1077,1,622
"8881","초월읍","초월읍제8투","대통령선거","경기도","광주시",3659,2692,1119,545,690,148,168,5,2,0,1,1,0,1,4,2684,8,967
"8882","곤지암읍","관내사전투표","대통령선거","경기도","광주시",2875,2875,1192,659,614,177,209,5,0,4,3,0,1,0,2,2866,9,0
"8883","곤지암읍","곤지암읍제1투","대통령선거","경기도","광주시",3430,2180,768,562,559,142,123,5,0,0,0,2,2,1,6,2170,10,1250
"8884","곤지암읍","곤지암읍제2투","대통령선거","경기도","광주시",3294,1846,559,608,458,111,90,5,0,2,0,0,0,0,5,1838,8,1448
"8885","곤지암읍","곤지암읍제3투","대통령선거","경기도","광주시",2068,1291,318,511,314,68,64,4,0,1,1,1,1,0,1,1284,7,777
"8886","곤지암읍","곤지암읍제4투","대통령선거","경기도","광주시",2203,1362,321,595,291,61,58,6,1,2,2,1,3,3,0,1344,18,841
"8887","곤지암읍","곤지암읍제5투","대통령선거","경기도","광주시",4068,2625,985,614,664,174,167,2,0,1,0,1,0,1,3,2612,13,1443
"8888","도척면","관내사전투표","대통령선거","경기도","광주시",1214,1214,485,302,291,65,58,5,0,0,0,1,0,0,1,1208,6,0
"8889","도척면","도척면제1투","대통령선거","경기도","광주시",2647,1649,545,502,417,79,87,4,1,1,0,0,2,1,4,1643,6,998
"8890","도척면","도척면제2투","대통령선거","경기도","광주시",1957,1289,374,415,342,86,63,1,1,0,1,0,1,0,0,1284,5,668
"8891","도척면","도척면제3투","대통령선거","경기도","광주시",1242,788,189,358,162,34,35,0,0,0,0,2,0,0,0,780,8,454
"8892","퇴촌면","관내사전투표","대통령선거","경기도","광주시",1734,1734,665,462,407,90,97,2,0,1,0,3,0,1,1,1729,5,0
"8893","퇴촌면","퇴촌면제1투","대통령선거","경기도","광주시",2740,1758,496,635,454,71,86,4,1,0,1,1,0,1,2,1752,6,982
"8894","퇴촌면","퇴촌면제2투","대통령선거","경기도","광주시",2706,1753,572,558,455,66,88,1,0,2,0,1,0,3,2,1748,5,953
"8895","퇴촌면","퇴촌면제3투","대통령선거","경기도","광주시",3195,2088,602,744,504,131,91,3,1,0,0,3,1,0,1,2081,7,1107
"8896","남종면","관내사전투표","대통령선거","경기도","광주시",241,241,79,77,54,17,14,0,0,0,0,0,0,0,0,241,0,0
"8897","남종면","남종면제1투","대통령선거","경기도","광주시",564,384,71,214,72,14,11,0,0,0,0,0,0,0,0,382,2,180
"8898","남종면","남종면제2투","대통령선거","경기도","광주시",319,225,30,139,39,6,7,1,0,0,1,0,0,0,1,224,1,94
"8899","남종면","남종면제3투","대통령선거","경기도","광주시",215,148,31,73,23,8,12,0,0,0,0,0,0,0,0,147,1,67
"8900","남한산성면","관내사전투표","대통령선거","경기도","광주시",377,377,178,85,76,14,22,1,0,0,0,0,0,0,0,376,1,0
"8901","남한산성면","남한산성면제1투","대통령선거","경기도","광주시",667,422,101,194,85,20,18,1,0,0,0,0,0,0,0,419,3,245
"8902","남한산성면","남한산성면제2투","대통령선거","경기도","광주시",654,521,201,150,114,21,30,0,0,0,0,1,1,0,0,518,3,133
"8903","남한산성면","남한산성면제3투","대통령선거","경기도","광주시",618,425,116,159,104,23,19,2,0,0,0,1,0,0,0,424,1,193
"8904","경안동","관내사전투표","대통령선거","경기도","광주시",4712,4712,2058,892,1030,322,363,4,1,3,0,6,1,1,8,4689,23,0
"8905","경안동","경안동제1투","대통령선거","경기도","광주시",1753,1156,381,341,278,70,76,0,0,1,0,2,3,0,1,1153,3,597
"8906","경안동","경안동제2투","대통령선거","경기도","광주시",2340,1364,478,342,366,88,76,1,0,1,1,1,2,1,1,1358,6,976
"8907","경안동","경안동제3투","대통령선거","경기도","광주시",1472,710,201,264,173,31,34,2,1,0,0,1,0,0,1,708,2,762
"8908","경안동","경안동제4투","대통령선거","경기도","광주시",3523,2180,772,511,555,159,157,5,1,3,1,2,1,0,1,2168,12,1343
"8909","경안동","경안동제5투","대통령선거","경기도","광주시",5277,3706,1519,750,902,271,233,9,0,2,1,8,2,1,0,3698,8,1571
"8910","경안동","경안동제6투","대통령선거","경기도","광주시",4846,2992,1200,646,736,188,201,2,0,1,0,2,0,0,3,2979,13,1854
"8911","경안동","경안동제7투","대통령선거","경기도","광주시",3583,2717,1058,639,662,194,152,6,0,0,0,2,0,0,1,2714,3,866
"8912","경안동","경안동제8투","대통령선거","경기도","광주시",2501,1606,589,334,456,102,114,2,0,1,1,0,0,1,1,1601,5,895
"8913","송정동","관내사전투표","대통령선거","경기도","광주시",5937,5937,2597,1292,1214,361,432,6,1,5,2,10,1,0,4,5925,12,0
"8914","송정동","송정동제1투","대통령선거","경기도","광주시",3699,2335,920,462,632,143,160,1,0,1,0,5,0,0,2,2326,9,1364
"8915","송정동","송정동제2투","대통령선거","경기도","광주시",3258,2515,886,645,599,199,164,3,0,2,0,2,1,0,3,2504,11,743
"8916","송정동","송정동제3투","대통령선거","경기도","광주시",3329,2258,754,641,606,114,125,2,1,5,0,3,0,0,2,2253,5,1071
"8917","송정동","송정동제4투","대통령선거","경기도","광주시",2924,1831,609,591,398,121,88,0,0,1,1,1,5,0,6,1821,10,1093
"8918","송정동","송정동제5투","대통령선거","경기도","광주시",2487,1611,581,420,384,95,112,4,0,4,0,1,2,1,2,1606,5,876
"8919","송정동","송정동제6투","대통령선거","경기도","광주시",4658,2856,1074,695,696,187,180,4,0,0,0,1,0,0,8,2845,11,1802
"8920","송정동","송정동제7투","대통령선거","경기도","광주시",5030,3316,1265,717,866,209,232,4,0,0,1,9,3,1,3,3310,6,1714
"8921","송정동","송정동제8투","대통령선거","경기도","광주시",3994,2369,883,553,602,154,163,1,1,0,1,0,0,1,3,2362,7,1625
"8922","송정동","송정동제9투","대통령선거","경기도","광주시",2133,1624,672,341,420,90,91,0,0,1,0,0,1,2,0,1618,6,509
"8923","송정동","송정동제10투","대통령선거","경기도","광주시",1631,1322,549,228,346,101,89,2,0,1,0,1,0,0,2,1319,3,309
"8924","송정동","송정동제11투","대통령선거","경기도","광주시",3189,1913,754,425,490,114,118,3,0,2,0,1,1,0,0,1908,5,1276
"8925","광남동","관내사전투표","대통령선거","경기도","광주시",4991,4991,2404,878,1083,231,369,5,1,0,0,5,1,2,5,4984,7,0
"8926","광남동","광남동제1투","대통령선거","경기도","광주시",2570,1706,618,393,463,106,114,0,0,0,0,1,0,0,2,1697,9,864
"8927","광남동","광남동제2투","대통령선거","경기도","광주시",3836,2990,1260,622,723,176,187,3,0,0,0,3,0,1,5,2980,10,846
"8928","광남동","광남동제3투","대통령선거","경기도","광주시",4117,2572,965,628,684,122,155,3,0,0,0,3,1,0,2,2563,9,1545
"8929","광남동","광남동제4투","대통령선거","경기도","광주시",4059,2428,918,583,615,142,146,1,1,3,0,7,0,1,2,2419,9,1631
"8930","광남동","광남동제5투","대통령선거","경기도","광주시",3239,2079,759,528,535,110,131,2,1,0,0,1,1,2,1,2071,8,1160
"8931","광남동","광남동제6투","대통령선거","경기도","광주시",2638,2062,903,397,499,121,138,0,0,0,0,0,1,0,0,2059,3,576
"8932","광남동","광남동제7투","대통령선거","경기도","광주시",1417,1142,476,253,278,76,56,0,0,0,0,0,0,0,0,1139,3,275
"8933","광남동","광남동제8투","대통령선거","경기도","광주시",2513,1526,580,372,394,79,83,2,0,0,1,2,0,1,2,1516,10,987
"8934","광남동","광남동제9투","대통령선거","경기도","광주시",2358,1431,632,237,386,75,93,1,0,1,0,1,0,0,1,1427,4,927
"8935","잘못 투입·구분된 투표지","잘못 투입·구분된 투표지","대통령선거","경기도","광주시",0,0,0,0,0,0,0,0,0,0,0,0,0,0,0,0,0,0
"8936","거소·선상투표","거소·선상투표","대통령선거","경기도","포천시",453,427,114,81,126,26,19,1,3,7,1,5,0,1,5,389,38,26
"8937","관외사전투표","관외사전투표","대통령선거","경기도","포천시",9391,9391,3801,1895,2064,746,751,11,2,2,3,5,5,4,31,9320,71,0
"8938","재외투표","재외투표","대통령선거","경기도","포천시",504,384,202,40,62,14,61,1,0,0,0,1,1,0,0,382,2,120
"8939","소흘읍","관내사전투표","대통령선거","경기도","포천시",5960,5960,2366,1433,1278,390,431,3,2,6,3,7,1,2,9,5931,29,0
"8940","소흘읍","소흘읍제1투","대통령선거","경기도","포천시",3743,1939,606,578,507,122,102,5,0,0,0,6,0,0,0,1926,13,1804
"8941","소흘읍","소흘읍제2투","대통령선거","경기도","포천시",1523,969,252,354,274,50,32,3,0,0,0,0,0,0,2,967,2,554
"8942","소흘읍","소흘읍제3투","대통령선거","경기도","포천시",2145,1566,443,577,370,95,73,0,0,1,0,2,0,0,0,1561,5,579
"8943","소흘읍","소흘읍제4투","대통령선거","경기도","포천시",1968,1175,300,466,293,51,55,1,1,0,1,0,1,0,1,1170,5,793
"8944","소흘읍","소흘읍제5투","대통령선거","경기도","포천시",3476,2421,849,549,687,167,151,0,0,0,0,4,0,3,1,2411,10,1055
"8945","소흘읍","소흘읍제6투","대통령선거","경기도","포천시",3119,1817,639,463,463,117,126,0,2,1,1,1,0,1,1,1815,2,1302
"8946","소흘읍","소흘읍제7투","대통령선거","경기도","포천시",2549,1449,553,346,353,105,77,1,1,1,2,1,1,3,2,1446,3,1100
"8947","소흘읍","소흘읍제8투","대통령선거","경기도","포천시",2907,1752,567,488,413,137,132,1,0,1,0,0,0,1,3,1743,9,1155
"8948","소흘읍","소흘읍제9투","대통령선거","경기도","포천시",3232,2208,808,454,588,166,162,4,1,3,0,5,3,1,3,2198,10,1024
"8949","소흘읍","소흘읍제10투","대통령선거","경기도","포천시",2561,1628,607,323,460,104,120,0,0,2,0,3,0,0,1,1620,8,933
"8950","소흘읍","소흘읍제11투","대통령선거","경기도","포천시",1131,714,237,191,178,51,45,1,0,0,1,1,0,0,3,708,6,417
"8951","군내면","관내사전투표","대통령선거","경기도","포천시",863,863,248,284,184,58,55,2,1,1,1,6,0,2,0,842,21,0
"8952","군내면","군내면제1투","대통령선거","경기도","포천시",1772,985,200,390,266,67,52,2,0,0,0,1,0,3,0,981,4,787
"8953","군내면","군내면제2투","대통령선거","경기도","포천시",933,618,168,218,166,39,20,0,0,0,0,1,0,0,0,612,6,315
"8954","군내면","군내면제3투","대통령선거","경기도","포천시",1617,1061,215,438,284,60,49,5,1,0,1,0,2,1,1,1057,4,556
"8955","내촌면","관내사전투표","대통령선거","경기도","포천시",695,695,254,217,146,31,37,1,0,0,0,2,0,0,1,689,6,0
"8956","내촌면","내촌면제1투","대통령선거","경기도","포천시",2029,1196,263,527,299,55,45,2,0,1,0,1,0,0,0,1193,3,833
"8957","내촌면","내촌면제2투","대통령선거","경기도","포천시",614,362,72,163,95,16,13,0,0,0,0,0,1,0,0,360,2,252
"8958","내촌면","내촌면제3투","대통령선거","경기도","포천시",931,629,146,297,123,17,20,0,0,1,0,1,0,2,3,610,19,302
"8959","가산면","관내사전투표","대통령선거","경기도","포천시",1148,1148,395,373,244,72,53,2,0,0,1,0,1,2,1,1144,4,0
"8960","가산면","가산면제1투","대통령선거","경기도","포천시",2433,1352,353,497,347,79,68,0,1,1,1,0,2,1,0,1350,2,1081
"8961","가산면","가산면제2투","대통령선거","경기도","포천시",1740,1045,247,383,304,43,52,3,0,1,2,0,1,2,1,1039,6,695
"8962","가산면","가산면제3투","대통령선거","경기도","포천시",1487,886,188,375,223,50,41,1,0,3,0,1,0,0,2,884,2,601
"8963","신북면","관내사전투표","대통령선거","경기도","포천시",1453,1453,487,420,342,84,97,2,0,1,1,4,0,2,4,1444,9,0
"8964","신북면","신북면제1투","대통령선거","경기도","포천시",1746,1053,265,382,271,61,65,1,1,1,0,0,1,0,1,1049,4,693
"8965","신북면","신북면제2투","대통령선거","경기도","포천시",2851,1544,387,582,382,78,93,4,0,1,0,4,3,1,2,1537,7,1307
"8966","신북면","신북면제3투","대통령선거","경기도","포천시",1500,991,202,411,269,56,37,4,1,1,0,0,0,4,0,985,6,509
"8967","신북면","신북면제4투","대통령선거","경기도","포천시",797,500,86,248,132,12,15,0,0,1,0,0,0,2,2,498,2,297
"8968","신북면","신북면제5투","대통령선거","경기도","포천시",1687,998,263,321,258,76,72,1,0,0,0,2,0,0,1,994,4,689
"8969","창수면","관내사전투표","대통령선거","경기도","포천시",303,303,101,111,59,12,15,0,1,0,0,0,0,1,0,300,3,0
"8970","창수면","창수면제1투","대통령선거","경기도","포천시",915,615,110,297,157,25,15,3,1,1,0,4,0,0,0,613,2,300
"8971","창수면","창수면제2투","대통령선거","경기도","포천시",734,500,107,196,134,29,25,0,0,1,1,1,0,0,2,496,4,234
"8972","영중면","관내사전투표","대통령선거","경기도","포천시",697,697,224,211,149,55,51,0,0,0,0,4,0,0,0,694,3,0
"8973","영중면","영중면제1투","대통령선거","경기도","포천시",833,540,129,232,125,22,25,3,0,1,0,1,2,0,0,540,0,293
"8974","영중면","영중면제2투","대통령선거","경기도","포천시",1534,920,219,374,233,50,39,0,0,0,1,0,1,0,1,918,2,614
"8975","영중면","영중면제3투","대통령선거","경기도","포천시",551,393,67,168,104,22,24,1,0,1,1,0,0,1,0,389,4,158
"8976","영중면","영중면제4투","대통령선거","경기도","포천시",868,522,110,221,128,35,22,0,0,1,0,1,1,0,2,521,1,346
"8977","일동면","관내사전투표","대통령선거","경기도","포천시",1250,1250,411,353,300,89,78,2,1,0,0,2,0,1,3,1240,10,0
"8978","일동면","일동면제1투","대통령선거","경기도","포천시",2003,1079,277,387,291,52,58,2,0,3,0,2,0,0,1,1073,6,924
"8979","일동면","일동면제2투","대통령선거","경기도","포천시",388,253,39,128,61,11,8,2,0,0,0,0,0,0,2,251,2,135
"8980","일동면","일동면제3투","대통령선거","경기도","포천시",1135,712,152,296,200,34,25,0,0,0,0,1,0,0,1,709,3,423
"8981","일동면","일동면제4투","대통령선거","경기도","포천시",2159,1362,312,468,378,108,76,1,1,0,2,3,1,0,3,1353,9,797
"8982","일동면","일동면제5투","대통령선거","경기도","포천시",563,378,99,118,110,28,15,0,0,0,0,0,2,0,0,372,6,185
"8983","일동면","일동면제6투","대통령선거","경기도","포천시",760,446,102,206,106,12,15,0,0,0,0,0,0,2,0,443,3,314
"8984","이동면","관내사전투표","대통령선거","경기도","포천시",920,920,275,266,230,92,42,0,1,1,0,0,1,1,2,911,9,0
"8985","이동면","이동면제1투","대통령선거","경기도","포천시",1359,809,206,318,195,57,29,0,0,0,0,0,0,1,2,808,1,550
"8986","이동면","이동면제2투","대통령선거","경기도","포천시",657,398,80,160,119,17,16,1,1,1,0,1,0,0,0,396,2,259
"8987","이동면","이동면제3투","대통령선거","경기도","포천시",689,453,110,185,126,17,9,2,0,0,1,0,0,0,1,451,2,236
"8988","이동면","이동면제4투","대통령선거","경기도","포천시",1287,872,233,265,267,54,43,0,0,0,1,1,1,0,1,866,6,415
"8989","영북면","관내사전투표","대통령선거","경기도","포천시",1220,1220,383,312,305,100,96,0,0,0,0,1,1,2,3,1203,17,0
"8990","영북면","영북면제1투","대통령선거","경기도","포천시",1879,1024,225,426,276,44,32,1,0,4,0,1,0,1,3,1013,11,855
"8991","영북면","영북면제2투","대통령선거","경기도","포천시",640,435,89,204,103,16,18,0,0,0,0,0,0,1,2,433,2,205
"8992","영북면","영북면제3투","대통령선거","경기도","포천시",1461,925,230,257,291,87,51,1,1,1,0,1,0,1,1,922,3,536
"8993","영북면","영북면제4투","대통령선거","경기도","포천시",237,144,27,55,50,6,4,0,0,2,0,0,0,0,0,144,0,93
"8994","영북면","영북면제5투","대통령선거","경기도","포천시",988,622,139,240,162,33,35,1,0,1,2,2,1,1,0,617,5,366
"8995","영북면","영북면제6투","대통령선거","경기도","포천시",451,294,57,129,84,6,13,0,0,0,0,1,1,1,0,292,2,157
"8996","영북면","영북면제7투","대통령선거","경기도","포천시",521,332,74,148,83,12,13,0,0,0,0,0,0,1,0,331,1,189
"8997","관인면","관내사전투표","대통령선거","경기도","포천시",473,473,137,146,118,29,35,1,0,2,1,0,3,0,0,472,1,0
"8998","관인면","관인면제1투","대통령선거","경기도","포천시",1271,784,199,296,202,45,37,2,0,1,0,0,0,0,0,782,2,487
"8999","관인면","관인면제2투","대통령선거","경기도","포천시",467,326,78,137,78,20,13,0,0,0,0,0,0,0,0,326,0,141
"9000","관인면","관인면제3투","대통령선거","경기도","포천시",409,279,45,131,81,7,10,0,0,0,0,0,1,0,0,275,4,130
"9001","화현면","관내사전투표","대통령선거","경기도","포천시",408,408,108,154,86,30,28,0,0,0,0,1,0,0,0,407,1,0
"9002","화현면","화현면제1투","대통령선거","경기도","포천시",1264,810,169,348,201,45,32,5,1,0,0,0,0,1,1,803,7,454
"9003","화현면","화현면제2투","대통령선거","경기도","포천시",500,326,58,149,82,11,19,1,0,0,0,1,0,1,2,324,2,174
"9004","포천동","관내사전투표","대통령선거","경기도","포천시",2981,2981,1089,737,645,222,253,7,1,0,1,6,0,2,3,2966,15,0
"9005","포천동","포천동제1투","대통령선거","경기도","포천시",3125,2071,653,660,492,123,128,3,0,1,1,0,0,0,2,2063,8,1054
"9006","포천동","포천동제2투","대통령선거","경기도","포천시",1769,1024,242,387,273,53,59,2,0,1,2,0,0,1,1,1021,3,745
"9007","포천동","포천동제3투","대통령선거","경기도","포천시",2609,1672,441,518,455,122,122,0,1,2,1,2,0,1,1,1666,6,937
"9008","포천동","포천동제4투","대통령선거","경기도","포천시",3269,2150,618,616,538,169,191,3,0,2,1,1,0,1,3,2143,7,1119
"9009","포천동","포천동제5투","대통령선거","경기도","포천시",1078,643,178,234,147,40,37,0,0,1,0,1,1,0,2,641,2,435
"9010","선단동","관내사전투표","대통령선거","경기도","포천시",1666,1666,642,405,356,135,107,2,1,1,0,1,0,0,3,1653,13,0
"9011","선단동","선단동제1투","대통령선거","경기도","포천시",3442,1953,608,501,538,135,153,1,1,1,0,1,2,1,1,1943,10,1489
"9012","선단동","선단동제2투","대통령선거","경기도","포천시",1147,728,186,294,174,33,34,2,0,0,0,0,0,0,2,725,3,419
"9013","선단동","선단동제3투","대통령선거","경기도","포천시",1221,670,166,240,189,23,40,0,0,2,0,0,1,1,1,663,7,551
"9014","선단동","선단동제4투","대통령선거","경기도","포천시",3858,2059,645,582,573,119,118,3,0,0,1,3,3,0,1,2048,11,1799
"9015","잘못 투입·구분된 투표지","잘못 투입·구분된 투표지","대통령선거","경기도","포천시",0,0,0,0,0,0,0,0,0,0,0,0,0,0,0,0,0,0
"9016","거소·선상투표","거소·선상투표","대통령선거","경기도","연천군",327,317,103,53,91,25,18,3,1,0,0,0,0,1,2,297,20,10
"9017","관외사전투표","관외사전투표","대통령선거","경기도","연천군",3345,3345,1376,673,706,295,257,1,1,0,1,2,0,1,8,3321,24,0
"9018","재외투표","재외투표","대통령선거","경기도","연천군",150,113,69,7,21,5,8,3,0,0,0,0,0,0,0,113,0,37
"9019","연천읍","관내사전투표","대통령선거","경기도","연천군",1130,1130,392,244,256,114,82,3,0,0,2,4,1,0,6,1104,26,0
"9020","연천읍","연천읍제1투","대통령선거","경기도","연천군",1336,875,216,336,217,43,55,1,0,1,1,2,0,1,0,873,2,461
"9021","연천읍","연천읍제2투","대통령선거","경기도","연천군",1109,791,205,318,193,26,33,0,0,2,1,1,1,1,3,784,7,318
"9022","연천읍","연천읍제3투","대통령선거","경기도","연천군",1402,910,279,225,230,102,64,2,1,0,1,1,0,0,0,905,5,492
"9023","연천읍","연천읍제4투","대통령선거","경기도","연천군",217,159,41,54,51,6,5,0,0,0,0,0,0,0,0,157,2,58
"9024","연천읍","연천읍제5투","대통령선거","경기도","연천군",1055,721,147,304,195,30,30,1,1,1,1,1,0,1,3,715,6,334
"9025","전곡읍","관내사전투표","대통령선거","경기도","연천군",2427,2427,906,548,514,243,183,4,2,1,1,1,1,2,4,2410,17,0
"9026","전곡읍","전곡읍제1투","대통령선거","경기도","연천군",2043,1092,279,422,277,60,44,0,0,1,0,1,1,1,2,1088,4,951
"9027","전곡읍","전곡읍제2투","대통령선거","경기도","연천군",843,549,143,226,127,25,25,0,1,0,0,1,0,0,0,548,1,294
"9028","전곡읍","전곡읍제3투","대통령선거","경기도","연천군",3059,1926,583,631,454,119,119,7,0,2,2,0,2,0,2,1921,5,1133
"9029","전곡읍","전곡읍제4투","대통령선거","경기도","연천군",1141,759,214,214,217,71,36,0,0,0,3,0,1,1,1,758,1,382
"9030","전곡읍","전곡읍제5투","대통령선거","경기도","연천군",1969,1328,350,435,362,89,81,0,0,1,1,0,0,1,2,1322,6,641
"9031","전곡읍","전곡읍제6투","대통령선거","경기도","연천군",310,209,58,85,44,12,7,0,0,0,1,0,0,0,0,207,2,101
"9032","전곡읍","전곡읍제7투","대통령선거","경기도","연천군",208,136,32,59,31,5,5,0,0,0,0,1,0,0,0,133,3,72
"9033","전곡읍","전곡읍제8투","대통령선거","경기도","연천군",365,233,58,91,60,10,13,0,0,0,0,0,0,0,0,232,1,132
"9034","전곡읍","전곡읍제9투","대통령선거","경기도","연천군",2078,1358,405,427,364,74,76,1,0,1,0,1,0,1,1,1351,7,720
"9035","군남면","관내사전투표","대통령선거","경기도","연천군",256,256,74,71,75,16,11,1,0,0,0,1,0,0,0,249,7,0
"9036","군남면","군남면제1투","대통령선거","경기도","연천군",680,437,81,191,116,17,20,2,0,1,0,0,0,4,1,433,4,243
"9037","군남면","군남면제2투","대통령선거","경기도","연천군",442,313,74,128,84,14,8,0,0,3,0,0,1,0,0,312,1,129
"9038","군남면","군남면제3투","대통령선거","경기도","연천군",421,284,57,127,77,8,10,0,0,1,0,0,0,2,1,283,1,137
"9039","군남면","군남면제4투","대통령선거","경기도","연천군",870,595,155,246,143,25,18,2,0,1,0,0,1,1,0,592,3,275
"9040","군남면","군남면제5투","대통령선거","경기도","연천군",173,114,19,40,33,15,3,0,0,0,0,1,0,0,0,111,3,59
"9041","청산면","관내사전투표","대통령선거","경기도","연천군",399,399,123,113,93,44,16,0,0,2,0,0,1,2,1,395,4,0
"9042","청산면","청산면제1투","대통령선거","경기도","연천군",1605,984,212,514,165,43,42,0,0,1,1,0,0,1,3,982,2,621
"9043","청산면","청산면제2투","대통령선거","경기도","연천군",869,575,112,273,121,24,33,0,0,1,0,0,2,3,1,570,5,294
"9044","청산면","청산면제3투","대통령선거","경기도","연천군",546,376,76,166,100,14,15,1,0,2,0,0,1,1,0,376,0,170
"9045","백학면","관내사전투표","대통령선거","경기도","연천군",279,279,95,88,58,16,18,0,0,0,0,3,0,0,0,278,1,0
"9046","백학면","백학면제1투","대통령선거","경기도","연천군",1210,780,174,318,193,42,43,0,0,0,1,0,0,1,2,774,6,430
"9047","백학면","백학면제2투","대통령선거","경기도","연천군",763,510,112,221,110,31,20,3,0,3,0,0,1,2,1,504,6,253
"9048","미산면","관내사전투표","대통령선거","경기도","연천군",208,208,72,68,37,15,11,0,0,0,1,0,0,1,1,206,2,0
"9049","미산면","미산면투표소","대통령선거","경기도","연천군",1221,795,169,335,227,33,25,2,0,0,0,0,2,0,1,794,1,426
"9050","왕징면","관내사전투표","대통령선거","경기도","연천군",189,189,60,45,59,10,9,2,0,0,0,0,0,0,0,185,4,0
"9051","왕징면","왕징면제1투","대통령선거","경기도","연천군",346,246,65,114,53,8,3,0,0,1,0,0,0,0,1,245,1,100
"9052","왕징면","왕징면제2투","대통령선거","경기도","연천군",169,129,32,50,23,6,12,2,0,0,1,0,0,1,0,127,2,40
"9053","왕징면","왕징면제3투","대통령선거","경기도","연천군",273,197,51,86,38,13,5,0,1,0,0,0,0,1,0,195,2,76
"9054","신서면","관내사전투표","대통령선거","경기도","연천군",562,562,200,162,107,51,25,0,1,0,0,0,0,1,0,547,15,0
"9055","신서면","신서면제1투","대통령선거","경기도","연천군",1261,839,213,336,200,42,35,0,0,1,2,0,1,0,2,832,7,422
"9056","신서면","신서면제2투","대통령선거","경기도","연천군",139,93,15,42,32,3,1,0,0,0,0,0,0,0,0,93,0,46
"9057","신서면","신서면제3투","대통령선거","경기도","연천군",239,177,37,90,42,2,5,0,0,0,0,0,0,0,1,177,0,62
"9058","신서면","신서면제4투","대통령선거","경기도","연천군",469,318,79,120,88,15,14,0,0,0,0,0,1,0,0,317,1,151
"9059","중면","관내사전투표","대통령선거","경기도","연천군",74,74,22,14,18,8,9,0,1,0,0,0,0,1,0,73,1,0
"9060","중면","중면투표소","대통령선거","경기도","연천군",123,89,27,30,14,9,7,0,0,1,0,0,0,0,0,88,1,34
"9061","장남면","관내사전투표","대통령선거","경기도","연천군",77,77,23,37,13,2,2,0,0,0,0,0,0,0,0,77,0,0
"9062","장남면","장남면투표소","대통령선거","경기도","연천군",532,402,99,180,76,21,20,0,0,0,0,0,0,0,0,396,6,130
"9063","잘못 투입·구분된 투표지","잘못 투입·구분된 투표지","대통령선거","경기도","연천군",0,0,0,0,0,0,0,0,0,0,0,0,0,0,0,0,0,0
"9064","거소·선상투표","거소·선상투표","대통령선거","경기도","양평군",299,282,86,60,68,21,13,2,0,1,0,1,3,1,4,260,22,17
"9065","관외사전투표","관외사전투표","대통령선거","경기도","양평군",9577,9573,3694,2367,1989,724,699,13,3,4,3,3,3,6,11,9519,54,4
"9066","재외투표","재외투표","대통령선거","경기도","양평군",728,565,351,35,86,15,77,0,0,0,0,0,0,0,1,565,0,163
"9067","양평읍","관내사전투표","대통령선거","경기도","양평군",4363,4363,1646,1173,844,313,346,7,0,3,0,3,3,1,6,4345,18,0
"9068","양평읍","양평읍제1투","대통령선거","경기도","양평군",2396,1429,381,499,318,107,108,6,0,3,1,0,0,1,3,1427,2,967
"9069","양평읍","양평읍제2투","대통령선거","경기도","양평군",2584,1680,478,585,379,115,111,3,0,0,0,0,0,0,2,1673,7,904
"9070","양평읍","양평읍제3투","대통령선거","경기도","양평군",1144,721,151,333,151,39,40,3,0,0,0,0,0,0,1,718,3,423
"9071","양평읍","양평읍제4투","대통령선거","경기도","양평군",1141,736,152,332,154,43,32,2,1,0,0,0,1,2,2,721,15,405
"9072","양평읍","양평읍제5투","대통령선거","경기도","양평군",3013,1846,537,655,422,111,98,3,1,1,1,0,0,4,0,1833,13,1167
"9073","양평읍","양평읍제6투","대통령선거","경기도","양평군",1469,990,241,380,231,81,51,0,0,2,0,0,0,2,0,988,2,479
"9074","양평읍","양평읍제7투","대통령선거","경기도","양평군",3224,2173,713,686,482,118,154,2,0,3,1,3,0,2,1,2165,8,1051
"9075","양평읍","양평읍제8투","대통령선거","경기도","양평군",2890,1938,656,577,453,119,120,5,0,0,0,0,1,1,2,1934,4,952
"9076","강상면","관내사전투표","대통령선거","경기도","양평군",1234,1234,418,407,213,84,103,1,0,2,0,0,0,0,1,1229,5,0
"9077","강상면","강상면제1투","대통령선거","경기도","양평군",2559,1737,554,577,384,106,98,3,0,0,0,1,0,3,4,1730,7,822
"9078","강상면","강상면제2투","대통령선거","경기도","양평군",1607,983,270,372,232,39,58,8,0,0,0,0,0,2,1,982,1,624
"9079","강상면","강상면제3투","대통령선거","경기도","양평군",968,649,156,260,162,39,23,3,1,1,0,0,0,1,1,647,2,319
"9080","강하면","관내사전투표","대통령선거","경기도","양평군",716,716,238,247,153,35,33,4,0,0,0,0,0,1,0,711,5,0
"9081","강하면","강하면제1투","대통령선거","경기도","양평군",1528,975,237,423,248,41,18,4,0,1,0,0,1,0,2,975,0,553
"9082","강하면","강하면제2투","대통령선거","경기도","양평군",1221,838,183,391,179,43,25,7,0,0,0,0,1,0,2,831,7,383
"9083","양서면","관내사전투표","대통령선거","경기도","양평군",1926,1926,644,662,383,114,111,2,0,0,0,2,1,0,3,1922,4,0
"9084","양서면","양서면제1투","대통령선거","경기도","양평군",2489,1718,478,638,392,90,94,7,0,1,1,2,1,3,1,1708,10,771
"9085","양서면","양서면제2투","대통령선거","경기도","양평군",970,676,166,271,159,28,43,2,1,1,0,2,0,1,1,675,1,294
"9086","양서면","양서면제3투","대통령선거","경기도","양평군",2705,1545,478,478,369,101,106,3,0,0,2,2,0,1,1,1541,4,1160
"9087","양서면","양서면제4투","대통령선거","경기도","양평군",940,625,161,276,129,22,31,0,0,1,0,0,0,0,0,620,5,315
"9088","옥천면","관내사전투표","대통령선거","경기도","양평군",1352,1352,455,407,284,89,106,3,0,0,1,1,1,0,0,1347,5,0
"9089","옥천면","옥천면제1투","대통령선거","경기도","양평군",1599,1029,306,359,244,52,57,0,1,1,1,1,1,1,0,1024,5,570
"9090","옥천면","옥천면제2투","대통령선거","경기도","양평군",1083,709,167,299,170,41,25,3,0,0,0,0,0,1,0,706,3,374
"9091","옥천면","옥천면제3투","대통령선거","경기도","양평군",982,668,169,295,154,31,17,0,0,0,0,0,0,1,0,667,1,314
"9092","옥천면","옥천면제4투","대통령선거","경기도","양평군",821,536,141,190,140,27,32,1,0,1,0,1,0,2,0,535,1,285
"9093","서종면","관내사전투표","대통령선거","경기도","양평군",1073,1073,404,342,200,45,72,2,0,0,1,0,0,0,0,1066,7,0
"9094","서종면","서종면제1투","대통령선거","경기도","양평군",2247,1419,468,489,294,77,81,3,0,0,1,0,1,0,0,1414,5,828
"9095","서종면","서종면제2투","대통령선거","경기도","양평군",664,462,146,175,96,18,23,1,0,0,0,0,0,0,0,459,3,202
"9096","서종면","서종면제3투","대통령선거","경기도","양평군",800,545,153,217,107,33,28,4,0,0,0,0,0,2,0,544,1,255
"9097","서종면","서종면제4투","대통령선거","경기도","양평군",385,245,48,116,60,11,8,0,0,0,0,0,0,0,1,244,1,140
"9098","서종면","서종면제5투","대통령선거","경기도","양평군",1007,670,152,280,167,41,27,0,0,0,0,0,0,0,0,667,3,337
"9099","단월면","관내사전투표","대통령선거","경기도","양평군",570,570,158,206,119,35,24,3,1,1,0,0,0,1,1,549,21,0
"9100","단월면","단월면제1투","대통령선거","경기도","양평군",919,612,147,267,133,34,21,4,0,0,0,1,1,3,0,611,1,307
"9101","단월면","단월면제2투","대통령선거","경기도","양평군",854,546,105,256,124,26,24,3,0,0,0,0,2,3,0,543,3,308
"9102","단월면","단월면제3투","대통령선거","경기도","양평군",379,254,37,134,59,16,6,0,0,0,0,0,0,1,0,253,1,125
"9103","단월면","단월면제4투","대통령선거","경기도","양평군",200,132,26,63,33,3,6,0,0,0,0,0,0,0,0,131,1,68
"9104","청운면","관내사전투표","대통령선거","경기도","양평군",459,459,117,179,105,29,26,1,0,0,0,0,0,0,0,457,2,0
"9105","청운면","청운면제1투","대통령선거","경기도","양평군",1068,680,138,314,152,39,18,2,0,2,0,0,1,2,1,669,11,388
"9106","청운면","청운면제2투","대통령선거","경기도","양평군",479,317,64,138,87,8,8,1,0,0,1,0,0,2,1,310,7,162
"9107","청운면","청운면제3투","대통령선거","경기도","양평군",501,314,72,134,82,14,8,0,0,0,0,0,0,1,0,311,3,187
"9108","청운면","청운면제4투","대통령선거","경기도","양평군",553,375,73,176,74,31,9,2,1,1,0,2,0,2,1,372,3,178
"9109","양동면","관내사전투표","대통령선거","경기도","양평군",482,482,145,192,94,11,37,1,0,0,1,0,0,0,0,481,1,0
"9110","양동면","양동면제1투","대통령선거","경기도","양평군",1455,948,196,428,229,39,37,2,1,4,2,0,0,1,3,942,6,507
"9111","양동면","양동면제2투","대통령선거","경기도","양평군",675,412,87,176,98,20,20,2,0,0,0,0,1,2,3,409,3,263
"9112","양동면","양동면제3투","대통령선거","경기도","양평군",651,436,69,228,100,16,12,2,0,2,0,0,0,3,1,433,3,215
"9113","양동면","양동면제4투","대통령선거","경기도","양평군",441,289,60,102,87,18,13,0,0,1,1,0,2,1,1,286,3,152
"9114","지평면","관내사전투표","대통령선거","경기도","양평군",849,849,246,296,186,60,53,1,0,0,1,0,1,1,0,845,4,0
"9115","지평면","지평면제1투","대통령선거","경기도","양평군",882,540,125,238,120,22,32,1,0,0,0,0,0,0,0,538,2,342
"9116","지평면","지평면제2투","대통령선거","경기도","양평군",735,485,109,202,127,17,27,0,0,0,1,0,0,1,0,484,1,250
"9117","지평면","지평면제3투","대통령선거","경기도","양평군",601,394,77,184,99,8,15,1,0,1,0,0,2,2,0,389,5,207
"9118","지평면","지평면제4투","대통령선거","경기도","양평군",747,484,99,224,119,20,15,0,1,0,0,1,2,0,1,482,2,263
"9119","지평면","지평면제5투","대통령선거","경기도","양평군",790,503,134,184,124,23,28,0,0,0,2,0,0,0,3,498,5,287
"9120","지평면","지평면제6투","대통령선거","경기도","양평군",690,465,107,185,114,31,20,2,0,0,0,1,0,1,0,461,4,225
"9121","용문면","관내사전투표","대통령선거","경기도","양평군",2320,2320,811,646,476,175,182,3,0,3,1,1,0,2,4,2304,16,0
"9122","용문면","용문면제1투","대통령선거","경기도","양평군",2806,1811,481,689,411,100,108,2,0,1,0,0,0,1,6,1799,12,995
"9123","용문면","용문면제2투","대통령선거","경기도","양평군",1755,1155,283,518,240,50,48,5,0,4,1,0,0,1,2,1152,3,600
"9124","용문면","용문면제3투","대통령선거","경기도","양평군",1733,1082,299,351,261,107,55,2,0,1,1,1,0,0,2,1080,2,651
"9125","용문면","용문면제4투","대통령선거","경기도","양평군",1189,783,167,336,212,32,25,0,2,0,0,1,0,0,2,777,6,406
"9126","용문면","용문면제5투","대통령선거","경기도","양평군",1506,1052,329,355,251,44,63,1,0,0,0,0,0,4,2,1049,3,454
"9127","용문면","용문면제6투","대통령선거","경기도","양평군",598,422,80,232,81,16,9,1,0,0,0,1,0,0,0,420,2,176
"9128","용문면","용문면제7투","대통령선거","경기도","양평군",623,431,113,187,108,7,13,2,0,0,0,0,0,0,0,430,1,192
"9129","개군면","관내사전투표","대통령선거","경기도","양평군",725,725,218,227,164,47,58,1,0,1,0,0,1,1,0,718,7,0
"9130","개군면","개군면제1투","대통령선거","경기도","양평군",1227,797,160,329,216,51,34,1,0,1,0,0,1,1,1,795,2,430
"9131","개군면","개군면제2투","대통령선거","경기도","양평군",1158,797,223,309,164,39,55,2,0,0,1,0,0,0,0,793,4,361
"9132","개군면","개군면제3투","대통령선거","경기도","양평군",773,509,96,262,108,15,17,2,0,3,0,0,2,1,0,506,3,264
"9133","잘못 투입·구분된 투표지","잘못 투입·구분된 투표지","대통령선거","경기도","양평군",0,0,0,0,0,0,0,0,0,0,0,0,0,0,0,0,0,0
"9134","거소·선상투표","거소·선상투표","대통령선거","경기도","가평군",462,416,131,62,112,18,20,4,5,4,7,3,1,3,7,377,39,46
"9135","관외사전투표","관외사전투표","대통령선거","경기도","가평군",4576,4576,1696,1080,1057,345,331,5,1,4,1,2,4,4,8,4538,38,0
"9136","재외투표","재외투표","대통령선거","경기도","가평군",258,195,112,12,40,7,24,0,0,0,0,0,0,0,0,195,0,63
"9137","가평읍","관내사전투표","대통령선거","경기도","가평군",2434,2434,949,635,481,159,182,8,0,3,3,1,3,0,2,2426,8,0
"9138","가평읍","가평읍제1투","대통령선거","경기도","가평군",2676,1639,438,587,386,110,106,0,0,1,0,0,0,2,2,1632,7,1037
"9139","가평읍","가평읍제2투","대통령선거","경기도","가평군",2215,1470,385,541,344,92,90,3,1,2,3,0,0,0,4,1465,5,745
"9140","가평읍","가평읍제3투","대통령선거","경기도","가평군",3013,2033,608,712,457,112,125,1,0,2,1,0,0,2,5,2025,8,980
"9141","가평읍","가평읍제4투","대통령선거","경기도","가평군",1555,995,298,386,202,57,40,2,0,0,0,1,1,2,2,991,4,560
"9142","가평읍","가평읍제5투","대통령선거","경기도","가평군",959,644,122,276,183,25,28,0,0,2,1,0,1,2,0,640,4,315
"9143","가평읍","가평읍제6투","대통령선거","경기도","가평군",844,552,117,220,147,34,28,0,0,2,1,0,0,0,1,550,2,292
"9144","가평읍","가평읍제7투","대통령선거","경기도","가평군",842,560,123,275,111,24,18,3,0,0,0,0,1,0,0,555,5,282
"9145","가평읍","가평읍제8투","대통령선거","경기도","가평군",624,401,87,187,91,15,12,2,0,0,0,1,0,0,0,395,6,223
"9146","설악면","관내사전투표","대통령선거","경기도","가평군",1091,1091,349,367,254,47,65,1,0,0,0,0,3,1,2,1089,2,0
"9147","설악면","설악면제1투","대통령선거","경기도","가평군",1946,1151,243,477,307,54,50,4,0,0,1,0,1,1,3,1141,10,795
"9148","설악면","설악면제2투","대통령선거","경기도","가평군",855,575,110,263,157,23,15,2,0,0,0,0,0,2,1,573,2,280
"9149","설악면","설악면제3투","대통령선거","경기도","가평군",957,645,137,279,173,22,27,1,0,1,1,0,1,0,1,643,2,312
"9150","설악면","설악면제4투","대통령선거","경기도","가평군",457,307,77,125,67,22,11,1,0,0,0,0,1,0,0,304,3,150
"9151","설악면","설악면제5투","대통령선거","경기도","가평군",1454,937,218,385,225,56,40,3,0,1,0,2,2,2,2,936,1,517
"9152","청평면","관내사전투표","대통령선거","경기도","가평군",1587,1587,616,451,319,82,98,5,0,0,1,4,1,2,2,1581,6,0
"9153","청평면","청평면제1투","대통령선거","경기도","가평군",3202,2009,537,769,439,106,127,6,1,2,2,5,1,2,1,1998,11,1193
"9154","청평면","청평면제2투","대통령선거","경기도","가평군",1456,970,185,518,197,33,28,1,1,0,0,2,0,1,1,967,3,486
"9155","청평면","청평면제3투","대통령선거","경기도","가평군",315,197,54,90,41,4,5,0,0,0,0,0,0,0,1,195,2,118
"9156","청평면","청평면제4투","대통령선거","경기도","가평군",3112,2008,607,680,497,105,96,7,0,3,2,1,3,0,2,2003,5,1104
"9157","청평면","청평면제5투","대통령선거","경기도","가평군",416,287,57,140,71,13,6,0,0,0,0,0,0,0,0,287,0,129
"9158","청평면","청평면제6투","대통령선거","경기도","가평군",676,489,119,181,146,18,19,2,0,1,0,0,1,0,0,487,2,187
"9159","청평면","청평면제7투","대통령선거","경기도","가평군",436,291,62,143,66,7,11,1,0,0,0,0,0,0,0,290,1,145
"9160","상면","관내사전투표","대통령선거","경기도","가평군",570,570,180,173,116,56,31,4,0,3,0,1,1,0,1,566,4,0
"9161","상면","상면제1투","대통령선거","경기도","가평군",1133,780,171,332,189,42,28,4,0,3,1,0,1,2,3,776,4,353
"9162","상면","상면제2투","대통령선거","경기도","가평군",950,604,135,256,162,28,19,0,0,0,0,0,0,1,1,602,2,346
"9163","상면","상면제3투","대통령선거","경기도","가평군",392,247,30,122,64,14,14,0,0,0,0,0,1,0,0,245,2,145
"9164","상면","상면제4투","대통령선거","경기도","가평군",813,526,100,244,130,22,16,1,1,0,0,0,0,2,1,517,9,287
"9165","상면","상면제5투","대통령선거","경기도","가평군",488,304,64,130,84,10,14,0,0,0,0,1,0,1,0,304,0,184
"9166","북면","관내사전투표","대통령선거","경기도","가평군",465,465,124,165,111,25,29,1,1,1,1,1,0,1,0,460,5,0
"9167","북면","북면제1투","대통령선거","경기도","가평군",1148,779,147,379,174,44,29,2,0,0,0,1,0,1,0,777,2,369
"9168","북면","북면제2투","대통령선거","경기도","가평군",606,392,89,164,104,16,16,0,0,0,0,0,0,1,0,390,2,214
"9169","북면","북면제3투","대통령선거","경기도","가평군",637,421,110,156,113,18,21,0,0,0,0,0,0,1,0,419,2,216
"9170","북면","북면제4투","대통령선거","경기도","가평군",389,265,53,130,65,7,3,0,0,1,0,3,0,0,2,264,1,124
"9171","조종면","관내사전투표","대통령선거","경기도","가평군",1282,1282,371,347,303,133,79,7,1,3,2,5,3,0,4,1258,24,0
"9172","조종면","조종면제1투","대통령선거","경기도","가평군",1585,1024,239,393,250,72,60,1,0,1,0,1,2,2,1,1022,2,561
"9173","조종면","조종면제2투","대통령선거","경기도","가평군",989,633,141,250,167,39,26,2,0,0,0,2,0,0,0,627,6,356
"9174","조종면","조종면제3투","대통령선거","경기도","가평군",1150,643,158,187,175,66,49,0,0,0,0,0,1,2,2,640,3,507
"9175","조종면","조종면제4투","대통령선거","경기도","가평군",1485,835,211,244,173,31,34,12,13,8,8,8,16,7,11,776,59,650
"9176","조종면","조종면제5투","대통령선거","경기도","가평군",509,343,49,184,74,8,18,3,0,0,0,0,0,2,1,339,4,166
"9177","조종면","조종면제6투","대통령선거","경기도","가평군",471,324,64,167,65,10,15,0,0,0,0,0,0,1,0,322,2,147
"9178","잘못 투입·구분된 투표지","잘못 투입·구분된 투표지","대통령선거","경기도","가평군",0,1,0,1,0,0,0,0,0,0,0,0,0,0,0,1,0,-1
"9179","거소·선상투표","거소·선상투표","대통령선거","경기도","과천시",120,106,31,26,33,6,3,1,0,1,2,0,0,0,0,103,3,14
"9180","관외사전투표","관외사전투표","대통령선거","경기도","과천시",5609,5609,2564,885,1159,480,462,6,2,1,1,5,2,2,6,5575,34,0
"9181","재외투표","재외투표","대통령선거","경기도","과천시",862,679,398,58,112,30,78,1,0,0,0,0,0,0,1,678,1,183
"9182","중앙동","관내사전투표","대통령선거","경기도","과천시",1449,1449,544,344,303,143,109,0,1,0,0,0,0,1,0,1445,4,0
"9183","중앙동","중앙동제1투","대통령선거","경기도","과천시",1439,953,349,246,206,80,67,1,0,0,0,0,0,0,0,949,4,486
"9184","중앙동","중앙동제2투","대통령선거","경기도","과천시",2371,1929,656,508,437,198,114,2,1,3,0,0,1,0,0,1920,9,442
"9185","갈현동","관내사전투표","대통령선거","경기도","과천시",1502,1501,715,249,287,132,112,2,0,0,0,1,0,0,0,1498,3,1
"9186","갈현동","갈현동제1투","대통령선거","경기도","과천시",830,531,150,188,122,44,22,0,0,0,1,0,0,0,1,528,3,299
"9187","갈현동","갈현동제2투","대통령선거","경기도","과천시",820,547,216,132,110,48,37,2,0,0,0,0,0,0,0,545,2,273
"9188","갈현동","갈현동제3투","대통령선거","경기도","과천시",2528,2082,867,426,474,186,124,0,0,0,0,0,0,1,2,2080,2,446
"9189","갈현동","갈현동제4투","대통령선거","경기도","과천시",2756,2349,943,532,516,209,139,6,0,0,1,0,0,0,2,2348,1,407
"9190","별양동","관내사전투표","대통령선거","경기도","과천시",2286,2286,1060,442,408,201,164,1,0,1,0,2,0,1,2,2282,4,0
"9191","별양동","별양동제1투","대통령선거","경기도","과천시",846,566,189,136,149,52,36,1,0,0,0,1,0,0,0,564,2,280
"9192","별양동","별양동제2투","대통령선거","경기도","과천시",2011,1437,569,341,322,99,92,4,0,0,1,0,2,0,1,1431,6,574
"9193","별양동","별양동제3투","대통령선거","경기도","과천시",1811,1449,584,307,322,131,98,2,0,0,0,0,0,1,2,1447,2,362
"9194","별양동","별양동제4투","대통령선거","경기도","과천시",1829,1464,479,433,314,163,70,0,0,1,0,0,0,0,2,1462,2,365
"9195","부림동","관내사전투표","대통령선거","경기도","과천시",1982,1982,852,392,397,176,147,6,0,1,0,1,0,0,1,1973,9,0
"9196","부림동","부림동제1투","대통령선거","경기도","과천시",2166,1662,628,367,379,162,118,2,0,1,0,0,0,0,0,1657,5,504
"9197","부림동","부림동제2투","대통령선거","경기도","과천시",1735,1423,606,266,301,128,115,2,1,0,1,0,0,0,0,1420,3,312
"9198","부림동","부림동제3투","대통령선거","경기도","과천시",1952,1356,514,333,333,84,80,5,0,0,0,2,0,3,1,1355,1,596
"9199","과천동","관내사전투표","대통령선거","경기도","과천시",918,918,386,215,170,71,72,2,0,0,0,0,1,0,0,917,1,0
"9200","과천동","과천동제1투","대통령선거","경기도","과천시",1452,987,357,255,230,65,77,0,0,0,0,1,0,0,1,986,1,465
"9201","과천동","과천동제2투","대통령선거","경기도","과천시",1758,1235,341,451,291,71,68,5,0,1,0,0,0,1,1,1230,5,523
"9202","과천동","과천동제3투","대통령선거","경기도","과천시",900,594,208,191,134,36,20,3,0,0,0,0,0,0,0,592,2,306
"9203","과천동","과천동제4투","대통령선거","경기도","과천시",1800,1313,568,281,288,82,78,4,2,0,0,1,0,4,3,1311,2,487
"9204","문원동","관내사전투표","대통령선거","경기도","과천시",1186,1186,552,235,226,70,90,4,1,0,0,2,1,1,0,1182,4,0
"9205","문원동","문원동제1투","대통령선거","경기도","과천시",1980,1427,563,344,302,102,103,4,0,3,0,0,1,1,1,1424,3,553
"9206","문원동","문원동제2투","대통령선거","경기도","과천시",2308,1769,639,472,411,105,119,6,0,1,0,1,1,3,2,1760,9,539
"9207","잘못 투입·구분된 투표지","잘못 투입·구분된 투표지","대통령선거","경기도","과천시",0,0,0,0,0,0,0,0,0,0,0,0,0,0,0,0,0,0
"9208","거소·선상투표","거소·선상투표","대통령선거","경상남도","창원시의창구",710,673,190,177,177,58,27,6,2,2,1,3,1,2,5,651,22,37
"9209","관외사전투표","관외사전투표","대통령선거","경상남도","창원시의창구",19542,19535,8205,4520,3044,1915,1548,25,4,11,7,18,6,6,43,19352,183,7
"9210","재외투표","재외투표","대통령선거","경상남도","창원시의창구",1006,721,396,52,121,46,93,9,0,0,0,0,0,1,1,719,2,285
"9211","동읍","관내사전투표","대통령선거","경상남도","창원시의창구",2843,2843,1261,874,351,189,142,3,0,3,1,2,1,1,6,2834,9,0
"9212","동읍","동읍제1투","대통령선거","경상남도","창원시의창구",1389,1081,423,267,229,101,50,1,0,1,0,1,0,1,2,1076,5,308
"9213","동읍","동읍제2투","대통령선거","경상남도","창원시의창구",2697,1790,614,763,213,83,101,2,0,3,1,1,0,0,3,1784,6,907
"9214","동읍","동읍제3투","대통령선거","경상남도","창원시의창구",1862,1358,487,563,164,72,61,1,0,0,0,0,1,1,0,1350,8,504
"9215","동읍","동읍제4투","대통령선거","경상남도","창원시의창구",2539,1927,796,604,268,129,102,3,0,3,0,5,0,1,5,1916,11,612
"9216","동읍","동읍제5투","대통령선거","경상남도","창원시의창구",2650,1819,639,738,226,110,93,2,1,0,1,0,0,1,2,1813,6,831
"9217","동읍","동읍제6투","대통령선거","경상남도","창원시의창구",1467,1035,271,512,136,61,38,2,1,0,1,1,3,0,1,1027,8,432
"9218","동읍","동읍제7투","대통령선거","경상남도","창원시의창구",1196,822,215,455,93,28,22,1,0,0,1,1,0,0,2,818,4,374
"9219","북면","관내사전투표","대통령선거","경상남도","창원시의창구",2975,2975,1201,1004,343,219,165,11,1,3,3,6,0,1,1,2958,17,0
"9220","북면","북면제1투","대통령선거","경상남도","창원시의창구",3806,3037,1246,966,461,215,126,2,0,1,0,1,1,4,4,3027,10,769
"9221","북면","북면제2투","대통령선거","경상남도","창원시의창구",4550,3567,1406,1153,518,260,201,6,0,1,0,1,1,2,4,3553,14,983
"9222","북면","북면제3투","대통령선거","경상남도","창원시의창구",5138,3921,1502,1297,576,282,230,6,0,0,1,3,2,4,6,3909,12,1217
"9223","북면","북면제4투","대통령선거","경상남도","창원시의창구",3275,2094,550,1056,270,99,91,8,2,1,0,3,0,1,4,2085,9,1181
"9224","북면","북면제5투","대통령선거","경상남도","창원시의창구",899,636,117,411,56,30,11,1,0,0,1,1,1,1,0,630,6,263
"9225","대산면","관내사전투표","대통령선거","경상남도","창원시의창구",759,759,347,251,83,30,39,2,0,0,0,3,1,0,2,758,1,0
"9226","대산면","대산면제1투","대통령선거","경상남도","창원시의창구",1526,1073,337,542,90,53,24,2,1,0,0,1,3,2,6,1061,12,453
"9227","대산면","대산면제2투","대통령선거","경상남도","창원시의창구",2451,1570,456,790,186,61,50,1,1,0,0,1,0,4,4,1554,16,881
"9228","대산면","대산면제3투","대통령선거","경상남도","창원시의창구",1114,761,293,330,80,30,21,0,0,0,1,0,1,2,0,758,3,353
"9229","의창동","관내사전투표","대통령선거","경상남도","창원시의창구",4168,4168,1588,1544,489,266,245,4,0,3,1,4,3,1,4,4152,16,0
"9230","의창동","의창동제1투","대통령선거","경상남도","창원시의창구",2208,1513,391,800,177,68,64,0,0,0,0,0,1,1,0,1502,11,695
"9231","의창동","의창동제2투","대통령선거","경상남도","창원시의창구",3076,2268,655,1047,296,155,103,1,0,2,0,0,0,1,2,2262,6,808
"9232","의창동","의창동제3투","대통령선거","경상남도","창원시의창구",2951,2173,780,786,292,166,124,4,0,2,0,1,2,0,5,2162,11,778
"9233","의창동","의창동제4투","대통령선거","경상남도","창원시의창구",3218,2229,713,963,279,131,116,4,0,1,0,2,0,1,4,2214,15,989
"9234","의창동","의창동제5투","대통령선거","경상남도","창원시의창구",2837,2041,673,877,242,135,92,1,3,1,2,1,2,0,2,2031,10,796
"9235","의창동","의창동제6투","대통령선거","경상남도","창원시의창구",2923,2061,680,774,298,170,117,2,0,1,1,1,0,1,2,2047,14,862
"9236","의창동","의창동제7투","대통령선거","경상남도","창원시의창구",2062,1528,465,667,212,97,69,1,0,2,0,1,1,0,4,1519,9,534
"9237","의창동","의창동제8투","대통령선거","경상남도","창원시의창구",1896,1448,429,683,166,98,59,1,1,2,0,0,1,1,1,1442,6,448
"9238","의창동","의창동제9투","대통령선거","경상남도","창원시의창구",2760,1885,779,526,290,158,120,1,0,1,0,0,0,0,2,1877,8,875
"9239","팔룡동","관내사전투표","대통령선거","경상남도","창원시의창구",5735,5735,2589,1495,721,481,408,2,1,4,1,3,0,0,5,5710,25,0
"9240","팔룡동","팔룡동제1투","대통령선거","경상남도","창원시의창구",2748,1985,695,733,288,156,100,3,0,0,1,1,0,0,2,1979,6,763
"9241","팔룡동","팔룡동제2투","대통령선거","경상남도","창원시의창구",2565,1654,551,649,227,108,102,1,1,3,0,1,0,1,3,1647,7,911
"9242","팔룡동","팔룡동제3투","대통령선거","경상남도","창원시의창구",2950,1995,656,768,310,147,99,3,2,0,1,0,1,0,2,1989,6,955
"9243","팔룡동","팔룡동제4투","대통령선거","경상남도","창원시의창구",2998,2314,963,620,334,196,181,3,0,3,0,0,0,0,4,2304,10,684
"9244","팔룡동","팔룡동제5투","대통령선거","경상남도","창원시의창구",3277,2722,1138,798,407,195,167,1,0,0,0,0,1,0,3,2710,12,555
"9245","팔룡동","팔룡동제6투","대통령선거","경상남도","창원시의창구",3149,2369,886,810,314,182,145,6,0,5,1,1,1,2,4,2357,12,780
"9246","팔룡동","팔룡동제7투","대통령선거","경상남도","창원시의창구",2536,2061,788,645,292,164,153,4,1,0,0,1,0,0,3,2051,10,475
"9247","팔룡동","팔룡동제8투","대통령선거","경상남도","창원시의창구",1900,1590,456,679,265,138,45,0,0,0,0,0,0,1,0,1584,6,310
"9248","명곡동","관내사전투표","대통령선거","경상남도","창원시의창구",6827,6826,2833,2073,880,515,469,8,0,2,2,5,2,4,4,6797,29,1
"9249","명곡동","명곡동제1투","대통령선거","경상남도","창원시의창구",3334,2451,798,996,304,170,163,0,0,2,0,0,0,1,3,2437,14,883
"9250","명곡동","명곡동제2투","대통령선거","경상남도","창원시의창구",3413,2581,893,864,399,189,216,0,0,1,0,0,2,0,3,2567,14,832
"9251","명곡동","명곡동제3투","대통령선거","경상남도","창원시의창구",2911,2228,817,769,294,181,148,2,1,0,1,1,0,0,4,2218,10,683
"9252","명곡동","명곡동제4투","대통령선거","경상남도","창원시의창구",2587,1672,617,568,244,134,94,0,0,0,1,1,1,1,4,1665,7,915
"9253","명곡동","명곡동제5투","대통령선거","경상남도","창원시의창구",2696,2173,768,779,333,199,81,0,1,1,0,1,1,1,1,2166,7,523
"9254","명곡동","명곡동제6투","대통령선거","경상남도","창원시의창구",2674,1797,596,749,235,110,91,1,1,1,0,1,0,0,1,1786,11,877
"9255","명곡동","명곡동제7투","대통령선거","경상남도","창원시의창구",2977,2094,621,918,269,142,125,1,0,3,0,2,0,1,3,2085,9,883
"9256","명곡동","명곡동제8투","대통령선거","경상남도","창원시의창구",2968,2029,607,848,287,144,124,3,0,3,0,3,0,2,2,2023,6,939
"9257","명곡동","명곡동제9투","대통령선거","경상남도","창원시의창구",2817,1950,601,843,251,134,105,1,0,5,0,1,1,0,0,1942,8,867
"9258","명곡동","명곡동제10투","대통령선거","경상남도","창원시의창구",2266,1588,527,645,225,79,99,1,0,1,1,0,1,0,0,1579,9,678
"9259","명곡동","명곡동제11투","대통령선거","경상남도","창원시의창구",2414,1628,510,708,228,83,85,6,0,1,0,1,0,0,1,1623,5,786
"9260","봉림동","관내사전투표","대통령선거","경상남도","창원시의창구",4415,4415,1882,1327,564,329,277,8,0,1,1,5,2,3,3,4402,13,0
"9261","봉림동","봉림동제1투","대통령선거","경상남도","창원시의창구",3412,2275,748,928,309,154,112,4,0,5,2,1,1,1,1,2266,9,1137
"9262","봉림동","봉림동제2투","대통령선거","경상남도","창원시의창구",3006,2067,683,821,312,145,89,2,0,2,1,1,1,1,1,2059,8,939
"9263","봉림동","봉림동제3투","대통령선거","경상남도","창원시의창구",2931,1965,664,768,269,113,136,2,1,2,0,1,0,2,2,1960,5,966
"9264","봉림동","봉림동제4투","대통령선거","경상남도","창원시의창구",2797,1938,675,706,293,129,111,0,2,2,1,1,0,5,3,1928,10,859
"9265","봉림동","봉림동제5투","대통령선거","경상남도","창원시의창구",3719,2547,935,916,357,167,136,4,0,2,3,2,2,1,6,2531,16,1172
"9266","봉림동","봉림동제6투","대통령선거","경상남도","창원시의창구",3606,2546,872,958,359,191,133,4,1,3,0,9,0,0,6,2536,10,1060
"9267","봉림동","봉림동제7투","대통령선거","경상남도","창원시의창구",3234,2276,793,821,316,204,116,2,0,1,1,2,2,1,6,2265,11,958
"9268","용지동","관내사전투표","대통령선거","경상남도","창원시의창구",4064,4064,1811,1096,526,319,291,6,1,0,1,1,0,1,2,4055,9,0
"9269","용지동","용지동제1투","대통령선거","경상남도","창원시의창구",1653,1212,483,393,154,96,74,1,0,1,0,1,0,1,4,1208,4,441
"9270","용지동","용지동제2투","대통령선거","경상남도","창원시의창구",2369,1776,602,648,288,127,103,0,1,0,0,2,0,2,0,1773,3,593
"9271","용지동","용지동제3투","대통령선거","경상남도","창원시의창구",2577,1905,725,578,306,158,126,0,0,2,0,1,0,0,4,1900,5,672
"9272","용지동","용지동제4투","대통령선거","경상남도","창원시의창구",2795,1962,647,768,257,162,111,1,0,1,0,2,0,1,5,1955,7,833
"9273","용지동","용지동제5투","대통령선거","경상남도","창원시의창구",3669,2471,814,952,378,163,150,3,0,0,0,0,0,3,2,2465,6,1198
"9274","용지동","용지동제6투","대통령선거","경상남도","창원시의창구",2812,2274,782,776,369,193,144,0,0,1,1,2,0,0,0,2268,6,538
"9275","용지동","용지동제7투","대통령선거","경상남도","창원시의창구",2081,1600,625,482,240,122,119,0,0,0,1,2,0,0,0,1591,9,481
"9276","잘못 투입·구분된 투표지","잘못 투입·구분된 투표지","대통령선거","경상남도","창원시의창구",0,1,1,0,0,0,0,0,0,0,0,0,0,0,0,1,0,-1
"9277","거소·선상투표","거소·선상투표","대통령선거","경상남도","창원시성산구",533,512,161,121,137,44,19,2,0,3,0,0,0,3,2,492,20,21
"9278","관외사전투표","관외사전투표","대통령선거","경상남도","창원시성산구",18125,18125,7863,3500,3098,1920,1498,16,7,4,6,27,8,9,35,17991,134,0
"9279","재외투표","재외투표","대통령선거","경상남도","창원시성산구",981,740,414,58,117,57,88,0,0,0,0,0,1,0,0,735,5,241
"9280","반송동","관내사전투표","대통령선거","경상남도","창원시성산구",6164,6164,2952,1441,811,497,431,3,0,3,2,4,0,0,4,6148,16,0
"9281","반송동","반송동제1투","대통령선거","경상남도","창원시성산구",2071,1727,612,595,252,153,98,5,0,1,0,1,0,1,1,1719,8,344
"9282","반송동","반송동제2투","대통령선거","경상남도","창원시성산구",2294,1919,736,621,272,159,115,2,0,1,0,0,1,1,2,1910,9,375
"9283","반송동","반송동제3투","대통령선거","경상남도","창원시성산구",2040,1713,687,522,269,126,99,5,0,0,1,0,0,1,1,1711,2,327
"9284","반송동","반송동제4투","대통령선거","경상남도","창원시성산구",2114,1778,744,503,288,140,97,0,1,1,0,0,0,0,1,1775,3,336
"9285","반송동","반송동제5투","대통령선거","경상남도","창원시성산구",2082,1765,725,491,304,147,88,3,0,0,0,1,0,1,1,1761,4,317
"9286","반송동","반송동제6투","대통령선거","경상남도","창원시성산구",2229,1839,727,521,323,161,92,6,1,0,3,0,0,0,1,1835,4,390
"9287","반송동","반송동제7투","대통령선거","경상남도","창원시성산구",2605,2147,791,682,326,177,157,2,0,1,0,2,0,0,2,2140,7,458
"9288","반송동","반송동제8투","대통령선거","경상남도","창원시성산구",2799,2024,689,810,283,115,112,2,0,1,1,0,2,0,2,2017,7,775
"9289","반송동","반송동제9투","대통령선거","경상남도","창원시성산구",2634,1909,632,747,258,142,106,1,0,1,0,0,1,1,3,1892,17,725
"9290","반송동","반송동제10투","대통령선거","경상남도","창원시성산구",2603,1893,721,690,254,115,96,0,0,0,0,3,2,1,0,1882,11,710
"9291","반송동","반송동제11투","대통령선거","경상남도","창원시성산구",2688,2294,857,747,338,166,169,5,0,2,1,3,1,0,1,2290,4,394
"9292","중앙동","관내사전투표","대통령선거","경상남도","창원시성산구",3412,3412,1575,842,444,252,273,2,0,0,0,4,1,0,4,3397,15,0
"9293","중앙동","중앙동제1투","대통령선거","경상남도","창원시성산구",2437,1433,499,513,202,103,108,2,0,0,0,0,0,0,2,1429,4,1004
"9294","중앙동","중앙동제2투","대통령선거","경상남도","창원시성산구",2735,1487,510,533,223,117,98,1,0,0,0,0,0,1,1,1484,3,1248
"9295","중앙동","중앙동제3투","대통령선거","경상남도","창원시성산구",2306,1504,469,623,212,109,81,0,0,0,1,0,0,0,0,1495,9,802
"9296","중앙동","중앙동제4투","대통령선거","경상남도","창원시성산구",2580,1684,674,488,268,135,102,6,0,0,0,3,0,1,4,1681,3,896
"9297","중앙동","중앙동제5투","대통령선거","경상남도","창원시성산구",2250,1605,648,460,230,124,135,2,0,0,0,1,0,0,0,1600,5,645
"9298","중앙동","중앙동제6투","대통령선거","경상남도","창원시성산구",3138,2493,1023,627,430,214,183,1,0,4,1,0,0,1,0,2484,9,645
"9299","상남동","관내사전투표","대통령선거","경상남도","창원시성산구",6618,6618,3139,1479,912,550,481,7,3,3,3,7,1,2,4,6591,27,0
"9300","상남동","상남동제1투","대통령선거","경상남도","창원시성산구",2675,2118,863,570,322,178,171,1,0,0,0,3,0,0,2,2110,8,557
"9301","상남동","상남동제2투","대통령선거","경상남도","창원시성산구",2160,1578,624,497,211,130,106,2,0,0,0,0,0,1,0,1571,7,582
"9302","상남동","상남동제3투","대통령선거","경상남도","창원시성산구",2708,2204,817,664,396,191,124,2,0,1,1,0,0,1,1,2198,6,504
"9303","상남동","상남동제4투","대통령선거","경상남도","창원시성산구",2851,2261,807,741,405,181,111,3,1,0,1,2,1,0,2,2255,6,590
"9304","상남동","상남동제5투","대통령선거","경상남도","창원시성산구",3119,2478,1031,677,412,190,149,4,1,0,1,2,2,0,4,2473,5,641
"9305","상남동","상남동제6투","대통령선거","경상남도","창원시성산구",2993,2050,772,669,325,164,102,5,0,1,0,1,1,1,0,2041,9,943
"9306","사파동","관내사전투표","대통령선거","경상남도","창원시성산구",7024,7023,3482,1572,862,552,511,9,1,1,1,4,0,2,4,7001,22,1
"9307","사파동","사파동제1투","대통령선거","경상남도","창원시성산구",3909,2796,1073,878,425,228,175,3,0,2,0,2,0,0,2,2788,8,1113
"9308","사파동","사파동제2투","대통령선거","경상남도","창원시성산구",2746,2009,689,778,279,126,116,2,0,1,0,1,2,3,3,2000,9,737
"9309","사파동","사파동제3투","대통령선거","경상남도","창원시성산구",1670,1301,531,370,175,113,100,2,0,0,0,0,0,1,3,1295,6,369
"9310","사파동","사파동제4투","대통령선거","경상남도","창원시성산구",3009,2352,960,653,362,177,177,0,0,3,1,4,0,0,0,2337,15,657
"9311","사파동","사파동제5투","대통령선거","경상남도","창원시성산구",3196,2498,1014,755,348,208,148,1,0,1,0,6,0,1,3,2485,13,698
"9312","사파동","사파동제6투","대통령선거","경상남도","창원시성산구",2583,2142,859,607,317,179,163,1,0,0,0,4,1,1,2,2134,8,441
"9313","사파동","사파동제7투","대통령선거","경상남도","창원시성산구",2015,1294,412,514,216,74,65,0,0,0,0,2,1,1,1,1286,8,721
"9314","사파동","사파동제8투","대통령선거","경상남도","창원시성산구",2843,2224,938,607,330,162,170,1,0,1,0,0,1,4,3,2217,7,619
"9315","사파동","사파동제9투","대통령선거","경상남도","창원시성산구",2961,2408,1045,617,343,217,169,0,0,0,1,2,0,0,2,2396,12,553
"9316","사파동","사파동제10투","대통령선거","경상남도","창원시성산구",2407,2024,865,496,304,180,165,0,0,0,0,0,0,0,2,2012,12,383
"9317","사파동","사파동제11투","대통령선거","경상남도","창원시성산구",3031,2496,1100,559,397,203,220,3,0,0,0,1,1,1,1,2486,10,535
"9318","가음정동","관내사전투표","대통령선거","경상남도","창원시성산구",5706,5706,2807,1268,693,449,439,10,0,3,2,3,0,0,7,5681,25,0
"9319","가음정동","가음정동제1투","대통령선거","경상남도","창원시성산구",2129,1630,678,432,238,152,119,1,1,1,0,1,0,0,2,1625,5,499
"9320","가음정동","가음정동제2투","대통령선거","경상남도","창원시성산구",657,461,184,124,77,34,37,1,0,1,0,1,0,0,0,459,2,196
"9321","가음정동","가음정동제3투","대통령선거","경상남도","창원시성산구",2060,1567,571,510,234,120,119,3,0,0,0,2,2,0,0,1561,6,493
"9322","가음정동","가음정동제4투","대통령선거","경상남도","창원시성산구",3070,2461,1009,696,380,200,162,3,0,3,0,0,0,0,3,2456,5,609
"9323","가음정동","가음정동제5투","대통령선거","경상남도","창원시성산구",2810,2336,935,679,353,171,181,1,0,0,0,3,1,1,2,2327,9,474
"9324","가음정동","가음정동제6투","대통령선거","경상남도","창원시성산구",2472,2036,806,625,281,183,132,1,0,1,0,1,0,0,1,2031,5,436
"9325","가음정동","가음정동제7투","대통령선거","경상남도","창원시성산구",2450,1785,631,671,219,142,104,2,0,1,1,1,1,1,5,1779,6,665
"9326","가음정동","가음정동제8투","대통령선거","경상남도","창원시성산구",2310,1828,826,421,288,126,146,3,0,0,0,3,0,1,4,1818,10,482
"9327","가음정동","가음정동제9투","대통령선거","경상남도","창원시성산구",3368,2568,1023,718,404,190,210,2,0,1,0,0,1,1,5,2555,13,800
"9328","성주동","관내사전투표","대통령선거","경상남도","창원시성산구",3356,3356,1641,770,405,240,274,1,0,2,1,2,2,0,1,3339,17,0
"9329","성주동","성주동제1투","대통령선거","경상남도","창원시성산구",3063,2467,937,786,402,188,141,1,1,1,0,1,1,0,2,2461,6,596
"9330","성주동","성주동제2투","대통령선거","경상남도","창원시성산구",1628,1176,512,242,170,88,153,0,0,0,1,0,1,0,0,1167,9,452
"9331","성주동","성주동제3투","대통령선거","경상남도","창원시성산구",2984,2288,985,585,338,146,211,1,0,1,0,3,1,3,3,2277,11,696
"9332","성주동","성주동제4투","대통령선거","경상남도","창원시성산구",2073,1747,771,400,263,144,154,1,0,1,0,1,0,0,4,1739,8,326
"9333","성주동","성주동제5투","대통령선거","경상남도","창원시성산구",2832,2377,906,722,420,204,114,1,0,0,0,0,1,1,2,2371,6,455
"9334","성주동","성주동제6투","대통령선거","경상남도","창원시성산구",2391,1999,779,578,331,192,108,2,0,0,0,0,0,0,1,1991,8,392
"9335","웅남동","관내사전투표","대통령선거","경상남도","창원시성산구",1389,1389,579,424,188,91,93,1,0,0,1,1,0,0,2,1380,9,0
"9336","웅남동","웅남동제1투","대통령선거","경상남도","창원시성산구",1316,931,282,415,116,57,54,0,0,1,0,0,0,0,0,925,6,385
"9337","웅남동","웅남동제2투","대통령선거","경상남도","창원시성산구",1912,1451,546,492,203,98,104,0,0,0,0,1,0,1,1,1446,5,461
"9338","웅남동","웅남동제3투","대통령선거","경상남도","창원시성산구",1662,1276,441,488,176,82,70,4,0,1,0,2,0,0,3,1267,9,386
"9339","웅남동","웅남동제4투","대통령선거","경상남도","창원시성산구",571,451,138,168,64,39,33,1,0,1,0,0,2,0,2,448,3,120
"9340","잘못 투입·구분된 투표지","잘못 투입·구분된 투표지","대통령선거","경상남도","창원시성산구",0,0,0,0,0,0,0,0,0,0,0,0,0,0,0,0,0,0
"9341","거소·선상투표","거소·선상투표","대통령선거","경상남도","창원시마산합포구",472,433,103,142,108,27,18,4,0,1,1,1,0,2,8,415,18,39
"9342","관외사전투표","관외사전투표","대통령선거","경상남도","창원시마산합포구",11805,11805,4626,3237,1744,1089,945,12,1,5,3,15,1,6,26,11710,95,0
"9343","재외투표","재외투표","대통령선거","경상남도","창원시마산합포구",1086,657,350,60,137,28,78,1,0,0,0,0,0,0,1,655,2,429
"9344","구산면","관내사전투표","대통령선거","경상남도","창원시마산합포구",501,501,133,264,50,27,22,0,1,0,0,0,0,1,0,498,3,0
"9345","구산면","구산면제1투","대통령선거","경상남도","창원시마산합포구",1251,843,183,494,79,39,30,2,0,0,0,0,0,3,3,833,10,408
"9346","구산면","구산면제2투","대통령선거","경상남도","창원시마산합포구",2179,1451,257,965,123,56,26,0,0,3,2,1,0,3,5,1441,10,728
"9347","진동면","관내사전투표","대통령선거","경상남도","창원시마산합포구",2135,2135,790,834,262,113,117,3,0,2,1,2,1,1,5,2131,4,0
"9348","진동면","진동면제1투","대통령선거","경상남도","창원시마산합포구",936,662,133,428,55,29,9,0,1,0,0,1,0,1,0,657,5,274
"9349","진동면","진동면제2투","대통령선거","경상남도","창원시마산합포구",2841,1916,507,954,238,96,101,2,1,0,0,1,1,4,1,1906,10,925
"9350","진동면","진동면제3투","대통령선거","경상남도","창원시마산합포구",1830,1206,273,685,131,57,44,4,0,1,0,1,0,0,2,1198,8,624
"9351","진동면","진동면제4투","대통령선거","경상남도","창원시마산합포구",2424,1760,668,615,252,122,94,4,0,1,0,0,0,0,0,1756,4,664
"9352","진북면","관내사전투표","대통령선거","경상남도","창원시마산합포구",623,623,158,330,71,36,21,0,0,1,0,0,0,0,2,619,4,0
"9353","진북면","진북면제1투","대통령선거","경상남도","창원시마산합포구",1891,1186,251,702,129,50,40,0,0,0,2,1,2,0,2,1179,7,705
"9354","진북면","진북면제2투","대통령선거","경상남도","창원시마산합포구",781,462,79,307,35,21,10,0,1,0,1,0,0,3,0,457,5,319
"9355","진전면","관내사전투표","대통령선거","경상남도","창원시마산합포구",638,638,115,419,46,22,20,0,2,1,0,1,0,3,1,630,8,0
"9356","진전면","진전면제1투","대통령선거","경상남도","창원시마산합포구",1595,1019,212,636,87,43,23,1,0,2,1,0,2,2,2,1011,8,576
"9357","진전면","진전면제2투","대통령선거","경상남도","창원시마산합포구",1245,906,173,574,88,27,21,1,0,0,0,1,0,6,3,894,12,339
"9358","현동","관내사전투표","대통령선거","경상남도","창원시마산합포구",1436,1436,623,462,169,103,67,0,0,0,0,0,0,4,1,1429,7,0
"9359","현동","현동제1투","대통령선거","경상남도","창원시마산합포구",1763,1279,403,569,148,96,52,0,0,0,0,0,0,1,0,1269,10,484
"9360","현동","현동제2투","대통령선거","경상남도","창원시마산합포구",427,312,68,196,25,17,3,0,0,0,0,0,1,0,0,310,2,115
"9361","현동","현동제3투","대통령선거","경상남도","창원시마산합포구",3227,2387,834,916,327,171,119,4,0,1,1,0,1,1,3,2378,9,840
"9362","가포동","관내사전투표","대통령선거","경상남도","창원시마산합포구",336,336,124,131,42,24,13,0,0,1,0,0,0,0,0,335,1,0
"9363","가포동","가포동투표소","대통령선거","경상남도","창원시마산합포구",586,373,91,197,48,20,14,0,0,0,0,0,0,0,0,370,3,213
"9364","월영동","관내사전투표","대통령선거","경상남도","창원시마산합포구",4013,4013,1511,1320,482,352,322,1,1,0,1,0,0,0,2,3992,21,0
"9365","월영동","월영동제1투","대통령선거","경상남도","창원시마산합포구",1785,1155,306,551,168,79,42,1,0,0,1,2,0,0,1,1151,4,630
"9366","월영동","월영동제2투","대통령선거","경상남도","창원시마산합포구",2113,1360,322,713,165,77,66,2,0,0,2,1,0,0,6,1354,6,753
"9367","월영동","월영동제3투","대통령선거","경상남도","창원시마산합포구",1645,1204,359,541,148,90,56,1,0,1,0,0,1,0,3,1200,4,441
"9368","월영동","월영동제4투","대통령선거","경상남도","창원시마산합포구",2725,1983,616,864,262,122,102,4,0,3,1,1,0,0,0,1975,8,742
"9369","월영동","월영동제5투","대통령선거","경상남도","창원시마산합포구",2075,1628,476,741,222,118,66,0,0,0,1,1,0,0,1,1626,2,447
"9370","월영동","월영동제6투","대통령선거","경상남도","창원시마산합포구",2570,2016,689,796,280,150,84,1,0,1,0,1,0,0,1,2003,13,554
"9371","월영동","월영동제7투","대통령선거","경상남도","창원시마산합포구",2536,1987,647,808,261,143,111,3,0,1,0,0,3,1,1,1979,8,549
"9372","월영동","월영동제8투","대통령선거","경상남도","창원시마산합포구",2500,1964,673,689,321,150,121,1,0,0,1,0,0,1,3,1960,4,536
"9373","문화동","관내사전투표","대통령선거","경상남도","창원시마산합포구",2471,2471,824,1066,282,135,140,5,0,3,1,0,1,1,1,2459,12,0
"9374","문화동","문화동제1투","대통령선거","경상남도","창원시마산합포구",2736,1854,471,949,220,109,91,2,1,0,2,2,1,0,2,1850,4,882
"9375","문화동","문화동제2투","대통령선거","경상남도","창원시마산합포구",2264,1511,357,777,215,89,58,3,0,1,0,2,0,0,0,1502,9,753
"9376","문화동","문화동제3투","대통령선거","경상남도","창원시마산합포구",2806,2064,548,1034,249,139,75,1,0,0,4,0,0,2,4,2056,8,742
"9377","완월동","관내사전투표","대통령선거","경상남도","창원시마산합포구",1734,1734,593,706,174,127,114,0,1,2,2,0,1,0,5,1725,9,0
"9378","완월동","완월동제1투","대통령선거","경상남도","창원시마산합포구",1742,1098,252,604,129,53,38,7,0,1,0,1,2,0,3,1090,8,644
"9379","완월동","완월동제2투","대통령선거","경상남도","창원시마산합포구",2293,1646,386,894,185,84,78,3,1,2,0,3,0,0,3,1639,7,647
"9380","완월동","완월동제3투","대통령선거","경상남도","창원시마산합포구",2824,2083,539,1000,265,141,114,3,0,4,0,0,1,1,3,2071,12,741
"9381","자산동","관내사전투표","대통령선거","경상남도","창원시마산합포구",2099,2099,680,945,239,110,106,2,0,2,1,1,0,1,6,2093,6,0
"9382","자산동","자산동제1투","대통령선거","경상남도","창원시마산합포구",2702,2018,480,1016,283,135,89,2,1,2,1,0,1,0,2,2012,6,684
"9383","자산동","자산동제2투","대통령선거","경상남도","창원시마산합포구",1496,974,220,580,104,32,28,0,0,0,0,0,0,1,1,966,8,522
"9384","자산동","자산동제3투","대통령선거","경상남도","창원시마산합포구",1552,1088,274,571,139,55,44,0,1,0,1,0,0,0,0,1085,3,464
"9385","자산동","자산동제4투","대통령선거","경상남도","창원시마산합포구",2132,1516,437,746,171,84,59,3,0,1,3,1,0,0,1,1506,10,616
"9386","교방동","관내사전투표","대통령선거","경상남도","창원시마산합포구",1480,1480,534,593,176,97,74,1,0,0,1,0,1,0,2,1479,1,0
"9387","교방동","교방동제1투","대통령선거","경상남도","창원시마산합포구",2218,1467,337,806,181,71,61,2,0,1,2,0,0,1,0,1462,5,751
"9388","교방동","교방동제2투","대통령선거","경상남도","창원시마산합포구",2598,1945,653,841,226,130,82,0,0,2,0,0,0,0,3,1937,8,653
"9389","교방동","교방동제3투","대통령선거","경상남도","창원시마산합포구",1195,811,185,481,69,37,30,0,0,0,1,0,0,0,2,805,6,384
"9390","노산동","관내사전투표","대통령선거","경상남도","창원시마산합포구",823,823,256,403,78,41,34,1,0,0,0,0,0,4,0,817,6,0
"9391","노산동","노산동제1투","대통령선거","경상남도","창원시마산합포구",2460,1891,539,930,212,114,80,4,0,0,0,0,0,1,1,1881,10,569
"9392","노산동","노산동제2투","대통령선거","경상남도","창원시마산합포구",2335,1468,317,862,154,58,68,2,1,0,0,0,1,0,0,1463,5,867
"9393","합포동","관내사전투표","대통령선거","경상남도","창원시마산합포구",1948,1948,632,911,185,107,98,0,0,0,2,0,0,2,0,1937,11,0
"9394","합포동","합포동제1투","대통령선거","경상남도","창원시마산합포구",3093,2158,627,1017,265,144,90,0,0,0,0,0,0,1,5,2149,9,935
"9395","합포동","합포동제2투","대통령선거","경상남도","창원시마산합포구",2110,1223,273,720,143,34,39,0,1,1,1,0,0,0,3,1215,8,887
"9396","산호동","관내사전투표","대통령선거","경상남도","창원시마산합포구",1850,1850,644,769,206,111,102,0,0,1,0,0,1,1,4,1839,11,0
"9397","산호동","산호동제1투","대통령선거","경상남도","창원시마산합포구",2542,1853,492,958,202,85,108,0,0,0,1,0,0,0,1,1847,6,689
"9398","산호동","산호동제2투","대통령선거","경상남도","창원시마산합포구",1453,864,207,454,113,48,37,0,0,1,0,0,0,2,0,862,2,589
"9399","산호동","산호동제3투","대통령선거","경상남도","창원시마산합포구",2678,1898,537,887,245,112,94,3,0,0,0,1,0,0,3,1882,16,780
"9400","산호동","산호동제4투","대통령선거","경상남도","창원시마산합포구",2172,1383,372,676,184,64,80,0,1,1,0,1,0,0,0,1379,4,789
"9401","반월중앙동","관내사전투표","대통령선거","경상남도","창원시마산합포구",3032,3032,1045,1310,338,185,133,0,0,2,0,2,0,0,3,3018,14,0
"9402","반월중앙동","반월중앙동제1투","대통령선거","경상남도","창원시마산합포구",3174,2298,688,1031,298,162,107,0,0,0,0,0,0,0,2,2288,10,876
"9403","반월중앙동","반월중앙동제2투","대통령선거","경상남도","창원시마산합포구",1532,971,203,535,117,50,55,2,0,2,0,0,1,1,2,968,3,561
"9404","반월중앙동","반월중앙동제3투","대통령선거","경상남도","창원시마산합포구",2590,1818,508,899,184,142,70,4,0,1,0,2,1,0,0,1811,7,772
"9405","반월중앙동","반월중앙동제4투","대통령선거","경상남도","창원시마산합포구",2904,2254,670,1042,284,143,103,2,1,0,0,1,0,0,2,2248,6,650
"9406","오동동","관내사전투표","대통령선거","경상남도","창원시마산합포구",2099,2099,557,1126,214,108,79,4,1,0,1,0,1,1,2,2094,5,0
"9407","오동동","오동동제1투","대통령선거","경상남도","창원시마산합포구",2911,1832,385,1071,210,95,65,0,0,1,0,0,0,0,1,1828,4,1079
"9408","오동동","오동동제2투","대통령선거","경상남도","창원시마산합포구",2594,1896,510,969,246,92,66,1,0,1,1,1,1,0,0,1888,8,698
"9409","오동동","오동동제3투","대통령선거","경상남도","창원시마산합포구",1905,1568,450,695,250,117,51,1,0,0,0,0,0,0,1,1565,3,337
"9410","오동동","오동동제4투","대통령선거","경상남도","창원시마산합포구",2855,1879,400,1069,211,104,75,2,0,1,2,1,0,0,7,1872,7,976
"9411","오동동","오동동제5투","대통령선거","경상남도","창원시마산합포구",2451,1657,531,740,202,105,71,0,0,0,0,0,0,0,2,1651,6,794
"9412","오동동","오동동제6투","대통령선거","경상남도","창원시마산합포구",1828,1123,226,665,135,48,44,0,0,0,0,0,1,0,0,1119,4,705
"9413","잘못 투입·구분된 투표지","잘못 투입·구분된 투표지","대통령선거","경상남도","창원시마산합포구",0,0,0,0,0,0,0,0,0,0,0,0,0,0,0,0,0,0
"9414","거소·선상투표","거소·선상투표","대통령선거","경상남도","창원시마산회원구",529,495,125,178,109,47,13,0,0,0,0,2,1,0,5,480,15,34
"9415","관외사전투표","관외사전투표","대통령선거","경상남도","창원시마산회원구",13904,13902,5461,3580,2184,1362,1103,20,5,6,6,5,2,7,42,13783,119,2
"9416","재외투표","재외투표","대통령선거","경상남도","창원시마산회원구",688,511,273,41,98,32,60,2,0,0,0,0,0,0,0,506,5,177
"9417","내서읍","관내사전투표","대통령선거","경상남도","창원시마산회원구",7478,7478,3303,2152,854,619,476,6,1,6,1,3,1,1,14,7437,41,0
"9418","내서읍","내서읍제1투","대통령선거","경상남도","창원시마산회원구",416,324,65,198,37,8,12,1,0,0,0,0,0,1,1,323,1,92
"9419","내서읍","내서읍제2투","대통령선거","경상남도","창원시마산회원구",3505,2833,1008,1031,460,169,147,0,1,0,0,2,1,1,4,2824,9,672
"9420","내서읍","내서읍제3투","대통령선거","경상남도","창원시마산회원구",2281,1723,636,680,214,107,69,4,0,1,0,2,1,1,1,1716,7,558
"9421","내서읍","내서읍제4투","대통령선거","경상남도","창원시마산회원구",3046,2570,947,942,351,171,148,5,0,0,0,1,0,1,1,2567,3,476
"9422","내서읍","내서읍제5투","대통령선거","경상남도","창원시마산회원구",2938,2186,684,957,290,124,111,1,0,1,0,1,2,1,4,2176,10,752
"9423","내서읍","내서읍제6투","대통령선거","경상남도","창원시마산회원구",2450,1821,513,884,209,113,82,1,0,0,2,0,1,1,4,1810,11,629
"9424","내서읍","내서읍제7투","대통령선거","경상남도","창원시마산회원구",2883,1948,556,900,221,168,83,0,0,2,0,0,1,0,3,1934,14,935
"9425","내서읍","내서읍제8투","대통령선거","경상남도","창원시마산회원구",3120,2246,729,903,312,139,139,1,0,5,0,2,0,0,2,2232,14,874
"9426","내서읍","내서읍제9투","대통령선거","경상남도","창원시마산회원구",2642,1800,492,886,234,92,70,1,1,0,1,0,1,1,6,1785,15,842
"9427","내서읍","내서읍제10투","대통령선거","경상남도","창원시마산회원구",4151,3168,1112,1144,445,258,190,2,0,2,1,0,0,0,5,3159,9,983
"9428","내서읍","내서읍제11투","대통령선거","경상남도","창원시마산회원구",2800,2119,803,691,318,167,131,1,0,0,0,0,0,0,1,2112,7,681
"9429","내서읍","내서읍제12투","대통령선거","경상남도","창원시마산회원구",3902,3014,1098,1017,449,245,175,1,1,1,1,2,3,1,6,3000,14,888
"9430","내서읍","내서읍제13투","대통령선거","경상남도","창원시마산회원구",3629,2901,1137,959,406,211,169,2,0,1,1,6,0,0,5,2897,4,728
"9431","내서읍","내서읍제14투","대통령선거","경상남도","창원시마산회원구",3321,2709,1163,762,399,210,169,1,0,0,0,1,0,0,0,2705,4,612
"9432","내서읍","내서읍제15투","대통령선거","경상남도","창원시마산회원구",633,497,100,303,55,17,17,0,0,0,0,1,1,1,0,495,2,136
"9433","회원1동","관내사전투표","대통령선거","경상남도","창원시마산회원구",1871,1871,573,913,196,92,79,3,1,0,0,0,1,4,1,1863,8,0
"9434","회원1동","회원1동제1투","대통령선거","경상남도","창원시마산회원구",2918,2116,426,1216,246,127,85,2,1,0,0,0,1,3,0,2107,9,802
"9435","회원1동","회원1동제2투","대통령선거","경상남도","창원시마산회원구",2861,1929,462,1090,222,84,56,3,0,0,0,1,1,0,3,1922,7,932
"9436","회원1동","회원1동제3투","대통령선거","경상남도","창원시마산회원구",2285,1561,384,797,219,85,56,2,0,2,0,2,2,0,3,1552,9,724
"9437","회원2동","관내사전투표","대통령선거","경상남도","창원시마산회원구",1589,1589,541,734,137,98,66,3,1,0,0,0,1,0,2,1583,6,0
"9438","회원2동","회원2동제1투","대통령선거","경상남도","창원시마산회원구",1547,963,205,572,105,50,24,0,1,0,0,0,2,0,3,962,1,584
"9439","회원2동","회원2동제2투","대통령선거","경상남도","창원시마산회원구",1807,1262,336,656,143,62,53,1,0,2,1,0,0,0,2,1256,6,545
"9440","회원2동","회원2동제3투","대통령선거","경상남도","창원시마산회원구",2398,1632,356,950,163,79,71,2,0,0,0,0,0,1,0,1622,10,766
"9441","회원2동","회원2동제4투","대통령선거","경상남도","창원시마산회원구",2028,1393,359,732,148,75,67,2,0,0,0,1,0,0,4,1388,5,635
"9442","회성동","관내사전투표","대통령선거","경상남도","창원시마산회원구",1281,1281,394,646,110,61,50,2,1,3,1,0,1,1,3,1273,8,0
"9443","회성동","회성동제1투","대통령선거","경상남도","창원시마산회원구",2355,1580,385,850,186,88,57,2,0,0,1,0,2,0,4,1575,5,775
"9444","회성동","회성동제2투","대통령선거","경상남도","창원시마산회원구",2012,1384,330,778,150,59,52,2,0,1,3,0,0,2,2,1379,5,628
"9445","회성동","회성동제3투","대통령선거","경상남도","창원시마산회원구",708,480,119,266,48,27,17,0,0,0,0,0,0,0,0,477,3,228
"9446","양덕1동","관내사전투표","대통령선거","경상남도","창원시마산회원구",1996,1996,663,860,222,146,89,2,0,1,0,3,0,0,4,1990,6,0
"9447","양덕1동","양덕1동제1투","대통령선거","경상남도","창원시마산회원구",2661,1656,486,805,200,93,60,0,0,0,2,0,0,1,4,1651,5,1005
"9448","양덕1동","양덕1동제2투","대통령선거","경상남도","창원시마산회원구",2548,1815,523,879,198,103,95,1,0,1,2,3,1,1,0,1807,8,733
"9449","양덕1동","양덕1동제3투","대통령선거","경상남도","창원시마산회원구",2659,1806,555,806,234,124,76,1,1,1,0,0,1,0,3,1802,4,853
"9450","양덕2동","관내사전투표","대통령선거","경상남도","창원시마산회원구",4637,4637,1872,1533,565,348,286,1,0,5,1,3,0,3,7,4624,13,0
"9451","양덕2동","양덕2동제1투","대통령선거","경상남도","창원시마산회원구",3540,2775,1012,998,414,194,149,0,0,0,0,0,1,1,1,2770,5,765
"9452","양덕2동","양덕2동제2투","대통령선거","경상남도","창원시마산회원구",2689,2139,625,960,302,160,72,6,0,1,2,2,0,0,1,2131,8,550
"9453","양덕2동","양덕2동제3투","대통령선거","경상남도","창원시마산회원구",2492,1733,495,793,222,125,83,0,0,1,0,1,0,1,1,1722,11,759
"9454","양덕2동","양덕2동제4투","대통령선거","경상남도","창원시마산회원구",2165,1642,499,719,225,99,85,3,0,1,0,1,1,1,0,1634,8,523
"9455","양덕2동","양덕2동제5투","대통령선거","경상남도","창원시마산회원구",2512,1781,547,783,227,119,90,2,1,2,1,1,0,2,1,1776,5,731
"9456","양덕2동","양덕2동제6투","대통령선거","경상남도","창원시마산회원구",3757,3159,965,1389,472,209,105,4,1,1,1,0,0,0,2,3149,10,598
"9457","양덕2동","양덕2동제7투","대통령선거","경상남도","창원시마산회원구",3203,2700,1036,906,418,201,131,0,0,1,0,1,0,0,2,2696,4,503
"9458","합성1동","관내사전투표","대통령선거","경상남도","창원시마산회원구",1423,1423,499,578,150,95,88,0,0,1,3,0,1,2,1,1418,5,0
"9459","합성1동","합성1동제1투","대통령선거","경상남도","창원시마산회원구",2328,1491,425,726,185,75,65,0,0,1,0,0,1,2,2,1482,9,837
"9460","합성1동","합성1동제2투","대통령선거","경상남도","창원시마산회원구",2558,1726,447,856,247,99,57,2,0,3,0,0,0,4,2,1717,9,832
"9461","합성2동","관내사전투표","대통령선거","경상남도","창원시마산회원구",1912,1912,627,814,215,106,132,2,0,1,0,0,1,0,3,1901,11,0
"9462","합성2동","합성2동제1투","대통령선거","경상남도","창원시마산회원구",2089,1377,384,655,178,87,62,3,0,0,2,1,1,0,1,1374,3,712
"9463","합성2동","합성2동제2투","대통령선거","경상남도","창원시마산회원구",2363,1524,377,798,191,79,65,0,1,1,1,1,0,0,2,1516,8,839
"9464","합성2동","합성2동제3투","대통령선거","경상남도","창원시마산회원구",2067,1367,364,655,187,82,61,2,1,0,0,1,0,0,1,1354,13,700
"9465","구암1동","관내사전투표","대통령선거","경상남도","창원시마산회원구",1492,1492,556,582,174,83,81,3,0,1,2,1,0,2,2,1487,5,0
"9466","구암1동","구암1동제1투","대통령선거","경상남도","창원시마산회원구",2440,1690,468,809,217,87,88,3,1,0,0,2,0,2,1,1678,12,750
"9467","구암1동","구암1동제2투","대통령선거","경상남도","창원시마산회원구",1792,1262,328,647,141,74,58,3,0,4,1,1,0,1,0,1258,4,530
"9468","구암1동","구암1동제3투","대통령선거","경상남도","창원시마산회원구",2979,2228,730,967,279,114,119,0,0,2,0,0,3,0,1,2215,13,751
"9469","구암2동","관내사전투표","대통령선거","경상남도","창원시마산회원구",1282,1282,556,421,132,91,72,1,1,1,0,2,0,1,0,1278,4,0
"9470","구암2동","구암2동제1투","대통령선거","경상남도","창원시마산회원구",2353,1749,501,793,229,125,86,2,0,1,1,1,0,0,0,1739,10,604
"9471","구암2동","구암2동제2투","대통령선거","경상남도","창원시마산회원구",3041,2267,740,947,282,158,108,2,0,3,1,0,2,0,4,2247,20,774
"9472","구암2동","구암2동제3투","대통령선거","경상남도","창원시마산회원구",1597,1125,327,529,138,62,53,2,1,0,0,0,0,2,2,1116,9,472
"9473","봉암동","관내사전투표","대통령선거","경상남도","창원시마산회원구",634,634,248,243,74,31,31,0,0,0,0,1,0,1,0,629,5,0
"9474","봉암동","봉암동제1투","대통령선거","경상남도","창원시마산회원구",1146,738,247,313,101,36,36,1,0,0,1,0,1,0,0,736,2,408
"9475","봉암동","봉암동제2투","대통령선거","경상남도","창원시마산회원구",1616,1026,285,512,127,50,39,2,0,1,0,1,0,3,2,1022,4,590
"9476","석전동","관내사전투표","대통령선거","경상남도","창원시마산회원구",2187,2187,690,1006,240,121,106,3,0,1,3,1,0,0,1,2172,15,0
"9477","석전동","석전동제1투","대통령선거","경상남도","창원시마산회원구",1381,992,275,497,98,66,48,0,0,0,0,1,1,0,2,988,4,389
"9478","석전동","석전동제2투","대통령선거","경상남도","창원시마산회원구",824,529,128,282,69,29,15,1,0,1,1,0,0,0,1,527,2,295
"9479","석전동","석전동제3투","대통령선거","경상남도","창원시마산회원구",1779,1302,345,686,139,58,64,0,0,0,0,0,1,4,0,1297,5,477
"9480","석전동","석전동제4투","대통령선거","경상남도","창원시마산회원구",1546,1122,271,578,125,78,57,1,1,1,0,1,0,2,0,1115,7,424
"9481","석전동","석전동제5투","대통령선거","경상남도","창원시마산회원구",1747,1187,314,599,152,58,51,0,0,1,1,1,0,2,3,1182,5,560
"9482","석전동","석전동제6투","대통령선거","경상남도","창원시마산회원구",2895,2000,529,1008,257,117,72,1,0,1,0,4,0,1,2,1992,8,895
"9483","잘못 투입·구분된 투표지","잘못 투입·구분된 투표지","대통령선거","경상남도","창원시마산회원구",0,0,0,0,0,0,0,0,0,0,0,0,0,0,0,0,0,0
"9484","거소·선상투표","거소·선상투표","대통령선거","경상남도","창원시진해구",1832,1793,464,458,491,209,61,2,3,2,3,6,0,3,31,1733,60,39
"9485","관외사전투표","관외사전투표","대통령선거","경상남도","창원시진해구",10633,10633,4450,2469,1665,1133,788,12,1,3,5,1,4,5,22,10558,75,0
"9486","재외투표","재외투표","대통령선거","경상남도","창원시진해구",765,556,278,55,120,44,54,0,0,0,0,0,0,3,1,555,1,209
"9487","중앙동","관내사전투표","대통령선거","경상남도","창원시진해구",1809,1809,618,481,335,248,96,2,0,1,0,1,3,0,7,1792,17,0
"9488","중앙동","중앙동투표소","대통령선거","경상남도","창원시진해구",3580,2503,765,873,438,272,127,2,0,2,4,1,0,0,7,2491,12,1077
"9489","태평동","관내사전투표","대통령선거","경상남도","창원시진해구",1433,1433,452,547,205,145,59,1,0,2,0,2,1,0,9,1423,10,0
"9490","태평동","태평동제1투","대통령선거","경상남도","창원시진해구",2006,1359,318,693,173,101,50,4,1,2,0,0,2,0,1,1345,14,647
"9491","태평동","태평동제2투","대통령선거","경상남도","창원시진해구",1972,1426,374,688,211,75,64,3,0,5,0,0,0,1,0,1421,5,546
"9492","충무동","관내사전투표","대통령선거","경상남도","창원시진해구",1085,1085,328,499,142,61,42,0,0,1,1,0,0,1,3,1078,7,0
"9493","충무동","충무동투표소","대통령선거","경상남도","창원시진해구",2645,1645,380,903,218,75,53,7,0,2,0,3,0,0,0,1641,4,1000
"9494","여좌동","관내사전투표","대통령선거","경상남도","창원시진해구",1819,1819,558,790,252,109,91,0,0,1,0,0,0,0,11,1812,7,0
"9495","여좌동","여좌동제1투","대통령선거","경상남도","창원시진해구",1373,948,219,532,114,45,30,1,0,1,0,0,0,2,0,944,4,425
"9496","여좌동","여좌동제2투","대통령선거","경상남도","창원시진해구",2513,1623,414,778,248,98,72,1,0,0,0,0,2,0,1,1614,9,890
"9497","여좌동","여좌동제3투","대통령선거","경상남도","창원시진해구",2563,1778,432,914,258,90,70,1,1,2,1,1,0,0,4,1774,4,785
"9498","태백동","관내사전투표","대통령선거","경상남도","창원시진해구",987,987,330,426,127,62,31,0,0,0,1,1,1,1,2,982,5,0
"9499","태백동","태백동제1투","대통령선거","경상남도","창원시진해구",2203,1420,317,780,175,68,60,2,0,1,1,0,1,2,2,1409,11,783
"9500","태백동","태백동제2투","대통령선거","경상남도","창원시진해구",1977,1300,288,726,154,73,42,4,0,1,1,1,1,2,2,1295,5,677
"9501","경화동","관내사전투표","대통령선거","경상남도","창원시진해구",1771,1771,677,600,222,143,113,3,1,1,0,0,1,1,3,1765,6,0
"9502","경화동","경화동제1투","대통령선거","경상남도","창원시진해구",2919,1889,457,975,254,102,81,0,0,2,1,0,0,0,4,1876,13,1030
"9503","경화동","경화동제2투","대통령선거","경상남도","창원시진해구",3659,2771,978,982,447,185,162,2,0,1,1,2,0,1,1,2762,9,888
"9504","병암동","관내사전투표","대통령선거","경상남도","창원시진해구",1503,1503,545,600,189,83,69,3,0,2,0,0,0,1,6,1498,5,0
"9505","병암동","병암동제1투","대통령선거","경상남도","창원시진해구",2323,1603,513,684,233,78,79,2,0,1,1,2,0,0,0,1593,10,720
"9506","병암동","병암동제2투","대통령선거","경상남도","창원시진해구",2483,1621,512,617,255,141,80,2,0,1,1,0,0,1,1,1611,10,862
"9507","석동","관내사전투표","대통령선거","경상남도","창원시진해구",2903,2902,1315,735,381,237,218,2,1,1,1,0,0,0,3,2894,8,1
"9508","석동","석동제1투","대통령선거","경상남도","창원시진해구",3756,2516,886,881,400,201,127,4,0,1,0,0,0,1,2,2503,13,1240
"9509","석동","석동제2투","대통령선거","경상남도","창원시진해구",3199,2473,963,731,432,184,149,1,0,2,0,0,0,2,2,2466,7,726
"9510","석동","석동제3투","대통령선거","경상남도","창원시진해구",3103,2513,955,809,420,218,104,1,0,0,2,1,0,0,0,2510,3,590
"9511","이동","관내사전투표","대통령선거","경상남도","창원시진해구",1525,1525,553,590,190,97,84,3,0,0,1,3,0,0,2,1523,2,0
"9512","이동","이동제1투","대통령선거","경상남도","창원시진해구",2284,1392,439,595,201,68,74,1,0,2,0,1,0,0,0,1381,11,892
"9513","이동","이동제2투","대통령선거","경상남도","창원시진해구",2109,1417,366,655,234,75,68,1,1,1,0,1,0,2,3,1407,10,692
"9514","이동","이동제3투","대통령선거","경상남도","창원시진해구",2416,1657,435,815,226,97,73,3,0,1,0,0,0,0,2,1652,5,759
"9515","자은동","관내사전투표","대통령선거","경상남도","창원시진해구",2129,2129,876,621,314,184,122,2,1,0,0,1,0,0,1,2122,7,0
"9516","자은동","자은동제1투","대통령선거","경상남도","창원시진해구",2886,2093,695,804,291,161,124,3,0,0,1,0,1,0,1,2081,12,793
"9517","자은동","자은동제2투","대통령선거","경상남도","창원시진해구",3778,2681,879,1071,374,190,137,2,0,1,3,5,1,2,2,2667,14,1097
"9518","자은동","자은동제3투","대통령선거","경상남도","창원시진해구",2834,2378,1085,519,408,213,146,0,0,1,0,0,0,0,1,2373,5,456
"9519","덕산동","관내사전투표","대통령선거","경상남도","창원시진해구",1883,1883,710,638,255,133,122,3,0,3,0,2,2,1,3,1872,11,0
"9520","덕산동","덕산동제1투","대통령선거","경상남도","창원시진해구",3386,2335,717,945,365,152,136,0,0,2,0,2,0,2,1,2322,13,1051
"9521","덕산동","덕산동제2투","대통령선거","경상남도","창원시진해구",2546,1748,597,675,247,123,83,1,3,3,0,2,2,0,3,1739,9,798
"9522","풍호동","관내사전투표","대통령선거","경상남도","창원시진해구",3650,3650,1576,1065,494,297,196,1,0,1,1,0,0,4,3,3638,12,0
"9523","풍호동","풍호동제1투","대통령선거","경상남도","창원시진해구",3307,2380,825,926,338,165,107,3,0,2,0,0,0,1,3,2370,10,927
"9524","풍호동","풍호동제2투","대통령선거","경상남도","창원시진해구",2888,2302,730,884,372,170,120,4,0,3,0,2,0,1,2,2288,14,586
"9525","풍호동","풍호동제3투","대통령선거","경상남도","창원시진해구",4064,3183,1239,997,517,262,151,2,0,1,1,1,1,0,2,3174,9,881
"9526","풍호동","풍호동제4투","대통령선거","경상남도","창원시진해구",3908,3167,1346,748,569,292,199,0,0,0,0,1,0,0,3,3158,9,741
"9527","웅천동","관내사전투표","대통령선거","경상남도","창원시진해구",760,760,193,417,72,38,32,1,0,0,1,0,1,3,0,758,2,0
"9528","웅천동","웅천동제1투","대통령선거","경상남도","창원시진해구",1775,1122,260,639,134,48,30,1,0,0,0,0,1,2,3,1118,4,653
"9529","웅천동","웅천동제2투","대통령선거","경상남도","창원시진해구",785,497,102,318,38,23,12,1,0,0,0,0,0,1,0,495,2,288
"9530","웅동1동","관내사전투표","대통령선거","경상남도","창원시진해구",1331,1331,544,445,185,86,57,1,0,1,0,1,0,2,3,1325,6,0
"9531","웅동1동","웅동1동제1투","대통령선거","경상남도","창원시진해구",2305,1544,562,560,245,86,74,2,0,1,0,1,0,2,5,1538,6,761
"9532","웅동1동","웅동1동제2투","대통령선거","경상남도","창원시진해구",1639,998,309,446,124,59,50,1,0,2,0,0,0,2,0,993,5,641
"9533","웅동2동","관내사전투표","대통령선거","경상남도","창원시진해구",4248,4248,2181,940,546,285,276,1,0,0,2,1,2,1,3,4238,10,0
"9534","웅동2동","웅동2동제1투","대통령선거","경상남도","창원시진해구",3075,1699,612,589,287,114,81,3,2,2,1,0,1,1,0,1693,6,1376
"9535","웅동2동","웅동2동제2투","대통령선거","경상남도","창원시진해구",4215,2884,1009,973,502,201,169,3,2,2,0,1,1,3,3,2869,15,1331
"9536","웅동2동","웅동2동제3투","대통령선거","경상남도","창원시진해구",3427,2600,1189,618,418,204,159,1,0,2,0,1,2,1,1,2596,4,827
"9537","웅동2동","웅동2동제4투","대통령선거","경상남도","창원시진해구",3043,2093,1023,434,338,164,115,2,0,2,2,2,0,3,1,2086,7,950
"9538","웅동2동","웅동2동제5투","대통령선거","경상남도","창원시진해구",2341,1644,731,421,272,118,96,0,0,2,0,0,0,1,1,1642,2,697
"9539","웅동2동","웅동2동제6투","대통령선거","경상남도","창원시진해구",3587,1759,680,474,320,147,121,0,0,0,1,3,0,1,4,1751,8,1828
"9540","잘못 투입·구분된 투표지","잘못 투입·구분된 투표지","대통령선거","경상남도","창원시진해구",0,1,0,1,0,0,0,0,0,0,0,0,0,0,0,1,0,-1
"9541","거소·선상투표","거소·선상투표","대통령선거","경상남도","진주시",713,662,213,210,139,34,14,3,3,2,0,3,0,3,3,627,35,51
"9542","관외사전투표","관외사전투표","대통령선거","경상남도","진주시",19274,19274,8191,4473,2950,1896,1484,16,6,8,6,16,5,9,47,19107,167,0
"9543","재외투표","재외투표","대통령선거","경상남도","진주시",1547,1069,592,97,217,34,122,3,0,0,0,1,1,0,0,1067,2,478
"9544","문산읍","관내사전투표","대통령선거","경상남도","진주시",1641,1641,626,594,197,111,92,4,0,2,0,1,1,2,2,1632,9,0
"9545","문산읍","문산읍제1투","대통령선거","경상남도","진주시",3261,2119,582,1054,238,113,90,6,1,2,1,1,3,10,5,2106,13,1142
"9546","문산읍","문산읍제2투","대통령선거","경상남도","진주시",2247,1647,521,773,175,88,74,2,0,1,1,2,0,2,1,1640,7,600
"9547","내동면","관내사전투표","대통령선거","경상남도","진주시",1115,1115,434,458,117,60,37,0,0,0,2,0,0,0,3,1111,4,0
"9548","내동면","내동면투표소","대통령선거","경상남도","진주시",2216,1635,460,766,212,104,66,4,1,1,0,0,1,1,4,1620,15,581
"9549","정촌면","관내사전투표","대통령선거","경상남도","진주시",1174,1174,385,563,93,66,54,1,0,0,0,1,0,1,7,1171,3,0
"9550","정촌면","정촌면투표소","대통령선거","경상남도","진주시",1863,1259,268,753,138,40,30,0,1,3,1,1,0,4,2,1241,18,604
"9551","금곡면","관내사전투표","대통령선거","경상남도","진주시",409,409,120,206,40,19,13,0,1,0,0,2,0,3,1,405,4,0
"9552","금곡면","금곡면투표소","대통령선거","경상남도","진주시",1701,1215,270,736,113,49,31,1,0,0,0,2,1,6,1,1210,5,486
"9553","진성면","관내사전투표","대통령선거","경상남도","진주시",552,552,174,274,50,22,22,0,0,0,0,3,1,2,1,549,3,0
"9554","진성면","진성면투표소","대통령선거","경상남도","진주시",1428,965,208,588,84,34,28,1,0,0,2,5,1,1,4,956,9,463
"9555","일반성면","관내사전투표","대통령선거","경상남도","진주시",880,880,282,443,78,35,26,2,0,1,2,0,2,2,3,876,4,0
"9556","일반성면","일반성면투표소","대통령선거","경상남도","진주시",1784,1215,289,698,130,41,32,0,1,1,1,1,2,2,3,1201,14,569
"9557","이반성면","관내사전투표","대통령선거","경상남도","진주시",273,273,91,131,24,17,9,0,0,1,0,0,0,0,0,273,0,0
"9558","이반성면","이반성면투표소","대통령선거","경상남도","진주시",1197,829,215,442,84,38,22,0,0,1,0,0,1,8,3,814,15,368
"9559","사봉면","관내사전투표","대통령선거","경상남도","진주시",356,356,113,186,29,13,10,2,0,0,1,1,0,1,0,356,0,0
"9560","사봉면","사봉면투표소","대통령선거","경상남도","진주시",1081,746,167,413,96,39,11,1,1,1,5,1,0,5,3,743,3,335
"9561","지수면","관내사전투표","대통령선거","경상남도","진주시",313,313,96,155,34,17,4,1,0,0,0,4,0,0,1,312,1,0
"9562","지수면","지수면투표소","대통령선거","경상남도","진주시",1081,720,182,395,73,29,22,2,0,2,1,1,1,2,3,713,7,361
"9563","대곡면","관내사전투표","대통령선거","경상남도","진주시",602,602,170,306,67,32,21,0,0,0,0,0,0,1,1,598,4,0
"9564","대곡면","대곡면투표소","대통령선거","경상남도","진주시",2572,1700,385,979,185,57,50,3,1,0,1,0,2,10,8,1681,19,872
"9565","금산면","관내사전투표","대통령선거","경상남도","진주시",3451,3451,1501,1115,388,239,177,3,1,0,2,8,0,1,3,3438,13,0
"9566","금산면","금산면제1투","대통령선거","경상남도","진주시",2687,1812,496,933,176,109,71,0,1,1,0,5,1,3,3,1799,13,875
"9567","금산면","금산면제2투","대통령선거","경상남도","진주시",3442,2457,782,1037,345,155,114,0,0,2,2,5,1,2,3,2448,9,985
"9568","금산면","금산면제3투","대통령선거","경상남도","진주시",2404,1791,613,703,240,122,89,2,1,1,2,6,0,0,2,1781,10,613
"9569","금산면","금산면제4투","대통령선거","경상남도","진주시",3176,2486,1045,797,362,144,129,2,0,0,0,1,1,1,1,2483,3,690
"9570","집현면","관내사전투표","대통령선거","경상남도","진주시",739,739,234,356,75,35,30,0,1,0,0,1,1,4,1,738,1,0
"9571","집현면","집현면투표소","대통령선거","경상남도","진주시",3118,2062,525,1113,213,90,84,1,0,1,1,3,0,16,4,2051,11,1056
"9572","미천면","관내사전투표","대통령선거","경상남도","진주시",173,173,58,74,22,11,6,0,0,0,0,0,0,0,0,171,2,0
"9573","미천면","미천면투표소","대통령선거","경상남도","진주시",1249,818,131,521,83,36,16,0,1,3,0,3,2,11,4,811,7,431
"9574","명석면","관내사전투표","대통령선거","경상남도","진주시",776,776,237,383,80,32,28,0,0,2,1,1,3,4,0,771,5,0
"9575","명석면","명석면투표소","대통령선거","경상남도","진주시",2931,1972,376,1244,183,70,70,2,0,1,0,2,4,8,5,1965,7,959
"9576","대평면","관내사전투표","대통령선거","경상남도","진주시",325,325,81,171,33,13,16,1,0,0,0,0,1,0,3,319,6,0
"9577","대평면","대평면투표소","대통령선거","경상남도","진주시",729,509,105,317,46,18,12,1,0,0,0,0,0,2,3,504,5,220
"9578","수곡면","관내사전투표","대통령선거","경상남도","진주시",414,414,129,228,33,8,8,0,0,1,2,0,0,2,1,412,2,0
"9579","수곡면","수곡면투표소","대통령선거","경상남도","진주시",1652,1131,271,648,100,42,43,0,0,0,2,1,2,6,6,1121,10,521
"9580","중앙동","관내사전투표","대통령선거","경상남도","진주시",2286,2286,626,1251,173,101,103,1,3,2,3,3,0,4,5,2275,11,0
"9581","중앙동","중앙동제1투","대통령선거","경상남도","진주시",2442,1566,288,998,177,51,39,2,0,1,1,0,1,0,1,1559,7,876
"9582","중앙동","중앙동제2투","대통령선거","경상남도","진주시",2845,1946,380,1222,177,78,65,1,1,0,0,0,1,5,1,1931,15,899
"9583","중앙동","중앙동제3투","대통령선거","경상남도","진주시",1966,1249,231,772,135,64,31,0,0,1,2,0,1,3,2,1242,7,717
"9584","중앙동","중앙동제4투","대통령선거","경상남도","진주시",1922,1266,265,758,131,55,39,1,0,2,0,0,1,4,2,1258,8,656
"9585","상평동","관내사전투표","대통령선거","경상남도","진주시",2033,2033,710,873,220,127,95,0,0,0,2,0,1,0,2,2030,3,0
"9586","상평동","상평동제1투","대통령선거","경상남도","진주시",2153,1388,328,761,149,71,65,0,0,0,1,1,1,1,2,1380,8,765
"9587","상평동","상평동제2투","대통령선거","경상남도","진주시",2590,1783,389,1039,173,110,55,1,0,0,1,0,1,0,2,1771,12,807
"9588","상평동","상평동제3투","대통령선거","경상남도","진주시",3200,2368,716,1099,293,137,112,2,0,1,0,1,1,0,2,2364,4,832
"9589","초장동","관내사전투표","대통령선거","경상남도","진주시",4095,4095,1780,1243,456,342,242,4,0,0,2,3,0,2,1,4075,20,0
"9590","초장동","초장동제1투","대통령선거","경상남도","진주시",2980,2116,654,947,268,134,84,2,0,1,2,0,1,7,2,2102,14,864
"9591","초장동","초장동제2투","대통령선거","경상남도","진주시",2415,1859,570,790,224,165,90,1,0,0,1,1,0,2,2,1846,13,556
"9592","초장동","초장동제3투","대통령선거","경상남도","진주시",2526,2038,761,716,314,163,75,1,0,0,0,0,0,1,1,2032,6,488
"9593","초장동","초장동제4투","대통령선거","경상남도","진주시",3414,2775,1139,896,372,210,149,3,1,0,1,1,0,0,1,2773,2,639
"9594","평거동","관내사전투표","대통령선거","경상남도","진주시",4521,4521,2073,1332,474,341,268,3,0,0,2,4,0,0,2,4499,22,0
"9595","평거동","평거동제1투","대통령선거","경상남도","진주시",2695,1819,488,890,227,114,77,1,0,0,1,2,1,1,3,1805,14,876
"9596","평거동","평거동제2투","대통령선거","경상남도","진주시",3384,2584,962,936,392,167,111,0,0,0,0,0,2,1,3,2574,10,800
"9597","평거동","평거동제3투","대통령선거","경상남도","진주시",2755,2126,730,808,319,156,93,2,0,1,0,2,1,0,1,2113,13,629
"9598","평거동","평거동제4투","대통령선거","경상남도","진주시",3129,2236,762,837,308,184,123,1,2,2,0,2,0,0,3,2224,12,893
"9599","평거동","평거동제5투","대통령선거","경상남도","진주시",3123,2351,818,882,326,180,131,3,1,1,0,2,0,2,0,2346,5,772
"9600","신안동","관내사전투표","대통령선거","경상남도","진주시",2946,2946,1075,1189,265,213,175,3,0,3,0,4,1,3,3,2934,12,0
"9601","신안동","신안동제1투","대통령선거","경상남도","진주시",3209,2443,718,1096,316,174,116,6,0,1,1,0,0,2,1,2431,12,766
"9602","신안동","신안동제2투","대통령선거","경상남도","진주시",2427,1827,454,935,229,117,82,1,1,1,0,0,0,0,3,1823,4,600
"9603","신안동","신안동제3투","대통령선거","경상남도","진주시",2146,1482,403,741,184,94,44,3,0,1,1,3,0,1,1,1476,6,664
"9604","이현동","관내사전투표","대통령선거","경상남도","진주시",2359,2359,757,1086,239,146,110,5,0,0,1,1,0,5,0,2350,9,0
"9605","이현동","이현동제1투","대통령선거","경상남도","진주시",2852,2181,701,939,299,141,85,4,0,1,0,2,1,0,3,2176,5,671
"9606","이현동","이현동제2투","대통령선거","경상남도","진주시",2267,1471,361,790,164,75,70,2,0,0,0,2,0,1,2,1467,4,796
"9607","이현동","이현동제3투","대통령선거","경상남도","진주시",2516,1692,448,824,209,101,93,5,0,1,0,1,0,1,0,1683,9,824
"9608","판문동","관내사전투표","대통령선거","경상남도","진주시",3879,3879,1823,1117,407,273,233,2,0,0,1,0,1,1,0,3858,21,0
"9609","판문동","판문동제1투","대통령선거","경상남도","진주시",2612,1790,471,863,239,111,83,1,1,0,2,3,1,4,2,1781,9,822
"9610","판문동","판문동제2투","대통령선거","경상남도","진주시",2456,1754,487,832,218,110,85,0,2,1,0,4,2,3,1,1745,9,702
"9611","판문동","판문동제3투","대통령선거","경상남도","진주시",2226,1623,642,543,216,117,93,1,2,2,0,0,1,1,0,1618,5,603
"9612","판문동","판문동제4투","대통령선거","경상남도","진주시",2449,2026,822,631,319,163,84,1,0,0,0,1,0,0,1,2022,4,423
"9613","판문동","판문동제5투","대통령선거","경상남도","진주시",1656,1325,567,377,211,96,69,1,0,0,1,0,0,0,0,1322,3,331
"9614","가호동","관내사전투표","대통령선거","경상남도","진주시",3458,3458,1651,634,425,365,342,2,0,0,2,8,0,0,5,3434,24,0
"9615","가호동","가호동제1투","대통령선거","경상남도","진주시",2220,1558,448,745,153,117,78,2,1,2,0,0,0,0,2,1548,10,662
"9616","가호동","가호동제2투","대통령선거","경상남도","진주시",2576,1756,638,681,209,132,86,0,0,2,1,1,0,0,0,1750,6,820
"9617","가호동","가호동제3투","대통령선거","경상남도","진주시",2858,2102,639,963,245,124,96,6,2,1,1,0,2,4,6,2089,13,756
"9618","가호동","가호동제4투","대통령선거","경상남도","진주시",2716,2122,808,703,292,158,140,2,0,1,0,2,0,0,1,2107,15,594
"9619","가호동","가호동제5투","대통령선거","경상남도","진주시",2252,1718,642,621,243,106,93,2,0,0,0,5,0,0,3,1715,3,534
"9620","천전동","관내사전투표","대통령선거","경상남도","진주시",4345,4345,1706,1426,495,358,322,0,0,3,0,0,2,1,9,4322,23,0
"9621","천전동","천전동제1투","대통령선거","경상남도","진주시",1756,1267,318,714,119,62,42,3,0,2,0,0,0,3,0,1263,4,489
"9622","천전동","천전동제2투","대통령선거","경상남도","진주시",1602,1148,230,704,102,55,43,2,0,0,0,1,0,1,2,1140,8,454
"9623","천전동","천전동제3투","대통령선거","경상남도","진주시",1985,1358,468,527,172,102,76,0,0,2,1,1,0,0,2,1351,7,627
"9624","천전동","천전동제4투","대통령선거","경상남도","진주시",2095,1519,367,794,198,85,58,1,0,0,1,2,0,0,2,1508,11,576
"9625","천전동","천전동제5투","대통령선거","경상남도","진주시",1845,1436,487,570,208,109,51,0,0,0,0,0,0,1,2,1428,8,409
"9626","천전동","천전동제6투","대통령선거","경상남도","진주시",2800,1877,396,1122,193,86,52,4,1,0,0,1,1,3,6,1865,12,923
"9627","천전동","천전동제7투","대통령선거","경상남도","진주시",2754,2022,486,1058,243,111,100,5,0,0,0,1,2,0,4,2010,12,732
"9628","천전동","천전동제8투","대통령선거","경상남도","진주시",2289,1866,540,890,253,104,72,2,0,0,0,0,0,0,0,1861,5,423
"9629","천전동","천전동제9투","대통령선거","경상남도","진주시",2376,1963,665,770,276,141,95,1,0,2,2,0,0,4,3,1959,4,413
"9630","성북동","관내사전투표","대통령선거","경상남도","진주시",2023,2023,633,975,170,121,99,2,2,2,0,3,0,3,2,2012,11,0
"9631","성북동","성북동제1투","대통령선거","경상남도","진주시",3088,2033,451,1138,238,112,78,0,0,2,0,1,1,2,4,2027,6,1055
"9632","성북동","성북동제2투","대통령선거","경상남도","진주시",2293,1386,316,783,141,78,57,0,0,0,2,0,0,2,0,1379,7,907
"9633","성북동","성북동제3투","대통령선거","경상남도","진주시",2617,1707,398,933,208,103,50,1,0,0,2,1,0,1,0,1697,10,910
"9634","상봉동","관내사전투표","대통령선거","경상남도","진주시",2459,2459,794,1123,217,160,146,3,0,1,0,2,2,1,3,2452,7,0
"9635","상봉동","상봉동제1투","대통령선거","경상남도","진주시",2195,1374,322,781,115,75,65,0,0,2,1,1,0,3,4,1369,5,821
"9636","상봉동","상봉동제2투","대통령선거","경상남도","진주시",2132,1393,312,773,149,77,68,1,0,1,0,1,0,1,4,1387,6,739
"9637","상봉동","상봉동제3투","대통령선거","경상남도","진주시",2986,1960,418,1147,190,98,92,3,0,2,1,0,0,1,0,1952,8,1026
"9638","상봉동","상봉동제4투","대통령선거","경상남도","진주시",3151,2158,533,1116,230,141,110,0,0,3,2,1,2,3,2,2143,15,993
"9639","충무공동","관내사전투표","대통령선거","경상남도","진주시",3214,3214,1793,666,323,237,174,3,0,0,0,5,0,0,6,3207,7,0
"9640","충무공동","충무공동제1투","대통령선거","경상남도","진주시",2930,2334,1143,572,307,185,114,1,0,2,0,1,0,1,1,2327,7,596
"9641","충무공동","충무공동제2투","대통령선거","경상남도","진주시",2779,2207,1062,566,302,165,105,0,0,0,0,0,1,0,2,2203,4,572
"9642","상대동","관내사전투표","대통령선거","경상남도","진주시",4725,4725,1716,1921,484,320,239,6,1,3,1,1,3,5,3,4703,22,0
"9643","상대동","상대동제1투","대통령선거","경상남도","진주시",2679,1869,522,870,236,108,110,1,0,0,0,3,0,1,1,1852,17,810
"9644","상대동","상대동제2투","대통령선거","경상남도","진주시",2745,1795,478,879,226,101,89,2,0,1,2,3,2,2,4,1789,6,950
"9645","상대동","상대동제3투","대통령선거","경상남도","진주시",2789,1841,480,934,209,118,80,2,0,2,1,1,0,0,4,1831,10,948
"9646","상대동","상대동제4투","대통령선거","경상남도","진주시",2751,1875,495,964,193,114,89,8,1,2,0,1,1,0,1,1869,6,876
"9647","상대동","상대동제5투","대통령선거","경상남도","진주시",3294,2375,650,1180,274,139,107,1,0,2,2,2,2,2,4,2365,10,919
"9648","하대동","관내사전투표","대통령선거","경상남도","진주시",4279,4279,1528,1719,450,284,264,5,0,3,0,1,1,1,3,4259,20,0
"9649","하대동","하대동제1투","대통령선거","경상남도","진주시",2285,1716,534,731,226,131,82,0,0,0,0,0,1,0,1,1706,10,569
"9650","하대동","하대동제2투","대통령선거","경상남도","진주시",2855,1891,494,961,198,116,103,2,0,1,2,1,0,1,1,1880,11,964
"9651","하대동","하대동제3투","대통령선거","경상남도","진주시",3030,2014,604,890,242,131,123,5,0,0,1,3,1,0,3,2003,11,1016
"9652","하대동","하대동제4투","대통령선거","경상남도","진주시",2771,1858,526,860,235,121,96,1,1,1,3,0,1,1,1,1847,11,913
"9653","하대동","하대동제5투","대통령선거","경상남도","진주시",3028,2185,604,979,294,155,129,2,0,3,1,3,0,0,5,2175,10,843
"9654","하대동","하대동제6투","대통령선거","경상남도","진주시",3060,2138,617,1022,239,137,102,3,0,2,1,0,0,2,2,2127,11,922
"9655","잘못 투입·구분된 투표지","잘못 투입·구분된 투표지","대통령선거","경상남도","진주시",0,0,0,0,0,0,0,0,0,0,0,0,0,0,0,0,0,0
"9656","거소·선상투표","거소·선상투표","대통령선거","경상남도","통영시",579,539,163,141,137,38,18,5,9,4,1,3,0,1,2,522,17,40
"9657","관외사전투표","관외사전투표","대통령선거","경상남도","통영시",7369,7369,3188,1561,1090,779,631,12,2,3,4,5,2,7,19,7303,66,0
"9658","재외투표","재외투표","대통령선거","경상남도","통영시",391,266,151,20,34,18,40,1,0,1,0,0,0,0,0,265,1,125
"9659","산양읍","관내사전투표","대통령선거","경상남도","통영시",594,594,173,268,87,34,19,3,0,1,0,0,1,4,0,590,4,0
"9660","산양읍","산양읍제1투","대통령선거","경상남도","통영시",2638,1630,366,966,160,71,44,0,0,1,0,0,4,5,0,1617,13,1008
"9661","산양읍","산양읍제2투","대통령선거","경상남도","통영시",647,400,69,248,49,10,9,0,2,0,0,0,1,7,2,397,3,247
"9662","산양읍","산양읍제3투","대통령선거","경상남도","통영시",224,153,26,112,3,6,1,0,0,0,0,0,0,1,0,149,4,71
"9663","산양읍","산양읍제4투","대통령선거","경상남도","통영시",113,73,12,44,11,3,0,0,0,0,0,0,2,1,0,73,0,40
"9664","용남면","관내사전투표","대통령선거","경상남도","통영시",1931,1931,804,644,227,126,106,2,0,0,0,0,2,4,8,1923,8,0
"9665","용남면","용남면제1투","대통령선거","경상남도","통영시",2602,1746,553,689,269,113,101,1,2,3,0,2,1,1,1,1736,10,856
"9666","용남면","용남면제2투","대통령선거","경상남도","통영시",2685,1825,425,958,242,102,76,2,0,1,1,0,0,3,2,1812,13,860
"9667","용남면","용남면제3투","대통령선거","경상남도","통영시",216,148,21,113,6,1,1,0,0,0,0,0,1,4,0,147,1,68
"9668","용남면","용남면제4투","대통령선거","경상남도","통영시",1977,1346,383,589,213,97,55,2,0,0,1,0,1,1,3,1345,1,631
"9669","도산면","관내사전투표","대통령선거","경상남도","통영시",443,443,130,224,48,23,13,0,0,1,0,0,0,0,2,441,2,0
"9670","도산면","도산면제1투","대통령선거","경상남도","통영시",1425,932,189,545,104,50,29,0,0,0,0,0,2,6,4,929,3,493
"9671","도산면","도산면제2투","대통령선거","경상남도","통영시",476,344,56,222,27,23,4,0,0,1,0,0,0,5,4,342,2,132
"9672","도산면","도산면제3투","대통령선거","경상남도","통영시",393,288,76,143,38,17,1,1,0,1,0,1,0,2,5,285,3,105
"9673","광도면","관내사전투표","대통령선거","경상남도","통영시",4403,4403,2050,1134,534,351,290,3,0,1,1,7,1,1,3,4376,27,0
"9674","광도면","광도면제1투","대통령선거","경상남도","통영시",1481,1002,252,530,127,45,33,0,0,0,2,0,0,2,5,996,6,479
"9675","광도면","광도면제2투","대통령선거","경상남도","통영시",2629,1699,700,575,214,107,87,0,0,1,0,0,1,5,0,1690,9,930
"9676","광도면","광도면제3투","대통령선거","경상남도","통영시",1515,990,249,498,120,59,49,0,0,0,0,2,0,5,2,984,6,525
"9677","광도면","광도면제4투","대통령선거","경상남도","통영시",3166,1897,669,666,283,149,113,0,0,1,1,0,0,1,4,1887,10,1269
"9678","광도면","광도면제5투","대통령선거","경상남도","통영시",2701,2126,874,639,356,141,101,1,0,1,1,1,1,2,4,2122,4,575
"9679","광도면","광도면제6투","대통령선거","경상남도","통영시",3489,2453,961,746,381,191,153,5,0,0,0,0,1,0,7,2445,8,1036
"9680","욕지면","관내사전투표","대통령선거","경상남도","통영시",352,352,66,223,35,17,8,1,0,0,0,0,0,0,0,350,2,0
"9681","욕지면","욕지면제1투","대통령선거","경상남도","통영시",905,520,88,327,57,24,13,1,0,1,0,0,2,2,3,518,2,385
"9682","욕지면","욕지면제2투","대통령선거","경상남도","통영시",159,114,27,74,7,3,1,0,0,0,0,0,0,0,1,113,1,45
"9683","욕지면","욕지면제3투","대통령선거","경상남도","통영시",222,145,11,115,13,1,2,1,0,0,0,0,1,0,0,144,1,77
"9684","한산면","관내사전투표","대통령선거","경상남도","통영시",368,368,57,248,34,17,3,0,0,1,0,1,0,5,0,366,2,0
"9685","한산면","한산면제1투","대통령선거","경상남도","통영시",1048,648,77,473,53,19,5,2,1,0,0,0,2,8,2,642,6,400
"9686","한산면","한산면제2투","대통령선거","경상남도","통영시",148,111,11,83,12,1,4,0,0,0,0,0,0,0,0,111,0,37
"9687","한산면","한산면제3투","대통령선거","경상남도","통영시",126,63,14,31,10,4,3,0,0,0,0,0,0,1,0,63,0,63
"9688","사량면","관내사전투표","대통령선거","경상남도","통영시",426,426,85,259,45,11,11,0,1,0,0,0,4,1,1,418,8,0
"9689","사량면","사량면투표소","대통령선거","경상남도","통영시",912,509,91,308,56,25,12,0,0,0,0,0,2,6,0,500,9,403
"9690","도천동","관내사전투표","대통령선거","경상남도","통영시",892,892,326,316,126,65,48,0,1,0,0,0,2,0,3,887,5,0
"9691","도천동","도천동제1투","대통령선거","경상남도","통영시",2200,1399,278,797,176,80,52,1,1,1,0,0,1,0,3,1390,9,801
"9692","도천동","도천동제2투","대통령선거","경상남도","통영시",1844,1158,252,668,126,57,35,2,0,0,0,2,0,0,2,1144,14,686
"9693","도천동","도천동제3투","대통령선거","경상남도","통영시",1691,1096,269,522,158,72,60,4,1,1,0,0,0,0,1,1088,8,595
"9694","도천동","도천동제4투","대통령선거","경상남도","통영시",1227,830,184,452,118,37,31,0,0,0,1,0,0,1,2,826,4,397
"9695","명정동","관내사전투표","대통령선거","경상남도","통영시",1442,1442,323,827,148,71,52,1,1,0,2,0,1,4,0,1430,12,0
"9696","명정동","명정동제1투","대통령선거","경상남도","통영시",1240,767,151,461,83,33,30,1,0,0,1,0,1,1,0,762,5,473
"9697","명정동","명정동제2투","대통령선거","경상남도","통영시",1243,782,149,460,96,38,22,0,0,2,1,1,2,3,1,775,7,461
"9698","중앙동","관내사전투표","대통령선거","경상남도","통영시",664,664,150,373,66,40,25,3,0,0,0,0,0,0,1,658,6,0
"9699","중앙동","중앙동제1투","대통령선거","경상남도","통영시",2165,1306,253,793,152,52,36,2,0,0,0,0,1,0,3,1292,14,859
"9700","중앙동","중앙동제2투","대통령선거","경상남도","통영시",1450,934,186,581,95,34,25,0,0,2,0,0,1,2,1,927,7,516
"9701","정량동","관내사전투표","대통령선거","경상남도","통영시",1277,1277,434,560,142,72,59,1,0,0,0,1,0,1,0,1270,7,0
"9702","정량동","정량동제1투","대통령선거","경상남도","통영시",2235,1369,300,786,150,53,62,0,0,2,1,0,2,2,4,1362,7,866
"9703","정량동","정량동제2투","대통령선거","경상남도","통영시",2387,1534,344,849,194,76,51,8,0,0,0,1,1,0,1,1525,9,853
"9704","정량동","정량동제3투","대통령선거","경상남도","통영시",2506,1666,427,879,175,91,77,2,1,2,1,2,0,4,1,1662,4,840
"9705","북신동","관내사전투표","대통령선거","경상남도","통영시",2488,2488,843,1024,274,162,157,7,0,2,0,1,0,0,4,2474,14,0
"9706","북신동","북신동제1투","대통령선거","경상남도","통영시",2564,1875,448,985,246,98,76,0,1,1,0,1,0,2,3,1861,14,689
"9707","북신동","북신동제2투","대통령선거","경상남도","통영시",2258,1463,328,845,165,64,50,1,0,1,1,0,0,2,1,1458,5,795
"9708","북신동","북신동제3투","대통령선거","경상남도","통영시",1202,738,180,403,92,36,19,0,0,1,1,0,0,1,1,734,4,464
"9709","무전동","관내사전투표","대통령선거","경상남도","통영시",1866,1866,774,598,211,139,117,5,1,1,0,2,1,1,4,1854,12,0
"9710","무전동","무전동제1투","대통령선거","경상남도","통영시",3255,2011,552,995,240,112,88,2,0,1,1,0,2,2,6,2001,10,1244
"9711","무전동","무전동제2투","대통령선거","경상남도","통영시",2776,1972,549,874,272,154,111,2,0,0,0,0,1,0,1,1964,8,804
"9712","무전동","무전동제3투","대통령선거","경상남도","통영시",2653,2036,679,812,318,136,81,3,0,0,0,1,0,0,0,2030,6,617
"9713","미수동","관내사전투표","대통령선거","경상남도","통영시",1800,1800,702,608,223,133,117,0,0,0,1,3,1,3,1,1792,8,0
"9714","미수동","미수동제1투","대통령선거","경상남도","통영시",2042,1317,317,643,187,82,69,4,0,1,0,0,0,2,3,1308,9,725
"9715","미수동","미수동제2투","대통령선거","경상남도","통영시",2260,1554,439,666,223,120,86,4,1,1,0,1,0,1,3,1545,9,706
"9716","미수동","미수동제3투","대통령선거","경상남도","통영시",1436,939,271,411,130,68,49,3,0,0,0,0,2,2,2,938,1,497
"9717","미수동","미수동제4투","대통령선거","경상남도","통영시",1699,1238,398,495,190,82,65,0,0,3,0,2,0,1,0,1236,2,461
"9718","봉평동","관내사전투표","대통령선거","경상남도","통영시",1547,1547,559,599,185,110,78,2,0,5,0,0,0,1,1,1540,7,0
"9719","봉평동","봉평동제1투","대통령선거","경상남도","통영시",2113,1341,380,597,198,83,65,1,0,0,1,0,0,1,0,1326,15,772
"9720","봉평동","봉평동제2투","대통령선거","경상남도","통영시",2482,1504,398,742,193,71,72,2,0,4,1,1,3,4,3,1494,10,978
"9721","봉평동","봉평동제3투","대통령선거","경상남도","통영시",1882,1110,270,547,165,74,41,0,0,4,1,0,0,2,0,1104,6,772
"9722","봉평동","봉평동제4투","대통령선거","경상남도","통영시",1740,1087,297,544,139,61,33,0,0,1,0,1,1,0,2,1079,8,653
"9723","잘못 투입·구분된 투표지","잘못 투입·구분된 투표지","대통령선거","경상남도","통영시",0,0,0,0,0,0,0,0,0,0,0,0,0,0,0,0,0,0
"9724","거소·선상투표","거소·선상투표","대통령선거","경상남도","고성군",299,283,79,91,61,19,8,3,1,1,2,2,1,1,0,269,14,16
"9725","관외사전투표","관외사전투표","대통령선거","경상남도","고성군",3944,3944,1582,1095,541,379,289,8,3,1,0,0,1,4,9,3912,32,0
"9726","재외투표","재외투표","대통령선거","경상남도","고성군",512,227,85,30,83,8,18,2,0,0,0,0,0,0,0,226,1,285
"9727","고성읍","관내사전투표","대통령선거","경상남도","고성군",4133,4133,1577,1532,479,254,232,11,2,2,2,4,3,0,9,4107,26,0
"9728","고성읍","고성읍제1투","대통령선거","경상남도","고성군",2748,1735,522,830,188,102,75,2,0,1,0,0,0,2,1,1723,12,1013
"9729","고성읍","고성읍제2투","대통령선거","경상남도","고성군",4236,2782,818,1241,376,180,141,2,0,2,0,2,2,2,3,2769,13,1454
"9730","고성읍","고성읍제3투","대통령선거","경상남도","고성군",2059,1331,409,572,177,80,74,1,0,1,0,1,0,2,3,1320,11,728
"9731","고성읍","고성읍제4투","대통령선거","경상남도","고성군",1773,1128,270,622,126,54,42,0,0,1,0,1,1,2,2,1121,7,645
"9732","고성읍","고성읍제5투","대통령선거","경상남도","고성군",2622,1553,469,710,198,83,66,1,0,2,0,0,0,3,5,1537,16,1069
"9733","고성읍","고성읍제6투","대통령선거","경상남도","고성군",738,489,129,259,62,20,10,0,0,0,0,1,3,1,1,486,3,249
"9734","고성읍","고성읍제7투","대통령선거","경상남도","고성군",1108,693,154,410,74,28,18,1,1,1,0,0,1,2,1,691,2,415
"9735","삼산면","관내사전투표","대통령선거","경상남도","고성군",350,350,99,178,38,23,9,0,0,0,0,0,0,0,0,347,3,0
"9736","삼산면","삼산면투표소","대통령선거","경상남도","고성군",1115,686,172,378,89,23,12,0,0,0,0,1,2,2,1,680,6,429
"9737","하일면","관내사전투표","대통령선거","경상남도","고성군",342,342,80,187,41,16,10,0,1,0,0,0,1,0,1,337,5,0
"9738","하일면","하일면투표소","대통령선거","경상남도","고성군",1270,763,112,513,80,20,18,0,0,0,0,1,2,9,1,756,7,507
"9739","하이면","관내사전투표","대통령선거","경상남도","고성군",421,421,107,214,57,17,17,0,1,1,0,0,0,0,4,418,3,0
"9740","하이면","하이면투표소","대통령선거","경상남도","고성군",1789,1161,227,700,126,51,33,4,1,0,1,2,0,2,4,1151,10,628
"9741","상리면","관내사전투표","대통령선거","경상남도","고성군",377,377,102,197,39,20,14,0,0,0,0,0,1,0,0,373,4,0
"9742","상리면","상리면투표소","대통령선거","경상남도","고성군",1044,660,146,421,56,14,13,2,0,0,0,0,0,2,0,654,6,384
"9743","대가면","관내사전투표","대통령선거","경상남도","고성군",276,276,80,146,28,8,10,0,0,0,0,1,0,2,0,275,1,0
"9744","대가면","대가면투표소","대통령선거","경상남도","고성군",1087,714,140,451,74,22,15,0,0,0,1,0,1,3,2,709,5,373
"9745","영현면","관내사전투표","대통령선거","경상남도","고성군",240,240,49,135,25,21,7,0,0,0,0,0,1,0,0,238,2,0
"9746","영현면","영현면투표소","대통령선거","경상남도","고성군",523,354,72,205,45,14,11,0,0,0,0,0,2,1,1,351,3,169
"9747","영오면","관내사전투표","대통령선거","경상남도","고성군",312,312,88,168,35,11,3,1,0,1,0,0,2,1,0,310,2,0
"9748","영오면","영오면투표소","대통령선거","경상남도","고성군",918,573,127,335,56,28,17,1,0,1,0,0,0,3,3,571,2,345
"9749","개천면","관내사전투표","대통령선거","경상남도","고성군",197,197,49,107,20,10,7,1,0,0,1,0,0,0,0,195,2,0
"9750","개천면","개천면제1투","대통령선거","경상남도","고성군",470,327,88,183,36,11,4,1,1,1,0,0,0,2,0,327,0,143
"9751","개천면","개천면제2투","대통령선거","경상남도","고성군",299,225,42,136,18,11,7,0,0,1,0,0,2,4,1,222,3,74
"9752","구만면","관내사전투표","대통령선거","경상남도","고성군",252,252,108,102,27,7,5,0,0,0,0,0,0,1,0,250,2,0
"9753","구만면","구만면투표소","대통령선거","경상남도","고성군",665,422,122,218,56,14,8,1,0,0,0,0,0,0,2,421,1,243
"9754","회화면","관내사전투표","대통령선거","경상남도","고성군",798,798,201,431,87,30,35,0,0,0,1,0,0,2,1,788,10,0
"9755","회화면","회화면투표소","대통령선거","경상남도","고성군",2363,1465,274,918,139,59,55,0,0,0,1,2,1,4,3,1456,9,898
"9756","마암면","관내사전투표","대통령선거","경상남도","고성군",361,361,75,222,38,7,9,0,0,1,0,1,2,1,0,356,5,0
"9757","마암면","마암면투표소","대통령선거","경상남도","고성군",1147,714,182,371,93,17,31,1,0,1,1,0,0,6,5,708,6,433
"9758","동해면","관내사전투표","대통령선거","경상남도","고성군",321,321,79,170,35,22,10,1,0,0,0,0,0,1,1,319,2,0
"9759","동해면","동해면제1투","대통령선거","경상남도","고성군",1266,728,146,465,61,25,16,1,0,0,0,0,4,2,0,720,8,538
"9760","동해면","동해면제2투","대통령선거","경상남도","고성군",1109,726,149,455,80,16,14,0,1,0,1,0,3,1,3,723,3,383
"9761","거류면","관내사전투표","대통령선거","경상남도","고성군",599,599,198,268,59,30,33,1,0,0,0,1,1,2,0,593,6,0
"9762","거류면","거류면제1투","대통령선거","경상남도","고성군",2157,1205,283,683,129,47,44,4,0,0,0,1,1,4,3,1199,6,952
"9763","거류면","거류면제2투","대통령선거","경상남도","고성군",1129,736,157,448,72,27,19,1,1,0,2,0,1,1,1,730,6,393
"9764","잘못 투입·구분된 투표지","잘못 투입·구분된 투표지","대통령선거","경상남도","고성군",0,0,0,0,0,0,0,0,0,0,0,0,0,0,0,0,0,0
"9765","거소·선상투표","거소·선상투표","대통령선거","경상남도","사천시",324,304,90,98,68,23,5,1,0,2,1,0,2,0,3,293,11,20
"9766","관외사전투표","관외사전투표","대통령선거","경상남도","사천시",7789,7788,3275,1932,1118,745,603,9,4,3,3,3,2,4,14,7715,73,1
"9767","재외투표","재외투표","대통령선거","경상남도","사천시",510,310,164,28,76,10,30,1,0,0,0,0,0,0,0,309,1,200
"9768","사천읍","관내사전투표","대통령선거","경상남도","사천시",3309,3309,1409,1069,389,222,201,1,0,0,0,3,0,3,3,3300,9,0
"9769","사천읍","사천읍제1투","대통령선거","경상남도","사천시",3391,2173,776,856,278,144,100,2,0,1,0,1,0,0,7,2165,8,1218
"9770","사천읍","사천읍제2투","대통령선거","경상남도","사천시",1692,1036,270,519,114,71,48,1,0,2,1,0,0,1,2,1029,7,656
"9771","사천읍","사천읍제3투","대통령선거","경상남도","사천시",1922,1210,292,593,175,87,51,3,0,0,0,1,2,1,1,1206,4,712
"9772","사천읍","사천읍제4투","대통령선거","경상남도","사천시",3672,2475,682,1195,280,151,140,0,0,3,2,1,2,2,3,2461,14,1197
"9773","정동면","관내사전투표","대통령선거","경상남도","사천시",853,853,356,307,89,46,46,0,0,0,0,2,2,0,3,851,2,0
"9774","정동면","정동면제1투","대통령선거","경상남도","사천시",1641,1194,356,567,127,71,63,0,0,0,0,0,1,2,0,1187,7,447
"9775","정동면","정동면제2투","대통령선거","경상남도","사천시",2002,1565,607,564,213,78,90,0,0,1,0,2,1,1,1,1558,7,437
"9776","정동면","정동면제3투","대통령선거","경상남도","사천시",2536,1682,577,711,188,82,94,1,0,1,0,3,2,3,5,1667,15,854
"9777","사남면","관내사전투표","대통령선거","경상남도","사천시",2494,2494,1088,783,306,176,125,0,0,1,0,3,0,3,0,2485,9,0
"9778","사남면","사남면제1투","대통령선거","경상남도","사천시",1990,1243,320,702,113,53,33,3,0,1,1,1,1,4,3,1235,8,747
"9779","사남면","사남면제2투","대통령선거","경상남도","사천시",2297,1746,678,601,231,139,87,0,0,2,1,1,0,0,4,1744,2,551
"9780","사남면","사남면제3투","대통령선거","경상남도","사천시",3115,2279,1029,653,304,154,129,0,0,0,0,1,0,2,1,2273,6,836
"9781","용현면","관내사전투표","대통령선거","경상남도","사천시",1409,1409,493,588,168,77,66,4,0,1,0,1,0,0,0,1398,11,0
"9782","용현면","용현면제1투","대통령선거","경상남도","사천시",1923,1210,380,534,145,72,58,1,0,0,0,1,3,5,2,1201,9,713
"9783","용현면","용현면제2투","대통령선거","경상남도","사천시",2731,1731,469,867,217,96,53,3,1,3,1,1,0,5,3,1719,12,1000
"9784","축동면","관내사전투표","대통령선거","경상남도","사천시",376,376,111,180,49,18,10,0,0,0,1,0,0,3,1,373,3,0
"9785","축동면","축동면투표소","대통령선거","경상남도","사천시",1262,884,187,595,53,20,19,0,0,1,0,0,0,2,1,878,6,378
"9786","곤양면","관내사전투표","대통령선거","경상남도","사천시",589,589,163,278,72,23,21,2,0,1,0,2,0,0,10,572,17,0
"9787","곤양면","곤양면제1투","대통령선거","경상남도","사천시",1867,1250,259,719,152,56,28,1,0,1,0,0,3,4,1,1224,26,617
"9788","곤양면","곤양면제2투","대통령선거","경상남도","사천시",702,492,91,332,33,18,9,0,0,0,1,0,2,2,0,488,4,210
"9789","곤명면","관내사전투표","대통령선거","경상남도","사천시",413,413,115,227,42,12,9,3,0,0,0,0,1,0,2,411,2,0
"9790","곤명면","곤명면제1투","대통령선거","경상남도","사천시",945,630,123,417,47,13,21,0,0,0,0,2,1,1,1,626,4,315
"9791","곤명면","곤명면제2투","대통령선거","경상남도","사천시",1151,826,179,512,72,33,13,1,0,1,0,2,4,1,3,821,5,325
"9792","서포면","관내사전투표","대통령선거","경상남도","사천시",706,706,167,422,69,21,10,1,0,0,1,1,2,4,3,701,5,0
"9793","서포면","서포면투표소","대통령선거","경상남도","사천시",2436,1458,300,891,147,51,34,0,0,0,0,0,2,7,6,1438,20,978
"9794","동서동","관내사전투표","대통령선거","경상남도","사천시",729,729,182,408,69,35,33,0,0,0,0,0,0,0,0,727,2,0
"9795","동서동","동서동제1투","대통령선거","경상남도","사천시",2117,1367,221,920,138,39,33,0,0,0,2,0,3,3,1,1360,7,750
"9796","동서동","동서동제2투","대통령선거","경상남도","사천시",1709,1145,208,756,102,46,23,1,0,0,0,0,0,3,4,1143,2,564
"9797","동서동","동서동제3투","대통령선거","경상남도","사천시",1517,1022,197,635,114,34,28,0,0,0,0,0,0,2,0,1010,12,495
"9798","동서동","동서동제4투","대통령선거","경상남도","사천시",247,163,18,125,13,3,2,0,0,0,0,0,1,0,1,163,0,84
"9799","선구동","관내사전투표","대통령선거","경상남도","사천시",568,568,202,229,55,38,38,1,0,0,0,1,0,0,0,564,4,0
"9800","선구동","선구동제1투","대통령선거","경상남도","사천시",1420,872,123,601,84,40,15,1,1,0,0,0,1,2,1,869,3,548
"9801","선구동","선구동제2투","대통령선거","경상남도","사천시",1122,752,203,419,56,37,20,3,1,0,0,1,1,1,0,742,10,370
"9802","선구동","선구동제3투","대통령선거","경상남도","사천시",1451,1006,265,555,106,34,37,1,0,0,1,2,0,2,0,1003,3,445
"9803","동서금동","관내사전투표","대통령선거","경상남도","사천시",1376,1376,391,734,140,67,33,0,0,0,0,0,0,2,0,1367,9,0
"9804","동서금동","동서금동제1투","대통령선거","경상남도","사천시",1926,1090,230,629,129,51,42,1,0,0,0,1,0,2,1,1086,4,836
"9805","동서금동","동서금동제2투","대통령선거","경상남도","사천시",1326,816,147,503,104,24,23,2,0,0,0,0,0,2,2,807,9,510
"9806","벌용동","관내사전투표","대통령선거","경상남도","사천시",2566,2566,978,975,261,148,170,5,0,1,2,4,0,1,5,2550,16,0
"9807","벌용동","벌용동제1투","대통령선거","경상남도","사천시",3080,2037,553,1009,238,123,85,2,1,2,0,2,1,0,1,2017,20,1043
"9808","벌용동","벌용동제2투","대통령선거","경상남도","사천시",1949,1301,307,754,131,64,31,0,0,0,0,1,0,4,3,1295,6,648
"9809","벌용동","벌용동제3투","대통령선거","경상남도","사천시",2298,1586,426,803,183,83,83,0,0,0,0,1,0,0,1,1580,6,712
"9810","벌용동","벌용동제4투","대통령선거","경상남도","사천시",2648,1830,596,783,234,110,79,0,0,0,1,6,1,4,2,1816,14,818
"9811","향촌동","관내사전투표","대통령선거","경상남도","사천시",1456,1456,482,593,168,85,87,2,6,3,0,0,1,7,6,1440,16,0
"9812","향촌동","향촌동제1투","대통령선거","경상남도","사천시",3129,2008,503,1070,226,113,74,2,0,0,0,2,2,2,3,1997,11,1121
"9813","향촌동","향촌동제2투","대통령선거","경상남도","사천시",1142,773,150,476,87,32,13,1,1,0,0,0,1,5,3,769,4,369
"9814","남양동","관내사전투표","대통령선거","경상남도","사천시",999,999,366,421,102,59,41,0,0,1,1,2,0,2,2,997,2,0
"9815","남양동","남양동제1투","대통령선거","경상남도","사천시",3007,2064,545,1078,238,94,75,2,0,2,1,0,3,4,4,2046,18,943
"9816","남양동","남양동제2투","대통령선거","경상남도","사천시",548,394,71,259,37,14,6,0,0,0,0,1,0,2,0,390,4,154
"9817","잘못 투입·구분된 투표지","잘못 투입·구분된 투표지","대통령선거","경상남도","사천시",0,0,0,0,0,0,0,0,0,0,0,0,0,0,0,0,0,0
"9818","거소·선상투표","거소·선상투표","대통령선거","경상남도","김해시",1153,1075,416,226,254,81,29,1,1,5,0,1,1,2,16,1033,42,78
"9819","관외사전투표","관외사전투표","대통령선거","경상남도","김해시",29679,29677,14045,5552,4699,2691,2232,25,14,8,9,24,12,7,83,29401,276,2
"9820","재외투표","재외투표","대통령선거","경상남도","김해시",1803,1320,798,92,195,51,166,5,0,0,0,1,0,1,1,1310,10,483
"9821","진영읍","관내사전투표","대통령선거","경상남도","김해시",6097,6098,3511,1249,585,400,307,7,2,3,1,1,2,1,3,6072,26,-1
"9822","진영읍","진영읍제1투","대통령선거","경상남도","김해시",1779,1238,533,437,142,61,51,4,0,1,0,2,0,0,1,1232,6,541
"9823","진영읍","진영읍제2투","대통령선거","경상남도","김해시",4449,2993,1488,788,385,170,132,8,0,2,0,0,2,1,5,2981,12,1456
"9824","진영읍","진영읍제3투","대통령선거","경상남도","김해시",4736,3679,1933,766,488,259,210,6,0,0,0,4,0,0,3,3669,10,1057
"9825","진영읍","진영읍제4투","대통령선거","경상남도","김해시",2873,2309,1216,513,307,157,109,0,0,2,0,1,0,0,1,2306,3,564
"9826","진영읍","진영읍제5투","대통령선거","경상남도","김해시",4622,2818,1413,707,377,153,142,1,0,1,2,1,1,2,5,2805,13,1804
"9827","진영읍","진영읍제6투","대통령선거","경상남도","김해시",3503,2009,952,579,267,107,78,2,0,0,0,0,0,2,6,1993,16,1494
"9828","진영읍","진영읍제7투","대통령선거","경상남도","김해시",3656,2475,1149,701,324,153,121,0,0,3,2,1,2,0,2,2458,17,1181
"9829","진영읍","진영읍제8투","대통령선거","경상남도","김해시",1934,1214,564,424,126,63,27,0,0,0,1,0,1,0,1,1207,7,720
"9830","주촌면","관내사전투표","대통령선거","경상남도","김해시",1010,1010,449,349,118,48,33,2,2,3,1,0,0,0,0,1005,5,0
"9831","주촌면","주촌면투표소","대통령선거","경상남도","김해시",2210,1283,412,631,143,56,21,4,0,1,1,0,0,2,0,1271,12,927
"9832","진례면","관내사전투표","대통령선거","경상남도","김해시",1385,1385,628,465,143,70,59,1,0,1,0,2,2,1,0,1372,13,0
"9833","진례면","진례면제1투","대통령선거","경상남도","김해시",2462,1595,579,633,204,83,73,1,0,1,1,1,0,0,4,1580,15,867
"9834","진례면","진례면제2투","대통령선거","경상남도","김해시",2396,1462,493,637,189,79,46,1,1,0,1,0,0,2,0,1449,13,934
"9835","한림면","관내사전투표","대통령선거","경상남도","김해시",860,860,445,235,90,48,25,0,0,4,1,3,1,1,1,854,6,0
"9836","한림면","한림면제1투","대통령선거","경상남도","김해시",1306,812,320,334,96,36,15,1,0,1,0,0,0,2,2,807,5,494
"9837","한림면","한림면제2투","대통령선거","경상남도","김해시",1621,1067,392,490,96,33,38,4,0,1,0,1,1,3,1,1060,7,554
"9838","한림면","한림면제3투","대통령선거","경상남도","김해시",1954,1265,621,375,161,51,35,1,0,2,0,1,3,2,4,1256,9,689
"9839","한림면","한림면제4투","대통령선거","경상남도","김해시",1332,846,367,322,91,26,20,1,0,1,0,0,2,2,3,835,11,486
"9840","생림면","관내사전투표","대통령선거","경상남도","김해시",923,923,427,311,82,51,40,0,0,0,1,0,1,1,1,915,8,0
"9841","생림면","생림면제1투","대통령선거","경상남도","김해시",1424,864,258,463,90,29,10,2,0,2,0,0,0,2,0,856,8,560
"9842","생림면","생림면제2투","대통령선거","경상남도","김해시",1372,889,267,432,121,39,15,1,0,2,0,0,0,1,2,880,9,483
"9843","상동면","관내사전투표","대통령선거","경상남도","김해시",869,869,332,329,107,33,28,4,0,1,2,2,2,2,0,842,27,0
"9844","상동면","상동면제1투","대통령선거","경상남도","김해시",1606,959,331,433,119,30,30,2,1,1,0,0,0,1,3,951,8,647
"9845","상동면","상동면제2투","대통령선거","경상남도","김해시",517,349,96,167,47,21,8,1,0,0,1,0,0,0,1,342,7,168
"9846","대동면","관내사전투표","대통령선거","경상남도","김해시",895,895,374,312,115,57,30,0,0,1,1,2,0,0,1,893,2,0
"9847","대동면","대동면제1투","대통령선거","경상남도","김해시",1623,1088,373,496,135,45,29,1,0,3,0,1,0,0,0,1083,5,535
"9848","대동면","대동면제2투","대통령선거","경상남도","김해시",1778,1191,415,505,162,62,37,1,0,1,0,0,0,0,0,1183,8,587
"9849","대동면","대동면제3투","대통령선거","경상남도","김해시",1542,1077,327,548,113,37,41,1,0,1,0,0,0,1,3,1072,5,465
"9850","동상동","관내사전투표","대통령선거","경상남도","김해시",2245,2245,1020,729,244,130,104,2,2,1,1,1,1,0,0,2235,10,0
"9851","동상동","동상동제1투","대통령선거","경상남도","김해시",3849,2448,868,898,382,167,112,0,0,1,0,1,0,2,2,2433,15,1401
"9852","동상동","동상동제2투","대통령선거","경상남도","김해시",2540,1444,499,599,208,66,44,4,0,1,0,0,2,1,2,1426,18,1096
"9853","회현동","관내사전투표","대통령선거","경상남도","김해시",2451,2451,1076,858,268,122,108,2,0,0,0,1,0,1,4,2440,11,0
"9854","회현동","회현동제1투","대통령선거","경상남도","김해시",2227,1379,504,569,179,77,43,2,0,0,0,0,0,0,0,1374,5,848
"9855","회현동","회현동제2투","대통령선거","경상남도","김해시",3054,1834,683,703,261,90,75,3,0,0,2,1,1,0,3,1822,12,1220
"9856","부원동","관내사전투표","대통령선거","경상남도","김해시",2488,2488,1256,640,270,159,143,2,0,1,1,0,0,3,0,2475,13,0
"9857","부원동","부원동제1투","대통령선거","경상남도","김해시",2961,1811,737,591,257,120,92,1,1,2,0,1,0,0,3,1805,6,1150
"9858","부원동","부원동제2투","대통령선거","경상남도","김해시",3454,2211,812,855,325,105,96,1,0,0,1,1,1,0,2,2199,12,1243
"9859","내외동","관내사전투표","대통령선거","경상남도","김해시",10812,10812,5746,2219,1369,700,689,5,1,3,0,6,1,3,13,10755,57,0
"9860","내외동","내외동제1투","대통령선거","경상남도","김해시",2797,1853,867,439,280,118,136,1,0,0,1,4,0,1,4,1851,2,944
"9861","내외동","내외동제2투","대통령선거","경상남도","김해시",2685,1657,680,481,270,111,96,5,0,3,1,2,0,1,0,1650,7,1028
"9862","내외동","내외동제3투","대통령선거","경상남도","김해시",2411,1490,610,460,236,91,71,2,0,0,0,1,2,1,4,1478,12,921
"9863","내외동","내외동제4투","대통령선거","경상남도","김해시",3191,2073,904,597,302,157,101,1,0,1,0,4,0,0,0,2067,6,1118
"9864","내외동","내외동제5투","대통령선거","경상남도","김해시",3947,2807,1229,762,449,231,118,1,0,1,1,0,0,2,2,2796,11,1140
"9865","내외동","내외동제6투","대통령선거","경상남도","김해시",3745,2858,1332,698,441,200,163,9,0,1,4,1,1,2,2,2854,4,887
"9866","내외동","내외동제7투","대통령선거","경상남도","김해시",3163,1698,726,482,262,101,113,0,0,2,1,2,0,0,0,1689,9,1465
"9867","내외동","내외동제8투","대통령선거","경상남도","김해시",2943,1995,897,519,301,146,117,3,1,0,0,1,1,0,2,1988,7,948
"9868","내외동","내외동제9투","대통령선거","경상남도","김해시",3283,2476,1114,673,376,169,122,1,0,1,1,1,1,0,6,2465,11,807
"9869","내외동","내외동제10투","대통령선거","경상남도","김해시",2972,2177,1005,542,297,194,126,1,0,1,0,0,1,0,0,2167,10,795
"9870","내외동","내외동제11투","대통령선거","경상남도","김해시",2803,1662,719,535,195,91,94,0,0,2,0,4,2,2,2,1646,16,1141
"9871","내외동","내외동제12투","대통령선거","경상남도","김해시",4015,3184,1399,895,438,249,181,3,0,0,0,1,1,1,2,3170,14,831
"9872","내외동","내외동제13투","대통령선거","경상남도","김해시",3891,2349,1004,678,362,170,123,1,2,1,0,2,0,1,1,2345,4,1542
"9873","내외동","내외동제14투","대통령선거","경상남도","김해시",3975,2753,1269,663,443,187,173,0,1,0,0,2,0,1,3,2742,11,1222
"9874","내외동","내외동제15투","대통령선거","경상남도","김해시",3965,2780,1238,788,377,187,157,1,0,3,0,2,0,0,3,2756,24,1185
"9875","북부동","관내사전투표","대통령선거","경상남도","김해시",10635,10635,5900,2018,1314,727,614,7,0,3,4,4,4,3,10,10608,27,0
"9876","북부동","북부동제1투","대통령선거","경상남도","김해시",3478,2028,819,716,255,120,99,2,0,2,0,1,1,2,3,2020,8,1450
"9877","북부동","북부동제2투","대통령선거","경상남도","김해시",3177,2119,801,736,341,126,87,5,2,4,0,2,4,1,0,2109,10,1058
"9878","북부동","북부동제3투","대통령선거","경상남도","김해시",3572,2410,1033,759,342,144,118,2,0,2,1,0,0,1,1,2403,7,1162
"9879","북부동","북부동제4투","대통령선거","경상남도","김해시",3023,2381,1247,444,365,191,127,1,0,0,0,1,0,0,3,2379,2,642
"9880","북부동","북부동제5투","대통령선거","경상남도","김해시",3519,2661,1322,555,389,217,160,2,0,0,3,2,0,1,5,2656,5,858
"9881","북부동","북부동제6투","대통령선거","경상남도","김해시",3907,2760,1180,827,406,185,143,2,0,1,0,0,0,1,4,2749,11,1147
"9882","북부동","북부동제7투","대통령선거","경상남도","김해시",3017,2271,988,686,331,166,87,0,0,1,2,0,0,2,3,2266,5,746
"9883","북부동","북부동제8투","대통령선거","경상남도","김해시",2857,1979,924,503,294,136,110,4,0,0,0,0,0,0,1,1972,7,878
"9884","북부동","북부동제9투","대통령선거","경상남도","김해시",2782,1877,916,433,295,114,105,1,2,0,0,1,0,3,1,1871,6,905
"9885","북부동","북부동제10투","대통령선거","경상남도","김해시",2238,1539,755,320,238,135,84,0,0,0,0,0,0,0,1,1533,6,699
"9886","북부동","북부동제11투","대통령선거","경상남도","김해시",3008,2268,1169,461,352,172,105,1,1,0,1,0,1,0,1,2264,4,740
"9887","북부동","북부동제12투","대통령선거","경상남도","김해시",2365,1519,708,384,216,101,99,1,0,0,1,1,0,1,2,1514,5,846
"9888","북부동","북부동제13투","대통령선거","경상남도","김해시",3489,2531,1211,641,364,165,134,4,0,0,0,2,0,0,2,2523,8,958
"9889","북부동","북부동제14투","대통령선거","경상남도","김해시",2882,2166,1075,472,327,148,135,1,0,0,1,0,0,2,3,2164,2,716
"9890","북부동","북부동제15투","대통령선거","경상남도","김해시",3323,2556,1295,567,400,178,102,1,0,1,0,2,1,1,1,2549,7,767
"9891","칠산서부동","관내사전투표","대통령선거","경상남도","김해시",1894,1894,950,486,229,101,111,2,0,1,0,2,0,0,3,1885,9,0
"9892","칠산서부동","칠산서부동제1투","대통령선거","경상남도","김해시",2277,1521,559,610,196,85,58,1,0,1,1,1,0,0,1,1513,8,756
"9893","칠산서부동","칠산서부동제2투","대통령선거","경상남도","김해시",4119,2679,1081,914,358,180,122,1,2,0,1,1,1,1,4,2666,13,1440
"9894","활천동","관내사전투표","대통령선거","경상남도","김해시",5069,5069,2469,1333,575,367,288,5,0,2,0,1,1,1,6,5048,21,0
"9895","활천동","활천동제1투","대통령선거","경상남도","김해시",3957,2411,944,797,368,169,109,1,0,0,1,1,3,1,1,2395,16,1546
"9896","활천동","활천동제2투","대통령선거","경상남도","김해시",3614,2457,1073,686,357,200,117,2,1,2,2,2,0,1,2,2445,12,1157
"9897","활천동","활천동제3투","대통령선거","경상남도","김해시",3569,2333,963,756,342,148,105,1,1,2,0,0,2,2,1,2323,10,1236
"9898","활천동","활천동제4투","대통령선거","경상남도","김해시",4869,3149,1273,1020,461,213,149,7,0,3,0,1,0,2,7,3136,13,1720
"9899","활천동","활천동제5투","대통령선거","경상남도","김해시",4460,2918,1296,833,412,189,165,3,0,2,2,0,0,0,2,2904,14,1542
"9900","활천동","활천동제6투","대통령선거","경상남도","김해시",3708,2772,1215,771,438,192,134,2,1,1,0,1,0,1,4,2760,12,936
"9901","활천동","활천동제7투","대통령선거","경상남도","김해시",4030,2403,1033,691,353,164,139,2,0,3,0,2,1,0,3,2391,12,1627
"9902","삼안동","관내사전투표","대통령선거","경상남도","김해시",6284,6284,3142,1479,764,454,397,7,0,1,4,7,0,1,5,6261,23,0
"9903","삼안동","삼안동제1투","대통령선거","경상남도","김해시",3737,2307,916,729,334,169,132,2,1,3,2,1,1,1,5,2296,11,1430
"9904","삼안동","삼안동제2투","대통령선거","경상남도","김해시",2144,1481,593,508,190,100,76,0,0,0,0,1,0,0,7,1475,6,663
"9905","삼안동","삼안동제3투","대통령선거","경상남도","김해시",4038,2935,1205,872,438,224,172,2,1,3,0,1,0,1,2,2921,14,1103
"9906","삼안동","삼안동제4투","대통령선거","경상남도","김해시",3101,1815,708,567,301,120,97,4,1,2,2,1,0,2,3,1808,7,1286
"9907","삼안동","삼안동제5투","대통령선거","경상남도","김해시",3383,2501,1049,695,405,198,129,0,0,2,0,1,1,2,6,2488,13,882
"9908","삼안동","삼안동제6투","대통령선거","경상남도","김해시",2666,1892,816,534,314,120,93,0,0,2,0,2,0,0,4,1885,7,774
"9909","삼안동","삼안동제7투","대통령선거","경상남도","김해시",2972,1886,721,597,287,133,117,4,0,3,1,3,1,1,7,1875,11,1086
"9910","삼안동","삼안동제8투","대통령선거","경상남도","김해시",3156,1703,636,566,258,133,93,1,0,1,0,4,1,1,1,1695,8,1453
"9911","불암동","관내사전투표","대통령선거","경상남도","김해시",1263,1263,634,316,181,66,56,0,0,0,0,0,0,2,2,1257,6,0
"9912","불암동","불암동제1투","대통령선거","경상남도","김해시",4139,2970,1205,910,466,207,154,3,0,3,0,2,1,1,3,2955,15,1169
"9913","불암동","불암동제2투","대통령선거","경상남도","김해시",1049,651,234,270,89,29,22,0,1,0,0,0,0,1,0,646,5,398
"9914","장유1동","관내사전투표","대통령선거","경상남도","김해시",6635,6635,3587,1360,810,446,392,4,2,7,2,0,3,1,3,6617,18,0
"9915","장유1동","장유1동제1투","대통령선거","경상남도","김해시",3934,3058,1450,665,496,235,189,3,0,3,0,1,1,0,2,3045,13,876
"9916","장유1동","장유1동제2투","대통령선거","경상남도","김해시",3817,2850,1359,618,452,210,191,2,0,2,2,0,1,2,1,2840,10,967
"9917","장유1동","장유1동제3투","대통령선거","경상남도","김해시",3433,2550,1205,626,385,167,142,2,1,0,0,1,0,2,3,2534,16,883
"9918","장유1동","장유1동제4투","대통령선거","경상남도","김해시",3438,2739,1362,590,395,206,168,2,0,1,1,0,0,1,4,2730,9,699
"9919","장유1동","장유1동제5투","대통령선거","경상남도","김해시",3740,2877,1305,765,452,195,142,6,0,2,0,0,0,1,3,2871,6,863
"9920","장유1동","장유1동제6투","대통령선거","경상남도","김해시",4606,3226,1508,720,551,214,212,1,0,2,0,0,0,1,6,3215,11,1380
"9921","장유1동","장유1동제7투","대통령선거","경상남도","김해시",3802,2365,890,861,349,136,108,1,0,0,0,0,0,2,1,2348,17,1437
"9922","장유1동","장유1동제8투","대통령선거","경상남도","김해시",3615,2661,1145,737,464,179,116,5,0,1,0,0,0,1,1,2649,12,954
"9923","장유2동","관내사전투표","대통령선거","경상남도","김해시",6051,6051,3353,1138,738,405,378,5,1,2,1,5,1,2,2,6031,20,0
"9924","장유2동","장유2동제1투","대통령선거","경상남도","김해시",2534,1611,751,347,269,133,98,2,0,0,0,1,0,0,1,1602,9,923
"9925","장유2동","장유2동제2투","대통령선거","경상남도","김해시",2786,2016,893,558,304,144,102,1,0,0,0,0,2,0,0,2004,12,770
"9926","장유2동","장유2동제3투","대통령선거","경상남도","김해시",3033,2332,1070,537,378,181,152,3,0,0,0,1,0,1,2,2325,7,701
"9927","장유2동","장유2동제4투","대통령선거","경상남도","김해시",3337,2340,1038,622,392,159,118,1,2,0,0,0,0,1,2,2335,5,997
"9928","장유2동","장유2동제5투","대통령선거","경상남도","김해시",3167,2293,1022,607,356,158,137,2,0,0,1,1,0,1,0,2285,8,874
"9929","장유2동","장유2동제6투","대통령선거","경상남도","김해시",3200,2455,1143,557,384,202,155,2,0,1,0,0,1,1,1,2447,8,745
"9930","장유3동","관내사전투표","대통령선거","경상남도","김해시",7683,7683,4399,1263,928,597,459,8,1,1,0,4,1,0,8,7669,14,0
"9931","장유3동","장유3동제1투","대통령선거","경상남도","김해시",3823,3045,1472,686,462,244,171,1,0,3,1,0,0,0,1,3041,4,778
"9932","장유3동","장유3동제2투","대통령선거","경상남도","김해시",2945,2335,1117,528,370,161,149,2,0,1,0,0,0,1,1,2330,5,610
"9933","장유3동","장유3동제3투","대통령선거","경상남도","김해시",3787,2891,1511,496,483,213,169,6,0,0,0,1,0,0,2,2881,10,896
"9934","장유3동","장유3동제4투","대통령선거","경상남도","김해시",3345,2415,1202,537,340,168,158,1,0,2,0,0,0,0,1,2409,6,930
"9935","장유3동","장유3동제5투","대통령선거","경상남도","김해시",2700,2159,1127,400,336,167,117,2,0,0,0,0,0,0,1,2150,9,541
"9936","장유3동","장유3동제6투","대통령선거","경상남도","김해시",3410,2626,1126,702,434,207,145,1,1,0,1,0,1,1,4,2623,3,784
"9937","장유3동","장유3동제7투","대통령선거","경상남도","김해시",3950,3253,1737,537,498,273,188,3,0,0,1,3,0,2,2,3244,9,697
"9938","장유3동","장유3동제8투","대통령선거","경상남도","김해시",3241,2264,1024,587,392,132,107,2,1,2,1,0,0,1,2,2251,13,977
"9939","잘못 투입·구분된 투표지","잘못 투입·구분된 투표지","대통령선거","경상남도","김해시",0,0,0,0,0,0,0,0,0,0,0,0,0,0,0,0,0,0
"9940","거소·선상투표","거소·선상투표","대통령선거","경상남도","밀양시",405,369,114,119,73,14,8,5,5,2,1,1,1,3,4,350,19,36
"9941","관외사전투표","관외사전투표","대통령선거","경상남도","밀양시",7377,7375,2926,1992,1092,675,557,10,1,6,3,8,5,2,18,7295,80,2
"9942","재외투표","재외투표","대통령선거","경상남도","밀양시",677,363,181,41,88,12,40,0,0,0,0,1,0,0,0,363,0,314
"9943","삼랑진읍","관내사전투표","대통령선거","경상남도","밀양시",807,807,285,345,97,40,31,2,0,1,0,1,2,0,1,805,2,0
"9944","삼랑진읍","삼랑진읍제1투","대통령선거","경상남도","밀양시",2093,1395,290,818,176,60,28,6,0,1,1,3,1,1,2,1387,8,698
"9945","삼랑진읍","삼랑진읍제2투","대통령선거","경상남도","밀양시",1882,1149,285,623,131,55,21,1,0,2,0,3,2,3,4,1130,19,733
"9946","삼랑진읍","삼랑진읍제3투","대통령선거","경상남도","밀양시",1054,727,185,414,70,27,17,1,1,0,0,1,0,3,1,720,7,327
"9947","하남읍","관내사전투표","대통령선거","경상남도","밀양시",1172,1172,443,454,120,84,54,2,0,2,0,1,1,3,2,1166,6,0
"9948","하남읍","하남읍제1투","대통령선거","경상남도","밀양시",995,678,150,411,75,21,7,1,0,1,1,1,4,2,2,676,2,317
"9949","하남읍","하남읍제2투","대통령선거","경상남도","밀양시",1332,811,209,414,102,43,30,1,0,0,1,0,1,1,1,803,8,521
"9950","하남읍","하남읍제3투","대통령선거","경상남도","밀양시",1304,875,246,477,97,24,11,0,0,0,1,0,1,3,2,862,13,429
"9951","하남읍","하남읍제4투","대통령선거","경상남도","밀양시",1767,1085,279,565,124,87,20,2,1,0,0,0,1,0,1,1080,5,682
"9952","부북면","관내사전투표","대통령선거","경상남도","밀양시",1008,1008,273,552,92,43,34,2,0,0,1,0,0,0,2,999,9,0
"9953","부북면","부북면제1투","대통령선거","경상남도","밀양시",1251,858,189,490,112,37,21,0,0,0,0,1,1,3,1,855,3,393
"9954","부북면","부북면제2투","대통령선거","경상남도","밀양시",1236,842,221,462,91,34,24,1,0,0,0,0,2,2,1,838,4,394
"9955","부북면","부북면제3투","대통령선거","경상남도","밀양시",1274,846,190,467,106,35,32,2,0,0,0,1,0,1,3,837,9,428
"9956","상동면","관내사전투표","대통령선거","경상남도","밀양시",524,524,172,239,61,22,26,1,0,1,0,0,0,2,0,524,0,0
"9957","상동면","상동면제1투","대통령선거","경상남도","밀양시",1492,1050,250,611,123,27,28,0,0,0,0,0,2,3,0,1044,6,442
"9958","상동면","상동면제2투","대통령선거","경상남도","밀양시",650,464,92,272,63,16,10,1,0,0,0,0,1,2,0,457,7,186
"9959","산외면","관내사전투표","대통령선거","경상남도","밀양시",552,552,159,267,70,34,15,1,0,0,0,0,0,0,2,548,4,0
"9960","산외면","산외면제1투","대통령선거","경상남도","밀양시",1096,732,166,415,93,34,15,0,0,1,0,1,1,1,1,728,4,364
"9961","산외면","산외면제2투","대통령선거","경상남도","밀양시",820,546,108,321,73,22,14,1,0,0,0,1,0,0,2,542,4,274
"9962","산내면","관내사전투표","대통령선거","경상남도","밀양시",575,575,171,288,59,22,25,1,0,0,0,0,2,1,1,570,5,0
"9963","산내면","산내면제1투","대통령선거","경상남도","밀양시",1660,1122,242,657,143,46,20,0,0,0,0,0,1,5,2,1116,6,538
"9964","산내면","산내면제2투","대통령선거","경상남도","밀양시",1035,750,197,405,82,24,23,2,1,1,2,1,1,1,1,741,9,285
"9965","단장면","관내사전투표","대통령선거","경상남도","밀양시",598,598,191,293,56,29,21,2,0,2,1,0,0,0,0,595,3,0
"9966","단장면","단장면제1투","대통령선거","경상남도","밀양시",797,549,130,303,65,22,17,3,0,0,0,0,1,4,3,548,1,248
"9967","단장면","단장면제2투","대통령선거","경상남도","밀양시",1128,763,157,451,91,34,16,0,0,1,0,0,1,4,2,757,6,365
"9968","단장면","단장면제3투","대통령선거","경상남도","밀양시",1080,723,170,415,82,27,13,2,0,0,0,0,0,4,3,716,7,357
"9969","상남면","관내사전투표","대통령선거","경상남도","밀양시",1168,1168,404,451,142,88,64,5,1,0,0,2,3,2,0,1162,6,0
"9970","상남면","상남면제1투","대통령선거","경상남도","밀양시",2094,1373,333,701,191,74,47,4,0,1,1,0,1,1,2,1356,17,721
"9971","상남면","상남면제2투","대통령선거","경상남도","밀양시",1866,1249,401,513,166,96,57,0,0,0,0,0,0,5,1,1239,10,617
"9972","상남면","상남면제3투","대통령선거","경상남도","밀양시",2316,1534,328,898,189,61,39,0,1,1,2,0,3,2,3,1527,7,782
"9973","초동면","관내사전투표","대통령선거","경상남도","밀양시",526,526,150,257,55,32,23,0,0,0,2,0,0,1,3,523,3,0
"9974","초동면","초동면투표소","대통령선거","경상남도","밀양시",2345,1538,353,887,183,66,28,1,1,0,1,0,0,2,2,1524,14,807
"9975","무안면","관내사전투표","대통령선거","경상남도","밀양시",1114,1114,289,583,104,97,28,0,0,3,0,0,0,3,2,1109,5,0
"9976","무안면","무안면제1투","대통령선거","경상남도","밀양시",1844,1131,221,617,149,100,27,0,0,0,0,0,1,7,1,1123,8,713
"9977","무안면","무안면제2투","대통령선거","경상남도","밀양시",1559,989,204,558,118,65,22,1,1,0,1,0,4,6,2,982,7,570
"9978","청도면","관내사전투표","대통령선거","경상남도","밀양시",330,330,101,157,37,17,12,2,0,0,0,0,0,2,1,329,1,0
"9979","청도면","청도면투표소","대통령선거","경상남도","밀양시",1261,871,206,489,96,40,20,1,0,2,0,0,2,5,1,862,9,390
"9980","내일동","관내사전투표","대통령선거","경상남도","밀양시",886,886,242,404,120,62,50,2,0,1,0,2,0,1,0,884,2,0
"9981","내일동","내일동제1투","대통령선거","경상남도","밀양시",1781,1114,241,626,160,48,31,1,0,1,1,0,0,1,0,1110,4,667
"9982","내일동","내일동제2투","대통령선거","경상남도","밀양시",527,361,67,238,31,15,8,0,0,0,0,0,0,0,0,359,2,166
"9983","내이동","관내사전투표","대통령선거","경상남도","밀양시",1641,1641,520,712,169,129,101,3,0,0,0,1,0,2,1,1638,3,0
"9984","내이동","내이동제1투","대통령선거","경상남도","밀양시",2456,1749,502,824,229,127,54,3,0,1,1,1,0,0,1,1743,6,707
"9985","내이동","내이동제2투","대통령선거","경상남도","밀양시",1623,1002,240,530,128,66,27,4,1,0,1,1,1,1,0,1000,2,621
"9986","내이동","내이동제3투","대통령선거","경상남도","밀양시",3944,2279,686,1010,311,144,111,2,0,0,0,1,1,0,1,2267,12,1665
"9987","교동","관내사전투표","대통령선거","경상남도","밀양시",1770,1770,684,556,228,148,132,5,0,4,1,0,0,0,1,1759,11,0
"9988","교동","교동제1투","대통령선거","경상남도","밀양시",1340,957,278,422,139,70,41,0,0,0,0,0,0,0,2,952,5,383
"9989","교동","교동제2투","대통령선거","경상남도","밀양시",2414,1596,453,754,214,86,78,1,0,0,0,0,2,0,1,1589,7,818
"9990","삼문동","관내사전투표","대통령선거","경상남도","밀양시",4443,4443,1752,1440,548,390,278,9,1,2,0,5,0,0,2,4427,16,0
"9991","삼문동","삼문동제1투","대통령선거","경상남도","밀양시",1762,1270,396,553,178,89,44,1,0,0,0,0,0,1,1,1263,7,492
"9992","삼문동","삼문동제2투","대통령선거","경상남도","밀양시",1685,1130,261,607,150,65,34,4,0,0,0,0,0,2,2,1125,5,555
"9993","삼문동","삼문동제3투","대통령선거","경상남도","밀양시",2189,1471,478,578,211,103,88,2,0,1,2,1,0,0,1,1465,6,718
"9994","삼문동","삼문동제4투","대통령선거","경상남도","밀양시",2182,1514,424,679,228,96,75,2,0,1,0,1,0,0,0,1506,8,668
"9995","삼문동","삼문동제5투","대통령선거","경상남도","밀양시",2938,2169,822,724,313,188,104,2,0,1,0,4,0,5,2,2165,4,769
"9996","가곡동","관내사전투표","대통령선거","경상남도","밀양시",1122,1122,348,482,134,74,59,4,0,0,0,1,1,2,3,1108,14,0
"9997","가곡동","가곡동제1투","대통령선거","경상남도","밀양시",2626,1653,409,840,253,86,42,4,0,0,0,1,1,2,2,1640,13,973
"9998","가곡동","가곡동제2투","대통령선거","경상남도","밀양시",2175,1429,378,723,192,69,38,3,1,1,1,1,1,4,2,1414,15,746
"9999","잘못 투입·구분된 투표지","잘못 투입·구분된 투표지","대통령선거","경상남도","밀양시",0,0,0,0,0,0,0,0,0,0,0,0,0,0,0,0,0,0
"10000","거소·선상투표","거소·선상투표","대통령선거","경상남도","거제시",666,615,182,142,120,47,22,3,2,7,5,3,4,3,5,545,70,51
"10001","관외사전투표","관외사전투표","대통령선거","경상남도","거제시",15732,15729,7595,2618,2425,1523,1356,13,7,2,6,11,5,8,42,15611,118,3
"10002","재외투표","재외투표","대통령선거","경상남도","거제시",762,563,355,37,71,36,58,5,0,0,0,0,0,0,0,562,1,199
"10003","일운면","관내사전투표","대통령선거","경상남도","거제시",1177,1177,507,414,111,70,65,1,0,0,0,0,0,0,1,1169,8,0
"10004","일운면","일운면제1투","대통령선거","경상남도","거제시",3288,1995,730,766,236,133,104,1,0,2,0,0,3,3,1,1979,16,1293
"10005","일운면","일운면제2투","대통령선거","경상남도","거제시",1052,661,206,321,61,38,23,0,0,0,0,0,0,3,0,652,9,391
"10006","동부면","관내사전투표","대통령선거","경상남도","거제시",637,637,247,255,60,25,30,2,0,1,0,3,1,2,2,628,9,0
"10007","동부면","동부면투표소","대통령선거","경상남도","거제시",2340,1541,448,812,177,50,26,8,0,1,1,1,0,1,4,1529,12,799
"10008","남부면","관내사전투표","대통령선거","경상남도","거제시",227,227,67,103,41,10,4,0,0,0,0,1,0,0,0,226,1,0
"10009","남부면","남부면투표소","대통령선거","경상남도","거제시",1194,767,159,461,95,30,10,0,0,1,0,1,0,4,2,763,4,427
"10010","거제면","관내사전투표","대통령선거","경상남도","거제시",1715,1715,610,749,172,86,64,1,0,2,0,3,3,4,6,1700,15,0
"10011","거제면","거제면제1투","대통령선거","경상남도","거제시",2538,1557,567,699,150,62,54,2,0,0,1,0,0,1,5,1541,16,981
"10012","거제면","거제면제2투","대통령선거","경상남도","거제시",1599,1024,294,537,99,56,25,0,0,1,1,0,0,2,3,1018,6,575
"10013","둔덕면","관내사전투표","대통령선거","경상남도","거제시",730,730,240,367,59,29,25,2,0,1,0,0,0,3,0,726,4,0
"10014","둔덕면","둔덕면투표소","대통령선거","경상남도","거제시",2041,1323,303,776,123,65,36,0,1,0,1,2,0,3,2,1312,11,718
"10015","사등면","관내사전투표","대통령선거","경상남도","거제시",1682,1682,723,518,197,107,113,1,1,1,1,1,0,0,3,1666,16,0
"10016","사등면","사등면제1투","대통령선거","경상남도","거제시",1797,1048,293,516,125,59,35,1,0,0,0,0,1,0,1,1031,17,749
"10017","사등면","사등면제2투","대통령선거","경상남도","거제시",1954,1281,311,661,153,70,60,1,1,1,0,2,0,6,2,1268,13,673
"10018","사등면","사등면제3투","대통령선거","경상남도","거제시",898,665,141,400,72,25,14,1,0,0,0,0,0,4,2,659,6,233
"10019","사등면","사등면제4투","대통령선거","경상남도","거제시",3748,2693,1123,758,390,210,184,5,0,2,1,1,0,1,2,2677,16,1055
"10020","연초면","관내사전투표","대통령선거","경상남도","거제시",1515,1515,679,418,193,112,91,2,0,0,0,1,0,2,5,1503,12,0
"10021","연초면","연초면제1투","대통령선거","경상남도","거제시",3203,1925,705,729,257,112,104,0,0,2,1,1,1,3,3,1918,7,1278
"10022","연초면","연초면제2투","대통령선거","경상남도","거제시",2334,1333,506,478,194,77,64,2,0,0,0,0,0,1,1,1323,10,1001
"10023","연초면","연초면제3투","대통령선거","경상남도","거제시",736,434,159,168,66,19,18,0,0,0,0,0,0,0,1,431,3,302
"10024","하청면","관내사전투표","대통령선거","경상남도","거제시",979,979,365,410,107,56,35,0,0,0,0,0,0,0,1,974,5,0
"10025","하청면","하청면제1투","대통령선거","경상남도","거제시",2607,1578,485,667,240,77,87,0,0,2,0,2,1,3,5,1569,9,1029
"10026","하청면","하청면제2투","대통령선거","경상남도","거제시",893,565,97,366,56,30,10,0,0,2,2,0,1,1,0,565,0,328
"10027","장목면","관내사전투표","대통령선거","경상남도","거제시",969,969,261,528,97,36,32,0,0,0,0,4,0,1,3,962,7,0
"10028","장목면","장목면제1투","대통령선거","경상남도","거제시",2082,1149,249,679,106,66,29,2,1,2,0,1,1,3,3,1142,7,933
"10029","장목면","장목면제2투","대통령선거","경상남도","거제시",1080,702,152,411,85,26,23,0,0,1,0,0,1,0,0,699,3,378
"10030","장승포동","관내사전투표","대통령선거","경상남도","거제시",1514,1514,810,305,164,87,110,6,0,2,1,2,1,0,4,1492,22,0
"10031","장승포동","장승포동제1투","대통령선거","경상남도","거제시",2232,1259,464,453,159,83,67,5,0,0,0,0,1,3,4,1239,20,973
"10032","장승포동","장승포동제2투","대통령선거","경상남도","거제시",2611,1642,772,394,216,92,155,0,1,1,0,2,0,0,1,1634,8,969
"10033","능포동","관내사전투표","대통령선거","경상남도","거제시",1964,1964,1129,388,174,121,142,4,0,2,0,1,0,0,0,1961,3,0
"10034","능포동","능포동제1투","대통령선거","경상남도","거제시",2129,1139,429,408,149,60,80,1,0,1,1,0,0,1,2,1132,7,990
"10035","능포동","능포동제2투","대통령선거","경상남도","거제시",2175,1779,911,357,226,117,154,2,0,1,2,2,0,0,0,1772,7,396
"10036","능포동","능포동제3투","대통령선거","경상남도","거제시",2391,1412,610,448,192,76,76,0,0,1,0,0,0,0,0,1403,9,979
"10037","아주동","관내사전투표","대통령선거","경상남도","거제시",4167,4167,2685,413,407,292,353,2,1,0,0,2,1,1,2,4159,8,0
"10038","아주동","아주동제1투","대통령선거","경상남도","거제시",3569,2050,1085,332,328,136,158,3,0,1,0,0,0,2,1,2046,4,1519
"10039","아주동","아주동제2투","대통령선거","경상남도","거제시",3687,2479,1396,395,323,186,166,2,0,1,0,0,1,0,3,2473,6,1208
"10040","아주동","아주동제3투","대통령선거","경상남도","거제시",2429,1777,1037,246,245,133,113,0,0,0,1,1,0,0,0,1776,1,652
"10041","아주동","아주동제4투","대통령선거","경상남도","거제시",1735,1373,860,130,162,100,114,2,0,0,0,2,0,0,0,1370,3,362
"10042","아주동","아주동제5투","대통령선거","경상남도","거제시",1754,1486,886,132,214,122,128,0,0,0,0,0,1,0,1,1484,2,268
"10043","옥포1동","관내사전투표","대통령선거","경상남도","거제시",2297,2297,1314,392,248,152,173,2,0,1,1,4,0,1,1,2289,8,0
"10044","옥포1동","옥포1동제1투","대통령선거","경상남도","거제시",2767,1681,752,442,238,115,115,1,0,2,0,1,1,0,2,1669,12,1086
"10045","옥포1동","옥포1동제2투","대통령선거","경상남도","거제시",1917,1199,495,381,156,77,77,3,0,0,0,0,0,0,4,1193,6,718
"10046","옥포2동","관내사전투표","대통령선거","경상남도","거제시",3661,3661,1985,576,478,259,317,4,0,3,4,2,1,3,8,3640,21,0
"10047","옥포2동","옥포2동제1투","대통령선거","경상남도","거제시",2567,1597,734,437,205,84,116,5,1,1,0,0,1,1,3,1588,9,970
"10048","옥포2동","옥포2동제2투","대통령선거","경상남도","거제시",2863,1819,806,456,266,139,137,2,0,2,0,1,0,3,1,1813,6,1044
"10049","옥포2동","옥포2동제3투","대통령선거","경상남도","거제시",2598,1952,969,362,292,140,168,2,1,3,1,1,1,1,4,1945,7,646
"10050","옥포2동","옥포2동제4투","대통령선거","경상남도","거제시",2727,1712,728,474,275,104,112,5,1,1,2,1,0,2,2,1707,5,1015
"10051","옥포2동","옥포2동제5투","대통령선거","경상남도","거제시",2393,1606,782,322,249,108,126,5,0,0,1,0,4,1,2,1600,6,787
"10052","옥포2동","옥포2동제6투","대통령선거","경상남도","거제시",2703,1908,999,327,277,122,171,1,0,0,0,1,1,2,1,1902,6,795
"10053","옥포2동","옥포2동제7투","대통령선거","경상남도","거제시",589,389,128,156,69,15,17,1,0,0,0,0,0,0,1,387,2,200
"10054","장평동","관내사전투표","대통령선거","경상남도","거제시",4528,4528,2362,824,607,337,362,6,0,0,1,2,1,1,4,4507,21,0
"10055","장평동","장평동제1투","대통령선거","경상남도","거제시",1055,604,302,95,85,70,46,0,0,2,0,0,0,0,1,601,3,451
"10056","장평동","장평동제2투","대통령선거","경상남도","거제시",2500,1694,734,419,278,112,139,2,0,2,0,0,0,0,1,1687,7,806
"10057","장평동","장평동제3투","대통령선거","경상남도","거제시",1758,968,386,270,157,79,62,1,0,1,1,0,1,0,4,962,6,790
"10058","장평동","장평동제4투","대통령선거","경상남도","거제시",2225,1244,487,357,206,84,95,1,0,1,1,0,1,0,1,1234,10,981
"10059","장평동","장평동제5투","대통령선거","경상남도","거제시",2665,1636,668,444,242,142,126,1,0,0,1,0,1,0,2,1627,9,1029
"10060","장평동","장평동제6투","대통령선거","경상남도","거제시",3018,2022,862,507,302,192,146,3,0,2,1,1,0,0,1,2017,5,996
"10061","고현동","관내사전투표","대통령선거","경상남도","거제시",5065,5065,2410,1233,601,407,373,5,2,4,0,3,1,4,3,5046,19,0
"10062","고현동","고현동제1투","대통령선거","경상남도","거제시",1736,1054,353,393,144,81,65,1,1,1,0,0,0,2,3,1044,10,682
"10063","고현동","고현동제2투","대통령선거","경상남도","거제시",3004,1950,628,789,275,128,108,7,0,1,0,1,1,1,0,1939,11,1054
"10064","고현동","고현동제3투","대통령선거","경상남도","거제시",1903,1250,449,439,208,85,61,1,0,1,0,0,0,1,0,1245,5,653
"10065","고현동","고현동제4투","대통령선거","경상남도","거제시",1112,671,243,241,92,45,43,0,0,1,1,0,0,1,0,667,4,441
"10066","고현동","고현동제5투","대통령선거","경상남도","거제시",2134,1270,490,413,174,107,73,4,0,0,1,0,0,0,2,1264,6,864
"10067","고현동","고현동제6투","대통령선거","경상남도","거제시",2795,1859,757,547,257,144,135,5,2,0,0,0,1,0,6,1854,5,936
"10068","고현동","고현동제7투","대통령선거","경상남도","거제시",2882,2076,884,568,285,182,145,2,0,2,0,0,0,1,3,2072,4,806
"10069","고현동","고현동제8투","대통령선거","경상남도","거제시",2470,1893,842,432,291,174,141,1,0,1,1,1,0,1,4,1889,4,577
"10070","고현동","고현동제9투","대통령선거","경상남도","거제시",2578,2054,1010,393,304,186,149,0,0,0,0,1,0,0,3,2046,8,524
"10071","고현동","고현동제10투","대통령선거","경상남도","거제시",3150,2388,1175,396,380,232,181,2,2,1,1,1,2,0,2,2375,13,762
"10072","상문동","관내사전투표","대통령선거","경상남도","거제시",3374,3374,1909,488,423,257,272,5,0,1,0,3,0,2,5,3365,9,0
"10073","상문동","상문동제1투","대통령선거","경상남도","거제시",2400,1584,649,440,258,129,98,0,1,1,0,0,0,0,1,1577,7,816
"10074","상문동","상문동제2투","대통령선거","경상남도","거제시",2863,2411,1220,403,379,209,184,4,0,4,0,0,0,0,1,2404,7,452
"10075","상문동","상문동제3투","대통령선거","경상남도","거제시",3233,2255,1059,481,338,177,185,3,0,0,1,0,1,1,3,2249,6,978
"10076","상문동","상문동제4투","대통령선거","경상남도","거제시",2336,1691,757,388,277,137,117,1,1,1,0,2,0,1,1,1683,8,645
"10077","상문동","상문동제5투","대통령선거","경상남도","거제시",2168,1740,924,219,303,161,123,0,1,2,0,1,1,0,2,1737,3,428
"10078","수양동","관내사전투표","대통령선거","경상남도","거제시",3975,3975,2180,630,554,311,288,0,0,0,0,2,1,1,2,3969,6,0
"10079","수양동","수양동제1투","대통령선거","경상남도","거제시",1360,1045,501,221,151,82,83,0,0,0,1,1,0,2,1,1043,2,315
"10080","수양동","수양동제2투","대통령선거","경상남도","거제시",2523,1723,785,484,215,108,115,1,0,0,1,2,1,0,3,1715,8,800
"10081","수양동","수양동제3투","대통령선거","경상남도","거제시",2487,2004,967,464,284,182,98,0,0,0,0,1,0,0,1,1997,7,483
"10082","수양동","수양동제4투","대통령선거","경상남도","거제시",2025,1561,773,307,239,139,97,0,0,2,0,0,0,0,0,1557,4,464
"10083","잘못 투입·구분된 투표지","잘못 투입·구분된 투표지","대통령선거","경상남도","거제시",0,0,0,0,0,0,0,0,0,0,0,0,0,0,0,0,0,0
"10084","거소·선상투표","거소·선상투표","대통령선거","경상남도","의령군",110,97,30,42,15,4,3,0,0,0,0,0,1,0,1,96,1,13
"10085","관외사전투표","관외사전투표","대통령선거","경상남도","의령군",2585,2585,1011,859,318,198,164,5,0,2,1,2,1,2,7,2570,15,0
"10086","재외투표","재외투표","대통령선거","경상남도","의령군",459,154,55,11,69,6,10,2,0,0,0,0,0,0,1,154,0,305
"10087","의령읍","관내사전투표","대통령선거","경상남도","의령군",1774,1774,682,710,176,87,98,2,0,1,0,1,5,0,2,1764,10,0
"10088","의령읍","의령읍제1투","대통령선거","경상남도","의령군",2254,1503,424,745,174,81,49,1,0,2,0,0,4,5,6,1491,12,751
"10089","의령읍","의령읍제2투","대통령선거","경상남도","의령군",2888,1874,498,998,189,85,74,2,0,1,0,1,1,4,6,1859,15,1014
"10090","가례면","관내사전투표","대통령선거","경상남도","의령군",350,350,103,181,35,7,12,0,0,0,1,1,0,1,2,343,7,0
"10091","가례면","가례면투표소","대통령선거","경상남도","의령군",1158,698,124,413,69,25,24,1,0,1,0,1,2,8,3,671,27,460
"10092","칠곡면","관내사전투표","대통령선거","경상남도","의령군",268,268,75,136,26,12,10,0,0,1,0,1,0,1,2,264,4,0
"10093","칠곡면","칠곡면투표소","대통령선거","경상남도","의령군",719,497,115,293,54,12,12,0,0,1,0,1,0,2,2,492,5,222
"10094","대의면","관내사전투표","대통령선거","경상남도","의령군",215,215,77,108,12,11,5,0,0,0,0,0,0,0,1,214,1,0
"10095","대의면","대의면투표소","대통령선거","경상남도","의령군",703,500,109,295,48,12,8,1,1,0,2,1,4,6,1,488,12,203
"10096","화정면","관내사전투표","대통령선거","경상남도","의령군",278,278,75,155,19,13,7,2,0,1,0,2,0,0,1,275,3,0
"10097","화정면","화정면투표소","대통령선거","경상남도","의령군",1052,713,155,427,75,31,16,1,0,1,0,0,1,2,2,711,2,339
"10098","용덕면","관내사전투표","대통령선거","경상남도","의령군",194,194,56,99,17,8,10,1,0,0,0,0,0,0,1,192,2,0
"10099","용덕면","용덕면제1투","대통령선거","경상남도","의령군",586,418,52,295,45,13,3,0,1,0,0,0,0,3,2,414,4,168
"10100","용덕면","용덕면제2투","대통령선거","경상남도","의령군",567,377,90,207,44,14,13,0,0,2,0,1,0,3,2,376,1,190
"10101","정곡면","관내사전투표","대통령선거","경상남도","의령군",191,191,72,88,14,7,5,0,0,0,0,0,0,1,1,188,3,0
"10102","정곡면","정곡면투표소","대통령선거","경상남도","의령군",1036,694,149,418,52,30,9,3,0,0,1,0,5,12,8,687,7,342
"10103","지정면","관내사전투표","대통령선거","경상남도","의령군",317,317,80,176,22,14,11,1,1,0,0,1,0,2,1,309,8,0
"10104","지정면","지정면투표소","대통령선거","경상남도","의령군",1275,866,183,520,91,23,24,2,0,2,0,3,1,6,1,856,10,409
"10105","낙서면","관내사전투표","대통령선거","경상남도","의령군",131,131,21,83,16,5,4,0,0,0,0,0,0,0,0,129,2,0
"10106","낙서면","낙서면투표소","대통령선거","경상남도","의령군",554,380,47,275,23,10,7,1,0,1,0,2,1,2,4,373,7,174
"10107","부림면","관내사전투표","대통령선거","경상남도","의령군",635,635,150,370,47,24,26,0,0,2,0,1,3,1,2,626,9,0
"10108","부림면","부림면투표소","대통령선거","경상남도","의령군",2043,1312,266,782,139,40,45,1,0,3,0,0,6,12,7,1301,11,731
"10109","봉수면","관내사전투표","대통령선거","경상남도","의령군",186,186,33,128,10,2,4,0,0,0,1,0,0,3,3,184,2,0
"10110","봉수면","봉수면투표소","대통령선거","경상남도","의령군",641,421,61,304,31,4,8,1,0,0,0,1,3,3,1,417,4,220
"10111","궁류면","관내사전투표","대통령선거","경상남도","의령군",218,218,44,123,26,11,5,0,0,1,0,1,1,1,0,213,5,0
"10112","궁류면","궁류면투표소","대통령선거","경상남도","의령군",826,554,103,335,64,10,10,0,1,2,0,0,3,10,3,541,13,272
"10113","유곡면","관내사전투표","대통령선거","경상남도","의령군",174,174,47,97,15,6,5,1,0,0,0,0,0,0,0,171,3,0
"10114","유곡면","유곡면제1투","대통령선거","경상남도","의령군",487,384,60,273,24,7,5,1,1,0,1,0,0,3,2,377,7,103
"10115","유곡면","유곡면제2투","대통령선거","경상남도","의령군",428,300,68,188,25,8,4,0,0,0,1,0,0,4,0,298,2,128
"10116","잘못 투입·구분된 투표지","잘못 투입·구분된 투표지","대통령선거","경상남도","의령군",0,0,0,0,0,0,0,0,0,0,0,0,0,0,0,0,0,0
"10117","거소·선상투표","거소·선상투표","대통령선거","경상남도","함안군",216,195,59,78,34,13,4,0,1,0,0,0,0,1,0,190,5,21
"10118","관외사전투표","관외사전투표","대통령선거","경상남도","함안군",5713,5713,2240,1679,800,515,403,4,2,3,1,8,1,2,8,5666,47,0
"10119","재외투표","재외투표","대통령선거","경상남도","함안군",609,289,108,34,109,9,27,0,0,0,0,0,0,1,0,288,1,320
"10120","가야읍","관내사전투표","대통령선거","경상남도","함안군",2399,2399,1016,799,237,153,163,3,0,1,0,2,2,0,6,2382,17,0
"10121","가야읍","가야읍제1투","대통령선거","경상남도","함안군",2364,1579,435,788,190,87,61,1,0,1,0,0,1,1,2,1567,12,785
"10122","가야읍","가야읍제2투","대통령선거","경상남도","함안군",3328,2164,663,996,257,111,108,3,0,0,0,1,1,2,5,2147,17,1164
"10123","가야읍","가야읍제3투","대통령선거","경상남도","함안군",2936,2031,626,913,266,118,90,1,1,1,1,1,1,2,3,2024,7,905
"10124","가야읍","가야읍제4투","대통령선거","경상남도","함안군",2689,1770,478,859,212,100,95,1,1,1,1,1,1,2,6,1758,12,919
"10125","함안면","관내사전투표","대통령선거","경상남도","함안군",429,429,131,221,41,18,12,0,0,1,0,0,0,1,1,426,3,0
"10126","함안면","함안면투표소","대통령선거","경상남도","함안군",1690,1097,193,664,146,44,28,1,2,1,1,1,1,4,6,1092,5,593
"10127","군북면","관내사전투표","대통령선거","경상남도","함안군",1148,1148,347,547,115,76,37,2,0,0,0,3,2,1,4,1134,14,0
"10128","군북면","군북면제1투","대통령선거","경상남도","함안군",2155,1282,307,684,163,59,48,2,0,0,0,2,0,3,1,1269,13,873
"10129","군북면","군북면제2투","대통령선거","경상남도","함안군",685,487,114,276,54,20,7,0,0,0,1,0,3,5,0,480,7,198
"10130","군북면","군북면제3투","대통령선거","경상남도","함안군",889,564,111,348,53,22,20,0,0,0,1,0,0,1,0,556,8,325
"10131","군북면","군북면제4투","대통령선거","경상남도","함안군",574,385,79,238,44,9,8,0,0,0,0,1,1,1,2,383,2,189
"10132","법수면","관내사전투표","대통령선거","경상남도","함안군",549,549,160,293,51,20,18,0,0,0,0,1,1,1,1,546,3,0
"10133","법수면","법수면투표소","대통령선거","경상남도","함안군",2064,1254,299,670,150,53,57,2,1,0,1,1,3,5,1,1243,11,810
"10134","대산면","관내사전투표","대통령선거","경상남도","함안군",585,585,180,295,64,15,22,3,0,0,1,0,0,1,2,583,2,0
"10135","대산면","대산면투표소","대통령선거","경상남도","함안군",2613,1631,378,952,170,53,40,1,1,2,2,1,3,5,8,1616,15,982
"10136","칠서면","관내사전투표","대통령선거","경상남도","함안군",471,471,137,257,41,19,14,0,0,0,0,1,1,0,0,470,1,0
"10137","칠서면","칠서면제1투","대통령선거","경상남도","함안군",2077,1421,441,642,180,77,65,0,1,0,0,1,0,0,8,1415,6,656
"10138","칠서면","칠서면제2투","대통령선거","경상남도","함안군",674,439,78,281,43,19,10,1,0,0,1,0,1,0,0,434,5,235
"10139","칠서면","칠서면제3투","대통령선거","경상남도","함안군",1063,752,171,475,57,22,16,0,0,0,0,0,1,3,1,746,6,311
"10140","칠북면","관내사전투표","대통령선거","경상남도","함안군",325,325,90,162,37,17,10,0,2,4,0,1,0,0,0,323,2,0
"10141","칠북면","칠북면투표소","대통령선거","경상남도","함안군",1462,1026,155,696,103,31,25,1,0,0,1,0,1,4,5,1022,4,436
"10142","칠원읍","관내사전투표","대통령선거","경상남도","함안군",2186,2186,777,879,268,105,132,1,0,2,0,0,0,3,3,2170,16,0
"10143","칠원읍","칠원읍제1투","대통령선거","경상남도","함안군",3451,2256,564,1169,295,119,81,3,0,0,2,0,1,2,4,2240,16,1195
"10144","칠원읍","칠원읍제2투","대통령선거","경상남도","함안군",938,684,129,410,86,32,11,2,1,0,0,1,1,2,3,678,6,254
"10145","칠원읍","칠원읍제3투","대통령선거","경상남도","함안군",2940,2484,1089,697,367,175,142,2,0,0,1,2,1,0,0,2476,8,456
"10146","칠원읍","칠원읍제4투","대통령선거","경상남도","함안군",2174,1451,387,744,172,76,54,4,0,0,0,2,0,1,2,1442,9,723
"10147","칠원읍","칠원읍제5투","대통령선거","경상남도","함안군",2408,1870,772,635,244,116,94,2,0,0,1,0,1,1,0,1866,4,538
"10148","산인면","관내사전투표","대통령선거","경상남도","함안군",1206,1206,435,493,135,71,41,3,1,1,1,1,1,8,2,1193,13,0
"10149","산인면","산인면투표소","대통령선거","경상남도","함안군",1678,1103,298,586,122,55,29,0,3,0,1,1,0,1,1,1097,6,575
"10150","여항면","관내사전투표","대통령선거","경상남도","함안군",294,294,86,137,42,13,10,0,0,0,0,1,0,0,1,290,4,0
"10151","여항면","여항면투표소","대통령선거","경상남도","함안군",511,347,64,212,51,10,4,0,0,0,0,0,1,1,0,343,4,164
"10152","잘못 투입·구분된 투표지","잘못 투입·구분된 투표지","대통령선거","경상남도","함안군",0,0,0,0,0,0,0,0,0,0,0,0,0,0,0,0,0,0
"10153","거소·선상투표","거소·선상투표","대통령선거","경상남도","창녕군",241,214,46,100,23,9,3,2,0,4,3,0,1,0,1,192,22,27
"10154","관외사전투표","관외사전투표","대통령선거","경상남도","창녕군",5261,5259,1955,1816,635,467,325,5,1,2,2,4,3,0,13,5228,31,2
"10155","재외투표","재외투표","대통령선거","경상남도","창녕군",459,210,103,20,59,10,16,0,0,0,0,0,0,0,1,209,1,249
"10156","창녕읍","관내사전투표","대통령선거","경상남도","창녕군",3212,3212,984,1588,245,184,144,2,1,2,1,3,2,6,10,3172,40,0
"10157","창녕읍","창녕읍제1투","대통령선거","경상남도","창녕군",1976,1390,252,897,126,55,39,3,1,0,0,0,0,1,2,1376,14,586
"10158","창녕읍","창녕읍제2투","대통령선거","경상남도","창녕군",2450,1557,340,938,120,85,57,3,0,0,1,0,0,2,1,1547,10,893
"10159","창녕읍","창녕읍제3투","대통령선거","경상남도","창녕군",2235,1484,325,865,133,80,47,3,0,1,0,1,0,5,4,1464,20,751
"10160","창녕읍","창녕읍제4투","대통령선거","경상남도","창녕군",2975,2026,495,1151,181,94,63,4,0,0,0,1,1,2,1,1993,33,949
"10161","남지읍","관내사전투표","대통령선거","경상남도","창녕군",2083,2083,596,1115,168,96,85,0,1,0,1,0,1,5,1,2069,14,0
"10162","남지읍","남지읍제1투","대통령선거","경상남도","창녕군",3117,2028,452,1253,157,74,67,1,0,2,0,1,1,3,2,2013,15,1089
"10163","남지읍","남지읍제2투","대통령선거","경상남도","창녕군",3517,2334,523,1351,263,109,65,0,0,2,4,0,0,2,3,2322,12,1183
"10164","남지읍","남지읍제3투","대통령선거","경상남도","창녕군",915,668,79,500,45,12,13,0,0,0,0,1,2,6,2,660,8,247
"10165","고암면","관내사전투표","대통령선거","경상남도","창녕군",550,550,106,321,68,24,19,0,0,0,1,0,0,2,0,541,9,0
"10166","고암면","고암면투표소","대통령선거","경상남도","창녕군",1319,870,151,574,74,27,16,2,0,0,0,1,1,6,4,856,14,449
"10167","성산면","관내사전투표","대통령선거","경상남도","창녕군",395,395,55,280,28,14,8,0,0,0,4,0,0,4,0,393,2,0
"10168","성산면","성산면투표소","대통령선거","경상남도","창녕군",931,597,99,399,62,19,12,0,0,0,0,0,1,1,0,593,4,334
"10169","대합면","관내사전투표","대통령선거","경상남도","창녕군",879,879,153,584,73,32,19,0,0,1,0,0,1,6,5,874,5,0
"10170","대합면","대합면투표소","대통령선거","경상남도","창녕군",2405,1435,239,972,114,50,31,1,1,0,1,0,4,9,1,1423,12,970
"10171","이방면","관내사전투표","대통령선거","경상남도","창녕군",495,495,87,327,35,26,14,0,0,0,0,1,0,1,2,493,2,0
"10172","이방면","이방면투표소","대통령선거","경상남도","창녕군",1628,1095,159,794,69,32,16,5,1,0,1,1,1,9,3,1091,4,533
"10173","유어면","관내사전투표","대통령선거","경상남도","창녕군",351,351,85,207,22,15,10,0,0,0,0,1,0,1,0,341,10,0
"10174","유어면","유어면투표소","대통령선거","경상남도","창녕군",1244,889,154,607,61,23,12,1,3,1,0,0,2,2,12,878,11,355
"10175","대지면","관내사전투표","대통령선거","경상남도","창녕군",571,571,161,311,36,23,25,1,0,0,0,1,0,3,4,565,6,0
"10176","대지면","대지면투표소","대통령선거","경상남도","창녕군",1591,1109,179,749,79,45,27,0,0,1,1,2,1,1,0,1085,24,482
"10177","계성면","관내사전투표","대통령선거","경상남도","창녕군",439,439,103,254,41,23,13,0,0,0,0,0,0,0,0,434,5,0
"10178","계성면","계성면투표소","대통령선거","경상남도","창녕군",1682,1088,215,720,85,22,16,2,0,0,0,0,3,9,2,1074,14,594
"10179","영산면","관내사전투표","대통령선거","경상남도","창녕군",965,965,289,476,86,55,45,2,0,0,0,0,0,0,3,956,9,0
"10180","영산면","영산면제1투","대통령선거","경상남도","창녕군",2899,1905,413,1152,187,87,45,1,0,0,0,0,2,0,1,1888,17,994
"10181","영산면","영산면제2투","대통령선거","경상남도","창녕군",783,537,127,331,46,11,13,1,0,0,0,0,0,3,2,534,3,246
"10182","장마면","관내사전투표","대통령선거","경상남도","창녕군",409,409,87,267,33,13,3,0,0,0,0,0,0,0,2,405,4,0
"10183","장마면","장마면투표소","대통령선거","경상남도","창녕군",1186,776,179,484,58,17,16,0,1,0,0,2,2,5,4,768,8,410
"10184","도천면","관내사전투표","대통령선거","경상남도","창녕군",541,541,156,307,40,15,15,2,0,0,0,0,0,1,2,538,3,0
"10185","도천면","도천면투표소","대통령선거","경상남도","창녕군",1721,1109,231,689,102,39,26,0,0,0,0,6,1,3,0,1097,12,612
"10186","길곡면","관내사전투표","대통령선거","경상남도","창녕군",376,376,80,231,34,14,10,1,0,0,0,0,0,3,0,373,3,0
"10187","길곡면","길곡면투표소","대통령선거","경상남도","창녕군",921,679,135,428,56,24,16,4,0,0,0,2,2,3,6,676,3,242
"10188","부곡면","관내사전투표","대통령선거","경상남도","창녕군",768,768,209,411,75,32,21,0,1,0,0,2,3,2,2,758,10,0
"10189","부곡면","부곡면투표소","대통령선거","경상남도","창녕군",2406,1585,308,995,158,56,36,1,0,1,2,1,3,7,3,1571,14,821
"10190","잘못 투입·구분된 투표지","잘못 투입·구분된 투표지","대통령선거","경상남도","창녕군",0,0,0,0,0,0,0,0,0,0,0,0,0,0,0,0,0,0
"10191","거소·선상투표","거소·선상투표","대통령선거","경상남도","양산시",737,683,246,137,186,47,27,0,3,1,2,2,1,0,10,662,21,54
"10192","관외사전투표","관외사전투표","대통령선거","경상남도","양산시",18615,18614,8503,3783,2956,1731,1385,24,5,8,5,12,9,14,40,18475,139,1
"10193","재외투표","재외투표","대통령선거","경상남도","양산시",1166,887,541,53,147,42,97,0,0,0,0,1,0,0,3,884,3,279
"10194","물금읍","관내사전투표","대통령선거","경상남도","양산시",9972,9972,5329,2034,1261,719,528,6,2,7,2,4,1,4,13,9910,62,0
"10195","물금읍","물금읍제1투","대통령선거","경상남도","양산시",1262,831,224,380,139,45,31,1,0,1,0,1,0,0,0,822,9,431
"10196","물금읍","물금읍제2투","대통령선거","경상남도","양산시",3439,2527,1202,544,439,199,132,2,0,1,0,0,0,0,1,2520,7,912
"10197","물금읍","물금읍제3투","대통령선거","경상남도","양산시",3596,2541,919,906,358,165,135,2,2,3,5,7,1,0,6,2509,32,1055
"10198","물금읍","물금읍제4투","대통령선거","경상남도","양산시",2849,1893,727,621,295,133,101,0,3,0,0,3,0,0,1,1884,9,956
"10199","물금읍","물금읍제5투","대통령선거","경상남도","양산시",4114,3327,1650,691,564,252,152,2,0,1,0,3,1,1,1,3318,9,787
"10200","물금읍","물금읍제6투","대통령선거","경상남도","양산시",2334,1542,528,537,264,121,76,2,0,1,1,1,0,0,3,1534,8,792
"10201","물금읍","물금읍제7투","대통령선거","경상남도","양산시",1902,1384,515,448,211,112,87,0,0,1,0,2,0,0,3,1379,5,518
"10202","물금읍","물금읍제8투","대통령선거","경상남도","양산시",2137,1657,689,444,248,141,118,1,0,0,1,6,0,0,3,1651,6,480
"10203","물금읍","물금읍제9투","대통령선거","경상남도","양산시",2428,1545,671,348,273,139,98,4,0,1,0,2,0,1,1,1538,7,883
"10204","물금읍","물금읍제10투","대통령선거","경상남도","양산시",2862,2385,1167,584,338,167,120,1,0,0,0,0,0,2,1,2380,5,477
"10205","물금읍","물금읍제11투","대통령선거","경상남도","양산시",3069,2366,1033,664,378,156,107,2,1,0,2,2,0,1,7,2353,13,703
"10206","물금읍","물금읍제12투","대통령선거","경상남도","양산시",2156,1704,743,417,306,142,79,4,1,0,0,0,0,0,2,1694,10,452
"10207","물금읍","물금읍제13투","대통령선거","경상남도","양산시",2371,1989,998,403,306,167,97,6,0,2,0,0,0,0,1,1980,9,382
"10208","물금읍","물금읍제14투","대통령선거","경상남도","양산시",2863,2313,1128,458,380,199,134,1,0,2,0,1,0,1,3,2307,6,550
"10209","물금읍","물금읍제15투","대통령선거","경상남도","양산시",2942,1849,760,535,323,141,81,0,0,0,0,0,0,2,0,1842,7,1093
"10210","물금읍","물금읍제16투","대통령선거","경상남도","양산시",3247,2543,1136,605,460,206,124,1,0,2,0,0,0,2,0,2536,7,704
"10211","물금읍","물금읍제17투","대통령선거","경상남도","양산시",1763,1341,549,328,250,108,96,0,1,0,0,1,1,0,2,1336,5,422
"10212","물금읍","물금읍제18투","대통령선거","경상남도","양산시",4062,3141,1407,798,549,216,158,4,0,0,0,0,1,0,1,3134,7,921
"10213","물금읍","물금읍제19투","대통령선거","경상남도","양산시",659,442,139,200,68,15,14,0,0,0,1,0,0,0,3,440,2,217
"10214","물금읍","물금읍제20투","대통령선거","경상남도","양산시",2080,1746,846,340,312,138,100,1,1,1,1,0,0,0,1,1741,5,334
"10215","동면","관내사전투표","대통령선거","경상남도","양산시",1652,1652,817,455,200,94,78,1,0,0,1,1,0,1,2,1650,2,0
"10216","동면","동면제1투","대통령선거","경상남도","양산시",4396,2988,1106,1036,496,196,128,5,1,2,0,2,1,1,1,2975,13,1408
"10217","동면","동면제2투","대통령선거","경상남도","양산시",2596,1871,703,648,277,142,88,6,0,2,0,0,0,0,1,1867,4,725
"10218","동면","동면제3투","대통령선거","경상남도","양산시",2216,1611,624,541,258,95,78,3,0,1,0,1,0,0,1,1602,9,605
"10219","동면","동면제4투","대통령선거","경상남도","양산시",858,627,140,370,75,26,11,0,0,1,0,0,0,2,1,626,1,231
"10220","동면","동면제5투","대통령선거","경상남도","양산시",4288,3430,1698,747,569,240,167,1,0,0,0,1,1,0,2,3426,4,858
"10221","동면","동면제6투","대통령선거","경상남도","양산시",2382,1847,950,358,294,157,79,0,0,0,0,0,0,1,0,1839,8,535
"10222","원동면","관내사전투표","대통령선거","경상남도","양산시",368,368,111,190,39,13,9,0,0,1,0,0,0,1,0,364,4,0
"10223","원동면","원동면제1투","대통령선거","경상남도","양산시",950,593,117,373,58,23,16,0,0,1,0,0,0,0,3,591,2,357
"10224","원동면","원동면제2투","대통령선거","경상남도","양산시",929,661,146,377,81,35,15,2,0,0,0,1,0,3,0,660,1,268
"10225","원동면","원동면제3투","대통령선거","경상남도","양산시",494,342,75,193,54,8,7,0,0,0,0,0,2,1,0,340,2,152
"10226","상북면","관내사전투표","대통령선거","경상남도","양산시",2616,2616,950,1033,342,142,110,0,0,1,0,2,5,5,5,2595,21,0
"10227","상북면","상북면제1투","대통령선거","경상남도","양산시",1296,844,229,367,141,43,48,3,0,2,0,0,1,1,4,839,5,452
"10228","상북면","상북면제2투","대통령선거","경상남도","양산시",1322,872,221,418,139,43,35,2,0,1,0,0,1,2,0,862,10,450
"10229","상북면","상북면제3투","대통령선거","경상남도","양산시",1431,945,282,394,167,62,32,2,2,0,1,0,0,0,1,943,2,486
"10230","상북면","상북면제4투","대통령선거","경상남도","양산시",2429,1643,558,663,262,78,60,1,1,2,1,3,0,3,5,1637,6,786
"10231","상북면","상북면제5투","대통령선거","경상남도","양산시",1645,1113,402,422,170,73,39,0,0,0,1,1,0,1,0,1109,4,532
"10232","상북면","상북면제6투","대통령선거","경상남도","양산시",1020,592,150,313,66,37,22,1,0,0,0,0,0,0,0,589,3,428
"10233","하북면","관내사전투표","대통령선거","경상남도","양산시",1719,1719,613,703,219,87,73,0,1,0,0,4,1,6,2,1709,10,0
"10234","하북면","하북면제1투","대통령선거","경상남도","양산시",2361,1484,428,667,223,96,50,1,0,1,0,1,1,1,5,1474,10,877
"10235","하북면","하북면제2투","대통령선거","경상남도","양산시",769,500,129,270,58,22,13,3,0,0,0,0,0,1,2,498,2,269
"10236","하북면","하북면제3투","대통령선거","경상남도","양산시",958,661,138,380,72,40,22,1,0,2,0,0,0,1,0,656,5,297
"10237","하북면","하북면제4투","대통령선거","경상남도","양산시",1774,1096,283,542,160,70,29,1,0,0,0,1,1,1,1,1089,7,678
"10238","중앙동","관내사전투표","대통령선거","경상남도","양산시",1963,1963,804,682,244,127,88,3,0,2,2,2,0,1,1,1956,7,0
"10239","중앙동","중앙동제1투","대통령선거","경상남도","양산시",1831,1053,308,474,151,64,44,0,0,1,0,0,0,0,3,1045,8,778
"10240","중앙동","중앙동제2투","대통령선거","경상남도","양산시",2363,1457,417,666,230,81,49,0,1,1,0,0,1,2,1,1449,8,906
"10241","중앙동","중앙동제3투","대통령선거","경상남도","양산시",1818,1088,329,482,155,60,45,1,0,1,0,1,1,1,3,1079,9,730
"10242","중앙동","중앙동제4투","대통령선거","경상남도","양산시",1875,1190,290,584,185,75,47,1,0,0,0,0,0,0,1,1183,7,685
"10243","양주동","관내사전투표","대통령선거","경상남도","양산시",6463,6463,3280,1410,845,491,395,2,3,3,1,2,2,4,2,6440,23,0
"10244","양주동","양주동제1투","대통령선거","경상남도","양산시",1679,1062,377,373,180,60,61,0,0,2,0,0,0,1,0,1054,8,617
"10245","양주동","양주동제2투","대통령선거","경상남도","양산시",2064,1578,620,474,255,112,111,0,0,0,0,2,0,0,1,1575,3,486
"10246","양주동","양주동제3투","대통령선거","경상남도","양산시",1903,1509,589,393,273,122,113,3,0,2,1,0,0,0,3,1499,10,394
"10247","양주동","양주동제4투","대통령선거","경상남도","양산시",1568,1159,391,403,204,80,62,2,1,0,0,2,1,1,1,1148,11,409
"10248","양주동","양주동제5투","대통령선거","경상남도","양산시",1725,1344,557,379,214,89,94,1,0,0,0,4,0,1,1,1340,4,381
"10249","양주동","양주동제6투","대통령선거","경상남도","양산시",2508,1930,823,510,318,141,124,0,0,2,1,3,0,0,2,1924,6,578
"10250","양주동","양주동제7투","대통령선거","경상남도","양산시",2771,2296,1053,516,370,204,135,4,0,3,0,1,0,0,1,2287,9,475
"10251","양주동","양주동제8투","대통령선거","경상남도","양산시",2410,1895,871,460,306,144,99,6,0,2,0,2,0,1,2,1893,2,515
"10252","양주동","양주동제9투","대통령선거","경상남도","양산시",1882,1596,742,381,261,118,86,0,0,0,0,1,0,0,1,1590,6,286
"10253","양주동","양주동제10투","대통령선거","경상남도","양산시",1851,1348,457,484,230,102,60,2,0,3,0,1,1,3,0,1343,5,503
"10254","삼성동","관내사전투표","대통령선거","경상남도","양산시",3766,3766,1795,889,523,284,242,1,0,4,0,6,1,0,3,3748,18,0
"10255","삼성동","삼성동제1투","대통령선거","경상남도","양산시",2034,1276,462,407,214,87,87,1,0,1,0,3,0,1,0,1263,13,758
"10256","삼성동","삼성동제2투","대통령선거","경상남도","양산시",2939,2125,772,727,330,174,108,2,0,2,0,0,0,0,1,2116,9,814
"10257","삼성동","삼성동제3투","대통령선거","경상남도","양산시",2284,1401,485,495,244,103,62,2,1,0,0,1,0,0,3,1396,5,883
"10258","삼성동","삼성동제4투","대통령선거","경상남도","양산시",2708,1807,718,538,290,135,108,2,0,2,0,0,0,0,4,1797,10,901
"10259","삼성동","삼성동제5투","대통령선거","경상남도","양산시",2372,1663,654,460,306,127,101,0,0,2,1,1,2,0,1,1655,8,709
"10260","삼성동","삼성동제6투","대통령선거","경상남도","양산시",2655,1672,623,557,265,121,84,3,1,1,0,1,0,0,5,1661,11,983
"10261","강서동","관내사전투표","대통령선거","경상남도","양산시",1899,1899,933,431,258,136,123,1,0,4,0,1,1,0,4,1892,7,0
"10262","강서동","강서동제1투","대통령선거","경상남도","양산시",2889,1986,767,630,312,149,104,2,0,8,1,1,0,2,1,1977,9,903
"10263","강서동","강서동제2투","대통령선거","경상남도","양산시",2474,1582,563,510,306,96,87,3,0,3,0,5,0,2,1,1576,6,892
"10264","서창동","관내사전투표","대통령선거","경상남도","양산시",4760,4760,2176,1364,683,256,259,6,1,2,0,1,1,1,1,4751,9,0
"10265","서창동","서창동제1투","대통령선거","경상남도","양산시",1813,1135,338,506,182,62,42,1,0,0,0,0,0,0,0,1131,4,678
"10266","서창동","서창동제2투","대통령선거","경상남도","양산시",2723,1886,721,526,366,146,115,2,0,1,0,3,0,0,2,1882,4,837
"10267","서창동","서창동제3투","대통령선거","경상남도","양산시",2130,1227,428,461,208,64,52,2,0,1,0,1,0,0,2,1219,8,903
"10268","서창동","서창동제4투","대통령선거","경상남도","양산시",3805,2921,1337,697,468,211,193,0,0,1,0,0,1,2,2,2912,9,884
"10269","서창동","서창동제5투","대통령선거","경상남도","양산시",2050,1283,434,511,196,71,59,3,0,0,0,0,0,1,0,1275,8,767
"10270","서창동","서창동제6투","대통령선거","경상남도","양산시",2530,1201,393,389,243,95,63,2,1,0,0,1,0,2,4,1193,8,1329
"10271","서창동","서창동제7투","대통령선거","경상남도","양산시",2974,2285,1016,581,353,182,134,2,1,4,0,0,0,2,2,2277,8,689
"10272","소주동","관내사전투표","대통령선거","경상남도","양산시",2908,2908,1300,843,390,178,168,4,0,7,3,3,0,1,2,2899,9,0
"10273","소주동","소주동제1투","대통령선거","경상남도","양산시",2281,1586,570,568,242,88,106,3,0,1,0,1,1,1,1,1582,4,695
"10274","소주동","소주동제2투","대통령선거","경상남도","양산시",2067,1381,534,445,245,76,71,1,0,0,1,0,1,1,2,1377,4,686
"10275","소주동","소주동제3투","대통령선거","경상남도","양산시",2253,1498,519,540,267,85,68,4,0,2,0,0,0,0,2,1487,11,755
"10276","소주동","소주동제4투","대통령선거","경상남도","양산시",1608,1144,449,352,179,73,76,2,1,1,1,0,0,2,2,1138,6,464
"10277","소주동","소주동제5투","대통령선거","경상남도","양산시",2275,1267,436,481,212,71,55,3,0,2,0,0,1,0,3,1264,3,1008
"10278","소주동","소주동제6투","대통령선거","경상남도","양산시",2058,1305,545,378,219,89,66,1,0,0,1,0,0,2,1,1302,3,753
"10279","평산동","관내사전투표","대통령선거","경상남도","양산시",3907,3907,1819,1120,499,224,213,4,0,1,2,2,1,1,4,3890,17,0
"10280","평산동","평산동제1투","대통령선거","경상남도","양산시",2042,1453,619,379,265,92,82,4,0,1,0,1,0,1,1,1445,8,589
"10281","평산동","평산동제2투","대통령선거","경상남도","양산시",2548,1779,739,545,267,123,77,1,0,0,1,1,0,1,6,1761,18,769
"10282","평산동","평산동제3투","대통령선거","경상남도","양산시",2534,1894,751,671,270,93,93,4,0,1,0,0,0,1,2,1886,8,640
"10283","평산동","평산동제4투","대통령선거","경상남도","양산시",1751,1308,528,453,188,78,48,0,1,2,0,0,0,0,2,1300,8,443
"10284","평산동","평산동제5투","대통령선거","경상남도","양산시",3454,2006,729,722,320,124,92,4,1,2,2,0,1,0,1,1998,8,1448
"10285","평산동","평산동제6투","대통령선거","경상남도","양산시",1653,1046,399,357,157,74,51,0,0,0,0,2,0,0,2,1042,4,607
"10286","평산동","평산동제7투","대통령선거","경상남도","양산시",1989,1382,424,594,226,74,56,2,1,0,1,0,1,1,1,1381,1,607
"10287","평산동","평산동제8투","대통령선거","경상남도","양산시",2607,1967,878,535,284,150,104,8,0,0,1,1,1,1,1,1964,3,640
"10288","덕계동","관내사전투표","대통령선거","경상남도","양산시",3077,3077,1338,953,410,184,157,5,3,3,1,6,0,1,2,3063,14,0
"10289","덕계동","덕계동제1투","대통령선거","경상남도","양산시",2346,1566,576,618,214,93,59,1,0,0,0,0,0,1,0,1562,4,780
"10290","덕계동","덕계동제2투","대통령선거","경상남도","양산시",2560,1799,709,605,267,117,85,3,0,2,0,1,0,0,3,1792,7,761
"10291","덕계동","덕계동제3투","대통령선거","경상남도","양산시",2233,1458,507,584,225,76,56,1,0,0,1,0,0,1,1,1452,6,775
"10292","잘못 투입·구분된 투표지","잘못 투입·구분된 투표지","대통령선거","경상남도","양산시",0,1,0,0,0,1,0,0,0,0,0,0,0,0,0,1,0,-1
"10293","거소·선상투표","거소·선상투표","대통령선거","경상남도","하동군",496,423,119,129,66,25,7,4,2,7,0,3,6,4,9,381,42,73
"10294","관외사전투표","관외사전투표","대통령선거","경상남도","하동군",5120,5120,2157,1408,673,418,395,5,1,4,4,2,5,3,5,5080,40,0
"10295","재외투표","재외투표","대통령선거","경상남도","하동군",307,178,94,21,39,6,17,0,0,0,0,1,0,0,0,178,0,129
"10296","하동읍","관내사전투표","대통령선거","경상남도","하동군",2348,2348,922,910,239,123,129,4,0,3,1,1,2,0,3,2337,11,0
"10297","하동읍","하동읍제1투","대통령선거","경상남도","하동군",1662,1139,354,504,139,74,42,2,0,2,2,1,2,4,5,1131,8,523
"10298","하동읍","하동읍제2투","대통령선거","경상남도","하동군",1614,1103,395,449,138,73,36,1,0,1,2,1,1,0,0,1097,6,511
"10299","하동읍","하동읍제3투","대통령선거","경상남도","하동군",874,626,168,311,80,36,16,1,0,0,1,0,1,3,2,619,7,248
"10300","하동읍","하동읍제4투","대통령선거","경상남도","하동군",1592,1007,304,455,133,69,27,0,0,2,2,1,0,3,2,998,9,585
"10301","화개면","관내사전투표","대통령선거","경상남도","하동군",742,742,306,279,82,33,32,2,0,0,0,2,0,0,1,737,5,0
"10302","화개면","화개면제1투","대통령선거","경상남도","하동군",1280,824,318,296,118,40,28,3,0,1,2,1,0,6,2,815,9,456
"10303","화개면","화개면제2투","대통령선거","경상남도","하동군",648,466,159,195,65,13,22,0,0,1,1,1,0,3,1,461,5,182
"10304","악양면","관내사전투표","대통령선거","경상남도","하동군",913,913,281,428,106,28,47,0,0,0,0,4,3,4,2,903,10,0
"10305","악양면","악양면투표소","대통령선거","경상남도","하동군",2080,1337,381,612,172,56,68,3,2,1,3,4,5,5,6,1318,19,743
"10306","적량면","관내사전투표","대통령선거","경상남도","하동군",417,417,159,165,47,13,23,1,0,1,0,0,1,1,1,412,5,0
"10307","적량면","적량면투표소","대통령선거","경상남도","하동군",1256,869,234,417,128,36,29,1,1,0,0,0,1,8,5,860,9,387
"10308","횡천면","관내사전투표","대통령선거","경상남도","하동군",550,550,173,264,72,15,14,0,1,1,0,1,0,2,2,545,5,0
"10309","횡천면","횡천면투표소","대통령선거","경상남도","하동군",1119,786,200,414,89,44,26,0,0,0,0,0,3,2,3,781,5,333
"10310","고전면","관내사전투표","대통령선거","경상남도","하동군",484,484,159,206,54,29,18,1,0,3,1,2,1,1,1,476,8,0
"10311","고전면","고전면제1투","대통령선거","경상남도","하동군",798,543,150,269,67,32,9,1,0,0,3,1,0,2,0,534,9,255
"10312","고전면","고전면제2투","대통령선거","경상남도","하동군",636,456,140,214,50,16,18,3,0,0,0,1,2,4,4,452,4,180
"10313","금남면","관내사전투표","대통령선거","경상남도","하동군",752,752,258,312,89,39,32,1,2,0,1,0,0,3,1,738,14,0
"10314","금남면","금남면제1투","대통령선거","경상남도","하동군",1294,863,225,458,98,34,20,1,1,2,2,0,0,4,4,849,14,431
"10315","금남면","금남면제2투","대통령선거","경상남도","하동군",901,636,167,327,72,27,24,0,0,1,1,0,2,2,5,628,8,265
"10316","금성면","관내사전투표","대통령선거","경상남도","하동군",809,809,295,347,76,35,37,1,1,1,0,0,1,5,2,801,8,0
"10317","금성면","금성면제1투","대통령선거","경상남도","하동군",998,618,211,276,69,28,21,0,0,0,0,2,1,2,4,614,4,380
"10318","금성면","금성면제2투","대통령선거","경상남도","하동군",751,464,131,223,51,24,18,0,3,1,1,1,1,0,2,456,8,287
"10319","진교면","관내사전투표","대통령선거","경상남도","하동군",1729,1729,558,809,183,88,63,2,0,1,0,1,0,6,5,1716,13,0
"10320","진교면","진교면제1투","대통령선거","경상남도","하동군",1858,1159,364,511,144,63,46,2,0,0,0,4,1,1,6,1142,17,699
"10321","진교면","진교면제2투","대통령선거","경상남도","하동군",1472,1004,315,465,125,40,39,2,0,1,1,1,1,4,2,996,8,468
"10322","양보면","관내사전투표","대통령선거","경상남도","하동군",516,516,135,278,54,19,20,1,0,0,0,0,1,1,1,510,6,0
"10323","양보면","양보면투표소","대통령선거","경상남도","하동군",1005,661,161,366,79,24,18,1,0,2,1,1,0,3,3,659,2,344
"10324","북천면","관내사전투표","대통령선거","경상남도","하동군",476,476,103,266,58,18,14,2,2,0,0,0,0,1,4,468,8,0
"10325","북천면","북천면투표소","대통령선거","경상남도","하동군",985,616,117,392,62,21,10,3,0,0,0,0,2,3,0,610,6,369
"10326","청암면","관내사전투표","대통령선거","경상남도","하동군",304,304,84,157,33,11,12,0,0,0,0,1,0,1,2,301,3,0
"10327","청암면","청암면제1투","대통령선거","경상남도","하동군",464,329,54,193,49,13,10,0,0,1,0,0,1,3,4,328,1,135
"10328","청암면","청암면제2투","대통령선거","경상남도","하동군",365,257,89,106,39,3,12,0,0,0,0,0,0,4,2,255,2,108
"10329","옥종면","관내사전투표","대통령선거","경상남도","하동군",1138,1138,342,566,122,51,32,3,0,1,3,1,1,6,4,1132,6,0
"10330","옥종면","옥종면투표소","대통령선거","경상남도","하동군",2453,1662,429,866,190,75,58,6,1,0,0,3,3,9,9,1649,13,791
"10331","잘못 투입·구분된 투표지","잘못 투입·구분된 투표지","대통령선거","경상남도","하동군",0,0,0,0,0,0,0,0,0,0,0,0,0,0,0,0,0,0
"10332","거소·선상투표","거소·선상투표","대통령선거","경상남도","남해군",192,170,44,54,38,7,4,2,2,1,0,0,1,3,5,161,9,22
"10333","관외사전투표","관외사전투표","대통령선거","경상남도","남해군",2993,2993,1190,786,426,284,264,4,0,0,0,1,1,1,7,2964,29,0
"10334","재외투표","재외투표","대통령선거","경상남도","남해군",336,170,82,15,54,8,10,1,0,0,0,0,0,0,0,170,0,166
"10335","남해읍","관내사전투표","대통령선거","경상남도","남해군",2780,2780,1031,1025,297,201,189,3,0,3,1,1,0,2,6,2759,21,0
"10336","남해읍","남해읍제1투","대통령선거","경상남도","남해군",1899,1250,345,549,198,77,69,0,0,1,1,0,2,1,1,1244,6,649
"10337","남해읍","남해읍제2투","대통령선거","경상남도","남해군",1145,740,199,391,88,31,20,0,2,1,0,0,1,3,0,736,4,405
"10338","남해읍","남해읍제3투","대통령선거","경상남도","남해군",1840,1257,375,540,165,81,65,0,1,6,1,1,2,2,2,1241,16,583
"10339","남해읍","남해읍제4투","대통령선거","경상남도","남해군",2489,1621,430,736,242,86,89,1,0,2,1,1,4,1,6,1599,22,868
"10340","이동면","관내사전투표","대통령선거","경상남도","남해군",749,749,224,373,80,36,23,1,3,0,0,1,0,1,1,743,6,0
"10341","이동면","이동면제1투","대통령선거","경상남도","남해군",1097,732,161,392,113,31,20,0,0,0,0,0,1,1,2,721,11,365
"10342","이동면","이동면제2투","대통령선거","경상남도","남해군",805,550,139,290,80,22,9,1,0,0,0,0,2,1,1,545,5,255
"10343","이동면","이동면제3투","대통령선거","경상남도","남해군",828,566,125,319,78,19,15,0,0,0,1,1,1,4,1,564,2,262
"10344","상주면","관내사전투표","대통령선거","경상남도","남해군",320,320,105,148,33,14,11,1,0,0,0,0,1,3,2,318,2,0
"10345","상주면","상주면투표소","대통령선거","경상남도","남해군",1100,734,183,376,95,45,21,0,1,1,0,0,1,3,1,727,7,366
"10346","삼동면","관내사전투표","대통령선거","경상남도","남해군",488,488,165,193,69,27,29,1,0,0,1,0,0,1,0,486,2,0
"10347","삼동면","삼동면제1투","대통령선거","경상남도","남해군",1283,852,199,475,115,33,19,0,0,0,0,0,2,1,2,846,6,431
"10348","삼동면","삼동면제2투","대통령선거","경상남도","남해군",1561,1064,291,537,138,48,33,1,0,1,0,1,2,3,3,1058,6,497
"10349","미조면","관내사전투표","대통령선거","경상남도","남해군",537,537,159,245,53,31,39,2,0,1,0,0,0,0,1,531,6,0
"10350","미조면","미조면투표소","대통령선거","경상남도","남해군",1638,1013,227,554,139,49,25,3,2,0,1,2,1,2,3,1008,5,625
"10351","남면","관내사전투표","대통령선거","경상남도","남해군",952,952,242,508,101,46,28,2,1,0,0,3,0,3,4,938,14,0
"10352","남면","남면제1투","대통령선거","경상남도","남해군",1251,749,180,418,98,22,23,1,0,1,1,1,1,0,0,746,3,502
"10353","남면","남면제2투","대통령선거","경상남도","남해군",1036,563,154,275,82,24,10,2,0,0,1,0,2,4,3,557,6,473
"10354","서면","관내사전투표","대통령선거","경상남도","남해군",414,414,130,210,41,20,8,0,0,0,0,0,0,1,2,412,2,0
"10355","서면","서면제1투","대통령선거","경상남도","남해군",1255,833,202,485,78,28,26,0,1,2,0,0,1,3,3,829,4,422
"10356","서면","서면제2투","대통령선거","경상남도","남해군",695,503,103,297,62,22,8,0,0,0,0,0,0,2,1,495,8,192
"10357","고현면","관내사전투표","대통령선거","경상남도","남해군",770,770,252,350,90,39,22,2,0,1,1,2,1,1,7,768,2,0
"10358","고현면","고현면제1투","대통령선거","경상남도","남해군",1206,727,193,357,95,42,21,3,0,0,0,1,1,2,5,720,7,479
"10359","고현면","고현면제2투","대통령선거","경상남도","남해군",1116,754,266,299,105,38,34,0,0,1,0,0,0,2,4,749,5,362
"10360","설천면","관내사전투표","대통령선거","경상남도","남해군",534,534,177,244,69,21,17,0,0,1,0,0,1,0,0,530,4,0
"10361","설천면","설천면제1투","대통령선거","경상남도","남해군",1343,857,257,411,108,45,17,0,0,0,1,2,0,2,2,845,12,486
"10362","설천면","설천면제2투","대통령선거","경상남도","남해군",688,528,142,281,61,17,11,0,0,1,0,1,0,2,5,521,7,160
"10363","창선면","관내사전투표","대통령선거","경상남도","남해군",861,861,222,464,104,36,17,2,0,2,1,0,3,2,3,856,5,0
"10364","창선면","창선면제1투","대통령선거","경상남도","남해군",1930,1250,263,729,157,45,32,1,0,0,1,1,0,4,3,1236,14,680
"10365","창선면","창선면제2투","대통령선거","경상남도","남해군",1161,735,115,494,66,32,10,1,0,0,1,0,1,2,0,722,13,426
"10366","창선면","창선면제3투","대통령선거","경상남도","남해군",905,592,108,346,88,20,10,1,0,1,1,0,2,5,1,583,9,313
"10367","잘못 투입·구분된 투표지","잘못 투입·구분된 투표지","대통령선거","경상남도","남해군",0,0,0,0,0,0,0,0,0,0,0,0,0,0,0,0,0,0
"10368","거소·선상투표","거소·선상투표","대통령선거","경상남도","함양군",262,242,80,67,28,11,12,2,3,1,4,5,1,2,3,219,23,20
"10369","관외사전투표","관외사전투표","대통령선거","경상남도","함양군",2747,2747,1090,754,368,211,272,6,0,1,0,0,2,3,5,2712,35,0
"10370","재외투표","재외투표","대통령선거","경상남도","함양군",299,152,73,19,41,5,12,0,0,0,0,0,0,0,0,150,2,147
"10371","함양읍","관내사전투표","대통령선거","경상남도","함양군",3150,3150,1146,1182,371,201,202,6,1,3,2,1,1,7,4,3127,23,0
"10372","함양읍","함양읍제1투","대통령선거","경상남도","함양군",1473,901,204,483,123,34,35,2,0,7,0,1,1,3,1,894,7,572
"10373","함양읍","함양읍제2투","대통령선거","경상남도","함양군",1799,1232,252,739,117,64,37,2,1,1,0,1,0,1,3,1218,14,567
"10374","함양읍","함양읍제3투","대통령선거","경상남도","함양군",2610,1741,531,747,242,109,87,4,1,1,1,1,2,1,1,1728,13,869
"10375","함양읍","함양읍제4투","대통령선거","경상남도","함양군",910,605,139,331,91,24,9,0,1,1,1,1,0,2,1,601,4,305
"10376","함양읍","함양읍제5투","대통령선거","경상남도","함양군",1820,1322,392,611,173,76,50,3,1,1,0,1,1,2,1,1312,10,498
"10377","함양읍","함양읍제6투","대통령선거","경상남도","함양군",1306,797,187,439,96,42,20,3,0,0,0,1,0,2,0,790,7,509
"10378","함양읍","함양읍제7투","대통령선거","경상남도","함양군",648,398,77,221,61,15,18,1,0,0,0,0,1,2,0,396,2,250
"10379","마천면","관내사전투표","대통령선거","경상남도","함양군",512,512,186,239,49,11,18,0,0,1,0,0,0,4,2,510,2,0
"10380","마천면","마천면투표소","대통령선거","경상남도","함양군",1406,892,237,448,115,33,23,0,1,1,4,3,5,7,3,880,12,514
"10381","휴천면","관내사전투표","대통령선거","경상남도","함양군",284,284,81,141,33,14,9,1,1,0,0,0,0,0,0,280,4,0
"10382","휴천면","휴천면투표소","대통령선거","경상남도","함양군",1040,643,157,362,75,20,15,0,0,0,0,0,5,3,1,638,5,397
"10383","유림면","관내사전투표","대통령선거","경상남도","함양군",325,325,100,159,32,22,3,0,0,2,0,0,0,6,0,324,1,0
"10384","유림면","유림면투표소","대통령선거","경상남도","함양군",1193,762,151,450,88,25,17,1,0,3,0,0,0,11,5,751,11,431
"10385","수동면","관내사전투표","대통령선거","경상남도","함양군",601,601,161,335,55,23,13,1,1,1,1,0,0,5,1,597,4,0
"10386","수동면","수동면투표소","대통령선거","경상남도","함양군",1469,984,170,615,111,42,25,4,0,1,0,1,1,2,2,974,10,485
"10387","지곡면","관내사전투표","대통령선거","경상남도","함양군",461,461,125,225,70,18,18,2,0,0,0,1,0,0,0,459,2,0
"10388","지곡면","지곡면투표소","대통령선거","경상남도","함양군",1313,902,216,502,101,37,25,1,0,0,1,1,1,3,5,893,9,411
"10389","안의면","관내사전투표","대통령선거","경상남도","함양군",1251,1251,266,751,129,31,31,3,2,3,1,2,2,7,5,1233,18,0
"10390","안의면","안의면제1투","대통령선거","경상남도","함양군",1548,1041,196,633,111,52,24,0,0,0,0,2,0,5,5,1028,13,507
"10391","안의면","안의면제2투","대통령선거","경상남도","함양군",1289,770,159,452,86,27,26,0,1,2,0,1,1,2,3,760,10,519
"10392","서하면","관내사전투표","대통령선거","경상남도","함양군",299,299,83,139,43,19,9,0,0,0,0,0,0,3,0,296,3,0
"10393","서하면","서하면투표소","대통령선거","경상남도","함양군",862,598,138,335,62,25,12,0,0,2,1,2,1,8,2,588,10,264
"10394","서상면","관내사전투표","대통령선거","경상남도","함양군",313,313,113,130,35,16,17,0,0,0,0,0,0,1,0,312,1,0
"10395","서상면","서상면투표소","대통령선거","경상남도","함양군",1255,864,202,502,83,28,31,1,0,0,0,1,0,4,1,853,11,391
"10396","백전면","관내사전투표","대통령선거","경상남도","함양군",241,241,87,111,24,10,6,0,0,0,0,0,0,1,0,239,2,0
"10397","백전면","백전면투표소","대통령선거","경상남도","함양군",1079,743,179,402,93,31,22,1,0,0,0,0,2,5,5,740,3,336
"10398","병곡면","관내사전투표","대통령선거","경상남도","함양군",268,268,80,144,22,14,6,0,0,0,0,0,0,1,0,267,1,0
"10399","병곡면","병곡면투표소","대통령선거","경상남도","함양군",866,599,130,340,75,25,14,0,0,0,0,1,0,8,2,595,4,267
"10400","잘못 투입·구분된 투표지","잘못 투입·구분된 투표지","대통령선거","경상남도","함양군",0,0,0,0,0,0,0,0,0,0,0,0,0,0,0,0,0,0
"10401","거소·선상투표","거소·선상투표","대통령선거","경상남도","산청군",155,134,42,45,29,7,2,1,0,1,1,0,0,0,1,129,5,21
"10402","관외사전투표","관외사전투표","대통령선거","경상남도","산청군",3440,3440,1338,1110,420,279,241,3,2,6,0,3,3,3,8,3416,24,0
"10403","재외투표","재외투표","대통령선거","경상남도","산청군",292,131,64,8,40,9,8,2,0,0,0,0,0,0,0,131,0,161
"10404","산청읍","관내사전투표","대통령선거","경상남도","산청군",1352,1352,477,575,123,85,73,2,0,2,3,3,0,2,2,1347,5,0
"10405","산청읍","산청읍제1투","대통령선거","경상남도","산청군",3007,1963,464,1053,216,107,82,5,0,3,2,1,1,6,4,1944,19,1044
"10406","산청읍","산청읍제2투","대통령선거","경상남도","산청군",862,584,147,315,67,25,14,1,0,1,1,0,2,5,3,581,3,278
"10407","차황면","관내사전투표","대통령선거","경상남도","산청군",267,267,90,136,16,12,10,0,0,0,0,0,0,2,1,267,0,0
"10408","차황면","차황면투표소","대통령선거","경상남도","산청군",1000,676,124,421,75,22,15,0,0,0,0,1,2,5,1,666,10,324
"10409","오부면","관내사전투표","대통령선거","경상남도","산청군",210,210,56,114,21,5,9,0,0,0,0,0,1,0,2,208,2,0
"10410","오부면","오부면투표소","대통령선거","경상남도","산청군",707,485,99,295,46,6,13,1,0,0,0,0,3,11,4,478,7,222
"10411","생초면","관내사전투표","대통령선거","경상남도","산청군",368,368,92,188,42,16,18,0,0,0,0,0,1,0,1,358,10,0
"10412","생초면","생초면투표소","대통령선거","경상남도","산청군",1495,1004,183,664,86,33,15,0,1,0,0,0,3,4,1,990,14,491
"10413","금서면","관내사전투표","대통령선거","경상남도","산청군",435,435,154,181,45,26,24,0,0,0,0,0,1,2,1,434,1,0
"10414","금서면","금서면제1투","대통령선거","경상남도","산청군",1317,818,147,484,100,39,27,0,0,0,2,0,2,5,5,811,7,499
"10415","금서면","금서면제2투","대통령선거","경상남도","산청군",644,478,118,266,45,25,11,0,0,0,0,1,1,3,3,473,5,166
"10416","삼장면","관내사전투표","대통령선거","경상남도","산청군",278,278,69,157,34,8,6,1,0,0,0,0,1,0,0,276,2,0
"10417","삼장면","삼장면투표소","대통령선거","경상남도","산청군",1218,857,175,528,87,35,24,0,0,1,0,1,0,3,1,855,2,361
"10418","시천면","관내사전투표","대통령선거","경상남도","산청군",771,771,235,391,61,33,30,0,1,0,3,0,0,3,2,759,12,0
"10419","시천면","시천면제1투","대통령선거","경상남도","산청군",1400,902,174,525,120,47,21,1,0,1,1,1,0,2,4,897,5,498
"10420","시천면","시천면제2투","대통령선거","경상남도","산청군",1147,759,152,476,79,25,14,0,0,1,1,0,0,2,4,754,5,388
"10421","단성면","관내사전투표","대통령선거","경상남도","산청군",980,980,250,533,119,31,30,2,0,1,0,1,2,2,1,972,8,0
"10422","단성면","단성면제1투","대통령선거","경상남도","산청군",2810,1693,374,974,197,68,41,6,1,0,1,1,1,12,2,1678,15,1117
"10423","단성면","단성면제2투","대통령선거","경상남도","산청군",756,534,108,332,50,20,10,1,0,0,0,4,1,3,3,532,2,222
"10424","신안면","관내사전투표","대통령선거","경상남도","산청군",977,977,345,393,132,51,44,1,0,1,1,0,1,1,3,973,4,0
"10425","신안면","신안면제1투","대통령선거","경상남도","산청군",2401,1613,453,771,204,78,73,6,0,0,1,2,2,5,3,1598,15,788
"10426","신안면","신안면제2투","대통령선거","경상남도","산청군",1084,666,162,390,67,19,20,0,0,0,0,0,1,1,2,662,4,418
"10427","생비량면","관내사전투표","대통령선거","경상남도","산청군",164,164,45,85,10,12,7,1,0,1,0,0,0,0,0,161,3,0
"10428","생비량면","생비량면투표소","대통령선거","경상남도","산청군",843,597,92,387,63,15,12,1,0,0,0,0,2,6,8,586,11,246
"10429","신등면","관내사전투표","대통령선거","경상남도","산청군",435,435,103,214,68,24,12,5,0,2,1,0,1,1,1,432,3,0
"10430","신등면","신등면투표소","대통령선거","경상남도","산청군",1400,942,229,533,91,34,29,1,1,0,1,2,2,2,2,927,15,458
"10431","잘못 투입·구분된 투표지","잘못 투입·구분된 투표지","대통령선거","경상남도","산청군",0,0,0,0,0,0,0,0,0,0,0,0,0,0,0,0,0,0
"10432","거소·선상투표","거소·선상투표","대통령선거","경상남도","거창군",153,139,34,61,26,8,5,0,0,0,1,0,0,0,0,135,4,14
"10433","관외사전투표","관외사전투표","대통령선거","경상남도","거창군",3978,3978,1592,919,616,397,372,2,0,8,3,3,5,8,17,3942,36,0
"10434","재외투표","재외투표","대통령선거","경상남도","거창군",513,258,148,17,62,3,20,6,0,0,0,1,0,0,0,257,1,255
"10435","거창읍","관내사전투표","대통령선거","경상남도","거창군",6187,6187,2307,2167,679,500,454,5,1,5,2,7,4,6,13,6150,37,0
"10436","거창읍","거창읍제1투","대통령선거","경상남도","거창군",2356,1590,509,684,219,86,73,3,0,0,0,1,0,1,3,1579,11,766
"10437","거창읍","거창읍제2투","대통령선거","경상남도","거창군",2465,1611,371,874,197,104,42,2,0,0,0,2,1,2,3,1598,13,854
"10438","거창읍","거창읍제3투","대통령선거","경상남도","거창군",2726,1832,505,891,230,105,78,0,0,4,0,2,1,2,1,1819,13,894
"10439","거창읍","거창읍제4투","대통령선거","경상남도","거창군",3396,2236,601,1087,271,155,96,2,0,2,0,1,1,3,4,2223,13,1160
"10440","거창읍","거창읍제5투","대통령선거","경상남도","거창군",3095,2109,513,1028,272,169,101,3,0,3,0,0,1,3,1,2094,15,986
"10441","거창읍","거창읍제6투","대통령선거","경상남도","거창군",2203,1507,373,777,193,92,50,3,0,1,0,3,0,4,2,1498,9,696
"10442","거창읍","거창읍제7투","대통령선거","경상남도","거창군",1305,872,198,520,86,28,26,1,0,0,1,0,0,7,2,869,3,433
"10443","거창읍","거창읍제8투","대통령선거","경상남도","거창군",1328,967,185,603,82,36,38,0,1,0,0,3,2,4,0,954,13,361
"10444","거창읍","거창읍제9투","대통령선거","경상남도","거창군",1505,1118,359,465,168,80,34,3,0,0,0,1,1,0,3,1114,4,387
"10445","거창읍","거창읍제10투","대통령선거","경상남도","거창군",2584,1627,419,820,197,101,76,1,0,0,2,1,1,2,1,1621,6,957
"10446","주상면","관내사전투표","대통령선거","경상남도","거창군",399,399,103,225,32,22,9,0,0,1,0,0,0,0,3,395,4,0
"10447","주상면","주상면투표소","대통령선거","경상남도","거창군",1053,767,112,516,89,17,11,2,0,0,3,1,1,3,2,757,10,286
"10448","웅양면","관내사전투표","대통령선거","경상남도","거창군",519,519,151,256,57,15,29,0,1,1,1,2,0,2,1,516,3,0
"10449","웅양면","웅양면투표소","대통령선거","경상남도","거창군",1227,874,197,514,89,23,28,0,0,1,0,0,4,4,3,863,11,353
"10450","고제면","관내사전투표","대통령선거","경상남도","거창군",396,396,98,223,40,15,12,2,0,1,0,0,1,2,0,394,2,0
"10451","고제면","고제면투표소","대통령선거","경상남도","거창군",968,690,138,395,82,24,25,2,0,2,1,1,0,3,1,674,16,278
"10452","북상면","관내사전투표","대통령선거","경상남도","거창군",438,438,111,224,45,23,26,0,0,1,0,2,0,0,0,432,6,0
"10453","북상면","북상면투표소","대통령선거","경상남도","거창군",975,650,135,355,86,30,23,1,2,1,0,0,2,3,2,640,10,325
"10454","위천면","관내사전투표","대통령선거","경상남도","거창군",481,481,138,249,45,24,11,0,0,1,1,0,2,1,4,476,5,0
"10455","위천면","위천면투표소","대통령선거","경상남도","거창군",1356,967,183,566,120,51,24,1,0,1,0,2,2,2,1,953,14,389
"10456","마리면","관내사전투표","대통령선거","경상남도","거창군",506,506,132,260,58,20,24,1,1,0,0,0,1,2,0,499,7,0
"10457","마리면","마리면투표소","대통령선거","경상남도","거창군",1400,968,155,612,126,33,28,1,0,0,0,2,3,1,3,964,4,432
"10458","남상면","관내사전투표","대통령선거","경상남도","거창군",619,619,151,342,50,32,24,0,0,1,1,1,0,3,2,607,12,0
"10459","남상면","남상면투표소","대통령선거","경상남도","거창군",1671,1155,183,738,118,48,29,0,2,3,0,1,2,6,6,1136,19,516
"10460","남하면","관내사전투표","대통령선거","경상남도","거창군",460,460,127,234,54,27,16,0,0,0,0,0,0,0,1,459,1,0
"10461","남하면","남하면투표소","대통령선거","경상남도","거창군",1011,703,108,446,77,26,24,1,0,0,0,0,3,5,0,690,13,308
"10462","신원면","관내사전투표","대통령선거","경상남도","거창군",367,367,89,203,38,12,11,0,0,0,0,0,1,4,4,362,5,0
"10463","신원면","신원면투표소","대통령선거","경상남도","거창군",1027,727,145,435,75,35,7,0,0,0,2,2,4,6,7,718,9,300
"10464","가조면","관내사전투표","대통령선거","경상남도","거창군",1014,1014,251,600,85,26,30,0,1,0,0,2,3,2,2,1002,12,0
"10465","가조면","가조면투표소","대통령선거","경상남도","거창군",2435,1674,269,1112,155,49,42,2,3,0,0,2,5,7,5,1651,23,761
"10466","가북면","관내사전투표","대통령선거","경상남도","거창군",220,220,51,112,24,11,11,2,0,0,0,0,0,5,0,216,4,0
"10467","가북면","가북면투표소","대통령선거","경상남도","거창군",1009,700,115,446,80,20,14,0,0,0,4,5,3,2,3,692,8,309
"10468","잘못 투입·구분된 투표지","잘못 투입·구분된 투표지","대통령선거","경상남도","거창군",0,0,0,0,0,0,0,0,0,0,0,0,0,0,0,0,0,0
"10469","거소·선상투표","거소·선상투표","대통령선거","경상남도","합천군",321,304,51,150,42,12,4,2,3,3,0,0,1,2,3,273,31,17
"10470","관외사전투표","관외사전투표","대통령선거","경상남도","합천군",4100,4100,1392,1482,505,372,302,6,2,3,2,3,0,2,4,4075,25,0
"10471","재외투표","재외투표","대통령선거","경상남도","합천군",548,223,96,22,78,9,13,0,1,0,0,0,0,0,2,221,2,325
"10472","합천읍","관내사전투표","대통령선거","경상남도","합천군",2700,2700,816,1266,275,152,154,2,1,3,1,1,0,3,1,2675,25,0
"10473","합천읍","합천읍제1투","대통령선거","경상남도","합천군",1797,1256,253,739,125,77,49,0,0,0,0,0,0,2,1,1246,10,541
"10474","합천읍","합천읍제2투","대통령선거","경상남도","합천군",2579,1758,385,1105,152,48,43,2,0,1,0,1,4,3,1,1745,13,821
"10475","합천읍","합천읍제3투","대통령선거","경상남도","합천군",1855,1194,265,726,85,57,44,3,0,1,1,2,0,0,2,1186,8,661
"10476","봉산면","관내사전투표","대통령선거","경상남도","합천군",298,298,52,196,26,10,6,0,0,0,0,0,0,1,1,292,6,0
"10477","봉산면","봉산면투표소","대통령선거","경상남도","합천군",986,606,87,414,64,13,7,0,2,0,0,0,4,7,2,600,6,380
"10478","묘산면","관내사전투표","대통령선거","경상남도","합천군",394,394,85,254,27,13,7,0,0,1,0,0,1,0,2,390,4,0
"10479","묘산면","묘산면투표소","대통령선거","경상남도","합천군",1082,722,81,542,50,19,12,3,0,0,0,1,1,7,3,719,3,360
"10480","가야면","관내사전투표","대통령선거","경상남도","합천군",838,838,197,492,73,35,29,2,0,0,2,0,0,4,0,834,4,0
"10481","가야면","가야면제1투","대통령선거","경상남도","합천군",1253,828,142,556,70,28,26,0,0,0,0,0,0,2,0,824,4,425
"10482","가야면","가야면제2투","대통령선거","경상남도","합천군",1081,769,136,537,65,17,5,0,0,1,1,0,2,2,2,768,1,312
"10483","가야면","가야면제3투","대통령선거","경상남도","합천군",572,358,81,208,48,12,7,0,0,1,0,0,0,1,0,358,0,214
"10484","야로면","관내사전투표","대통령선거","경상남도","합천군",489,489,104,291,38,26,17,1,1,0,0,0,0,6,0,484,5,0
"10485","야로면","야로면투표소","대통령선거","경상남도","합천군",1683,1158,190,812,85,24,25,1,0,1,3,1,1,4,2,1149,9,525
"10486","율곡면","관내사전투표","대통령선거","경상남도","합천군",490,490,80,334,43,13,8,0,0,0,0,1,0,5,2,486,4,0
"10487","율곡면","율곡면제1투","대통령선거","경상남도","합천군",1153,745,135,488,68,24,10,1,1,0,0,0,3,7,3,740,5,408
"10488","율곡면","율곡면제2투","대통령선거","경상남도","합천군",397,287,33,200,34,8,5,0,1,0,0,0,1,3,0,285,2,110
"10489","초계면","관내사전투표","대통령선거","경상남도","합천군",618,618,126,392,53,19,12,1,1,1,0,0,1,4,1,611,7,0
"10490","초계면","초계면투표소","대통령선거","경상남도","합천군",1610,1030,187,673,107,30,21,0,0,2,0,0,1,2,1,1024,6,580
"10491","쌍책면","관내사전투표","대통령선거","경상남도","합천군",171,171,33,113,9,4,9,0,0,1,0,0,0,1,0,170,1,0
"10492","쌍책면","쌍책면제1투","대통령선거","경상남도","합천군",618,462,56,345,33,10,5,1,0,1,0,1,2,2,2,458,4,156
"10493","쌍책면","쌍책면제2투","대통령선거","경상남도","합천군",408,313,31,232,28,8,5,0,2,0,0,0,1,2,0,309,4,95
"10494","덕곡면","관내사전투표","대통령선거","경상남도","합천군",403,403,37,327,15,8,3,0,2,0,0,0,1,2,3,398,5,0
"10495","덕곡면","덕곡면투표소","대통령선거","경상남도","합천군",342,207,27,154,15,4,2,1,0,0,0,1,0,2,0,206,1,135
"10496","청덕면","관내사전투표","대통령선거","경상남도","합천군",196,196,54,109,18,3,11,0,0,0,0,0,0,0,0,195,1,0
"10497","청덕면","청덕면제1투","대통령선거","경상남도","합천군",833,558,90,362,67,13,4,0,1,0,1,1,5,4,2,550,8,275
"10498","청덕면","청덕면제2투","대통령선거","경상남도","합천군",460,322,42,231,34,8,1,0,0,0,0,0,1,1,0,318,4,138
"10499","적중면","관내사전투표","대통령선거","경상남도","합천군",329,329,75,201,23,15,5,0,0,0,1,0,0,5,0,325,4,0
"10500","적중면","적중면투표소","대통령선거","경상남도","합천군",995,652,100,439,64,15,13,0,0,1,0,0,2,5,5,644,8,343
"10501","대양면","관내사전투표","대통령선거","경상남도","합천군",305,305,66,182,23,10,15,0,0,0,0,1,0,2,1,300,5,0
"10502","대양면","대양면투표소","대통령선거","경상남도","합천군",1105,719,130,472,56,18,21,0,0,0,1,0,2,6,3,709,10,386
"10503","쌍백면","관내사전투표","대통령선거","경상남도","합천군",447,447,79,301,34,9,9,1,0,0,0,1,3,3,1,441,6,0
"10504","쌍백면","쌍백면투표소","대통령선거","경상남도","합천군",1183,737,114,508,51,14,12,1,1,1,0,1,1,10,4,718,19,446
"10505","삼가면","관내사전투표","대통령선거","경상남도","합천군",635,635,163,353,63,25,24,1,0,0,0,3,0,1,2,635,0,0
"10506","삼가면","삼가면제1투","대통령선거","경상남도","합천군",1161,736,152,471,62,20,17,1,0,0,0,1,1,6,0,731,5,425
"10507","삼가면","삼가면제2투","대통령선거","경상남도","합천군",1194,806,172,492,84,17,18,0,0,0,0,3,3,2,5,796,10,388
"10508","가회면","관내사전투표","대통령선거","경상남도","합천군",394,394,98,234,25,14,11,1,0,1,0,1,1,4,0,390,4,0
"10509","가회면","가회면투표소","대통령선거","경상남도","합천군",1148,726,134,449,64,26,25,1,1,2,1,0,1,8,5,717,9,422
"10510","대병면","관내사전투표","대통령선거","경상남도","합천군",469,469,101,288,39,8,20,0,1,0,0,1,2,2,2,464,5,0
"10511","대병면","대병면투표소","대통령선거","경상남도","합천군",1316,864,183,559,69,21,9,2,1,0,0,2,1,5,4,856,8,452
"10512","용주면","관내사전투표","대통령선거","경상남도","합천군",303,303,59,200,21,10,7,0,0,0,2,0,0,1,1,301,2,0
"10513","용주면","용주면투표소","대통령선거","경상남도","합천군",1628,1102,173,798,67,19,13,3,1,1,0,1,4,12,3,1095,7,526
"10514","잘못 투입·구분된 투표지","잘못 투입·구분된 투표지","대통령선거","경상남도","합천군",0,0,0,0,0,0,0,0,0,0,0,0,0,0,0,0,0,0
"10515","거소·선상투표","거소·선상투표","대통령선거","광주광역시","동구",201,182,92,5,71,3,6,0,0,0,2,0,1,0,2,182,0,19
"10516","관외사전투표","관외사전투표","대통령선거","광주광역시","동구",10495,10495,6442,173,2933,295,578,1,0,5,1,22,0,3,8,10461,34,0
"10517","재외투표","재외투표","대통령선거","광주광역시","동구",443,345,240,9,56,6,33,0,0,0,0,1,0,0,0,345,0,98
"10518","충장동","관내사전투표","대통령선거","광주광역시","동구",853,853,434,15,324,20,55,0,0,1,0,2,0,0,0,851,2,0
"10519","충장동","충장동제1투","대통령선거","광주광역시","동구",1712,945,475,30,393,21,24,0,0,1,0,0,0,0,0,944,1,767
"10520","충장동","충장동제2투","대통령선거","광주광역시","동구",1130,708,339,11,305,15,37,0,0,1,0,0,0,0,0,708,0,422
"10521","동명동","관내사전투표","대통령선거","광주광역시","동구",1303,1303,750,21,409,32,85,0,0,0,0,5,0,1,0,1303,0,0
"10522","동명동","동명동제1투","대통령선거","광주광역시","동구",1227,714,392,23,254,22,21,0,0,1,0,0,0,0,0,713,1,513
"10523","동명동","동명동제2투","대통령선거","광주광역시","동구",1390,954,514,17,388,10,21,0,0,0,0,1,0,0,0,951,3,436
"10524","계림1동","관내사전투표","대통령선거","광주광역시","동구",1264,1264,618,23,547,16,48,0,1,1,0,5,0,2,0,1261,3,0
"10525","계림1동","계림1동제1투","대통령선거","광주광역시","동구",1715,1008,541,24,400,11,25,0,0,1,0,1,0,0,1,1004,4,707
"10526","계림1동","계림1동제2투","대통령선거","광주광역시","동구",1745,1074,564,33,412,16,44,0,0,1,0,2,0,0,1,1073,1,671
"10527","계림1동","계림1동제3투","대통령선거","광주광역시","동구",643,339,154,7,159,7,9,0,0,0,1,1,0,0,0,338,1,304
"10528","계림2동","관내사전투표","대통령선거","광주광역시","동구",1568,1568,876,36,576,23,46,0,0,3,0,2,0,1,2,1565,3,0
"10529","계림2동","계림2동제1투","대통령선거","광주광역시","동구",1429,1031,590,15,349,21,47,0,0,2,1,1,1,0,2,1029,2,398
"10530","계림2동","계림2동제2투","대통령선거","광주광역시","동구",1505,944,497,18,388,13,24,0,0,0,0,1,0,0,1,942,2,561
"10531","계림2동","계림2동제3투","대통령선거","광주광역시","동구",2206,1736,918,37,697,32,44,0,0,0,0,3,0,0,1,1732,4,470
"10532","산수1동","관내사전투표","대통령선거","광주광역시","동구",1139,1139,675,11,395,20,30,0,0,0,0,1,0,1,1,1134,5,0
"10533","산수1동","산수1동제1투","대통령선거","광주광역시","동구",1653,1091,577,9,431,16,51,0,0,1,0,2,0,0,2,1089,2,562
"10534","산수1동","산수1동제2투","대통령선거","광주광역시","동구",1694,1096,626,19,400,15,29,0,0,1,0,0,0,1,1,1092,4,598
"10535","산수1동","산수1동제3투","대통령선거","광주광역시","동구",575,349,196,3,134,3,13,0,0,0,0,0,0,0,0,349,0,226
"10536","산수2동","관내사전투표","대통령선거","광주광역시","동구",1548,1548,839,25,586,29,56,0,0,1,0,4,0,0,1,1541,7,0
"10537","산수2동","산수2동제1투","대통령선거","광주광역시","동구",1799,1209,644,32,472,14,44,0,0,0,0,1,0,0,0,1207,2,590
"10538","산수2동","산수2동제2투","대통령선거","광주광역시","동구",1023,742,392,24,281,15,27,0,0,0,0,0,0,0,2,741,1,281
"10539","산수2동","산수2동제3투","대통령선거","광주광역시","동구",1690,1252,726,17,433,23,49,0,0,0,0,4,0,0,0,1252,0,438
"10540","산수2동","산수2동제4투","대통령선거","광주광역시","동구",1536,1251,652,38,501,27,28,0,1,0,0,4,0,0,0,1251,0,285
"10541","지산1동","관내사전투표","대통령선거","광주광역시","동구",1052,1052,592,15,373,19,41,1,1,1,0,3,1,0,1,1048,4,0
"10542","지산1동","지산1동제1투","대통령선거","광주광역시","동구",1661,1150,657,24,397,27,36,0,0,1,0,4,0,0,0,1146,4,511
"10543","지산1동","지산1동제2투","대통령선거","광주광역시","동구",818,471,256,3,163,19,22,1,0,1,0,1,0,1,1,468,3,347
"10544","지산2동","관내사전투표","대통령선거","광주광역시","동구",1165,1165,655,26,398,22,59,0,0,0,0,1,0,0,0,1161,4,0
"10545","지산2동","지산2동제1투","대통령선거","광주광역시","동구",2030,1366,737,39,499,32,54,0,0,2,0,1,0,0,1,1365,1,664
"10546","지산2동","지산2동제2투","대통령선거","광주광역시","동구",958,671,349,11,269,11,24,0,0,1,0,4,1,0,1,671,0,287
"10547","서남동","관내사전투표","대통령선거","광주광역시","동구",992,992,585,13,326,19,39,0,0,1,0,3,0,3,1,990,2,0
"10548","서남동","서남동제1투","대통령선거","광주광역시","동구",1068,596,320,19,211,13,32,0,0,0,0,0,0,0,0,595,1,472
"10549","서남동","서남동제2투","대통령선거","광주광역시","동구",975,500,259,12,186,13,23,0,0,2,0,2,0,0,0,497,3,475
"10550","학동","관내사전투표","대통령선거","광주광역시","동구",1769,1769,989,30,603,42,90,3,0,1,1,2,0,1,1,1763,6,0
"10551","학동","학동제1투","대통령선거","광주광역시","동구",1141,699,403,15,248,6,23,0,0,0,0,0,1,0,0,696,3,442
"10552","학동","학동제2투","대통령선거","광주광역시","동구",1829,1348,758,26,485,20,51,1,0,0,0,2,0,0,0,1343,5,481
"10553","학동","학동제3투","대통령선거","광주광역시","동구",1859,1449,792,29,534,34,51,0,0,1,0,0,0,1,2,1444,5,410
"10554","학운동","관내사전투표","대통령선거","광주광역시","동구",2853,2853,1568,62,1011,77,115,0,0,3,1,4,1,2,1,2845,8,0
"10555","학운동","학운동제1투","대통령선거","광주광역시","동구",1719,1106,572,32,439,21,34,1,0,1,0,1,0,0,0,1101,5,613
"10556","학운동","학운동제2투","대통령선거","광주광역시","동구",2049,1588,835,35,614,39,58,0,0,3,0,2,0,0,0,1586,2,461
"10557","학운동","학운동제3투","대통령선거","광주광역시","동구",1383,1058,526,27,458,17,26,0,0,1,0,0,0,0,0,1055,3,325
"10558","학운동","학운동제4투","대통령선거","광주광역시","동구",1816,1385,699,43,570,25,43,0,0,1,0,1,0,0,0,1382,3,431
"10559","지원1동","관내사전투표","대통령선거","광주광역시","동구",1713,1712,983,18,584,38,74,1,0,0,1,4,1,0,0,1704,8,1
"10560","지원1동","지원1동제1투","대통령선거","광주광역시","동구",1492,1033,567,19,396,14,33,0,0,0,0,0,1,0,1,1031,2,459
"10561","지원1동","지원1동제2투","대통령선거","광주광역시","동구",1730,1252,690,29,458,21,43,1,0,1,0,2,0,0,2,1247,5,478
"10562","지원1동","지원1동제3투","대통령선거","광주광역시","동구",776,540,299,15,182,10,28,0,0,0,0,1,1,0,1,537,3,236
"10563","지원2동","관내사전투표","대통령선거","광주광역시","동구",1534,1534,889,26,508,26,52,1,0,2,1,4,4,1,6,1520,14,0
"10564","지원2동","지원2동제1투","대통령선거","광주광역시","동구",2348,1852,1154,30,536,43,77,2,0,0,1,2,0,0,1,1846,6,496
"10565","지원2동","지원2동제2투","대통령선거","광주광역시","동구",1850,1115,619,17,411,19,36,0,2,2,0,6,0,1,1,1114,1,735
"10566","지원2동","지원2동제3투","대통령선거","광주광역시","동구",1312,891,537,18,285,20,27,0,0,0,0,2,0,0,1,890,1,421
"10567","잘못 투입·구분된 투표지","잘못 투입·구분된 투표지","대통령선거","광주광역시","동구",0,0,0,0,0,0,0,0,0,0,0,0,0,0,0,0,0,0
"10568","거소·선상투표","거소·선상투표","대통령선거","광주광역시","서구",624,574,303,11,189,28,15,1,1,1,1,1,0,0,5,556,18,50
"10569","관외사전투표","관외사전투표","대통령선거","광주광역시","서구",27780,27776,17523,479,6906,957,1685,3,4,26,8,56,4,8,26,27685,91,4
"10570","재외투표","재외투표","대통령선거","광주광역시","서구",1045,844,623,6,109,14,86,0,0,1,0,0,0,0,1,840,4,201
"10571","양동","관내사전투표","대통령선거","광주광역시","서구",946,946,475,16,418,12,21,0,0,1,0,0,0,1,0,944,2,0
"10572","양동","양동제1투","대통령선거","광주광역시","서구",1611,1169,604,24,497,15,24,0,0,0,1,1,0,0,0,1166,3,442
"10573","양동","양동제2투","대통령선거","광주광역시","서구",1443,890,463,10,385,6,20,0,0,1,0,4,0,0,0,889,1,553
"10574","양3동","관내사전투표","대통령선거","광주광역시","서구",949,949,596,9,279,24,33,0,0,1,0,5,0,0,1,948,1,0
"10575","양3동","양3동제1투","대통령선거","광주광역시","서구",2039,1479,853,20,511,24,61,0,0,0,0,5,0,1,0,1475,4,560
"10576","양3동","양3동제2투","대통령선거","광주광역시","서구",826,608,354,9,209,10,18,1,0,1,0,2,0,0,1,605,3,218
"10577","농성1동","관내사전투표","대통령선거","광주광역시","서구",1607,1607,882,29,584,26,72,1,1,1,0,4,0,1,0,1601,6,0
"10578","농성1동","농성1동제1투","대통령선거","광주광역시","서구",1440,927,514,13,359,10,29,0,0,0,0,1,0,0,0,926,1,513
"10579","농성1동","농성1동제2투","대통령선거","광주광역시","서구",1644,1032,551,19,400,15,39,0,1,1,0,2,0,2,1,1031,1,612
"10580","농성1동","농성1동제3투","대통령선거","광주광역시","서구",1653,1110,646,19,388,18,36,0,0,0,0,2,0,0,0,1109,1,543
"10581","농성2동","관내사전투표","대통령선거","광주광역시","서구",1281,1281,727,24,450,20,49,0,0,3,0,4,0,0,1,1278,3,0
"10582","농성2동","농성2동제1투","대통령선거","광주광역시","서구",1576,966,511,15,364,24,42,0,0,0,0,3,0,0,1,960,6,610
"10583","농성2동","농성2동제2투","대통령선거","광주광역시","서구",1736,1198,654,22,438,23,60,0,0,0,0,0,0,0,0,1197,1,538
"10584","광천동","관내사전투표","대통령선거","광주광역시","서구",2018,2017,1180,24,679,41,79,0,0,3,1,6,0,2,0,2015,2,1
"10585","광천동","광천동제1투","대통령선거","광주광역시","서구",1506,855,485,25,286,19,31,0,0,0,0,1,2,0,2,851,4,651
"10586","광천동","광천동제2투","대통령선거","광주광역시","서구",2742,1945,1096,52,664,52,70,1,0,1,0,0,0,0,1,1937,8,797
"10587","광천동","광천동제3투","대통령선거","광주광역시","서구",1103,733,403,12,279,20,13,0,0,2,0,0,0,0,1,730,3,370
"10588","유덕동","관내사전투표","대통령선거","광주광역시","서구",2237,2237,1480,30,552,48,109,0,0,3,1,3,0,4,1,2231,6,0
"10589","유덕동","유덕동제1투","대통령선거","광주광역시","서구",773,508,291,10,173,8,16,0,0,0,0,0,0,0,4,502,6,265
"10590","유덕동","유덕동제2투","대통령선거","광주광역시","서구",2351,1785,1175,28,432,43,92,0,0,0,0,9,0,0,1,1780,5,566
"10591","유덕동","유덕동제3투","대통령선거","광주광역시","서구",2375,1858,1182,19,530,33,83,0,0,1,1,5,0,0,0,1854,4,517
"10592","치평동","관내사전투표","대통령선거","광주광역시","서구",6844,6844,4422,71,1813,180,318,0,1,6,1,13,1,1,1,6828,16,0
"10593","치평동","치평동제1투","대통령선거","광주광역시","서구",2914,2157,1311,38,671,45,75,1,2,2,0,5,0,1,1,2152,5,757
"10594","치평동","치평동제2투","대통령선거","광주광역시","서구",2396,1822,1121,30,559,34,71,1,0,2,0,2,0,1,0,1821,1,574
"10595","치평동","치평동제3투","대통령선거","광주광역시","서구",2383,1838,1080,41,588,44,79,0,0,1,0,1,0,0,0,1834,4,545
"10596","치평동","치평동제4투","대통령선거","광주광역시","서구",2668,2102,1235,40,685,56,77,1,0,2,1,3,0,1,0,2101,1,566
"10597","치평동","치평동제5투","대통령선거","광주광역시","서구",2062,1692,1076,33,478,24,70,0,0,1,0,3,0,1,1,1687,5,370
"10598","치평동","치평동제6투","대통령선거","광주광역시","서구",3497,2436,1566,35,625,73,122,1,0,2,0,6,0,0,0,2430,6,1061
"10599","상무1동","관내사전투표","대통령선거","광주광역시","서구",3786,3786,2312,59,1143,74,179,0,0,2,1,11,1,0,2,3784,2,0
"10600","상무1동","상무1동제1투","대통령선거","광주광역시","서구",2025,1248,725,25,410,24,56,0,0,0,1,3,0,0,2,1246,2,777
"10601","상무1동","상무1동제2투","대통령선거","광주광역시","서구",2618,1953,1192,34,596,34,89,0,0,0,1,4,0,0,0,1950,3,665
"10602","상무1동","상무1동제3투","대통령선거","광주광역시","서구",2808,2029,1156,35,683,62,84,1,0,3,0,2,0,0,1,2027,2,779
"10603","상무1동","상무1동제4투","대통령선거","광주광역시","서구",2407,1239,750,20,369,35,56,0,0,1,0,1,0,0,1,1233,6,1168
"10604","상무1동","상무1동제5투","대통령선거","광주광역시","서구",3291,2612,1628,35,749,49,138,0,0,1,2,5,0,0,1,2608,4,679
"10605","상무2동","관내사전투표","대통령선거","광주광역시","서구",4166,4166,2334,58,1484,100,166,0,1,2,0,7,1,3,6,4162,4,0
"10606","상무2동","상무2동제1투","대통령선거","광주광역시","서구",2664,1908,1048,32,699,33,74,0,2,2,0,9,1,1,0,1901,7,756
"10607","상무2동","상무2동제2투","대통령선거","광주광역시","서구",2352,1557,879,28,578,18,45,0,0,2,0,0,2,0,1,1553,4,795
"10608","상무2동","상무2동제3투","대통령선거","광주광역시","서구",3102,2301,1395,57,710,39,89,0,0,2,1,3,0,0,2,2298,3,801
"10609","상무2동","상무2동제4투","대통령선거","광주광역시","서구",2940,1844,1033,42,637,28,87,0,0,2,0,6,1,0,0,1836,8,1096
"10610","상무2동","상무2동제5투","대통령선거","광주광역시","서구",3609,2336,1293,43,829,60,100,0,0,0,0,4,1,1,0,2331,5,1273
"10611","화정1동","관내사전투표","대통령선거","광주광역시","서구",2595,2595,1575,42,776,53,133,0,1,1,1,6,0,0,2,2590,5,0
"10612","화정1동","화정1동제1투","대통령선거","광주광역시","서구",3070,2417,1492,29,707,56,113,0,0,3,0,9,0,1,1,2411,6,653
"10613","화정1동","화정1동제2투","대통령선거","광주광역시","서구",2966,2013,1117,44,695,58,89,0,0,3,0,3,0,0,2,2011,2,953
"10614","화정1동","화정1동제3투","대통령선거","광주광역시","서구",2971,1895,1034,24,699,33,89,1,0,2,0,9,0,0,1,1892,3,1076
"10615","화정2동","관내사전투표","대통령선거","광주광역시","서구",4341,4341,2688,52,1294,96,196,0,0,0,0,10,0,0,3,4339,2,0
"10616","화정2동","화정2동제1투","대통령선거","광주광역시","서구",2869,2002,1183,39,637,50,83,0,0,0,0,3,1,1,2,1999,3,867
"10617","화정2동","화정2동제2투","대통령선거","광주광역시","서구",1491,1188,727,22,349,28,54,0,0,1,0,4,0,0,1,1186,2,303
"10618","화정2동","화정2동제3투","대통령선거","광주광역시","서구",2984,2364,1387,42,783,37,102,0,0,1,0,5,0,0,0,2357,7,620
"10619","화정2동","화정2동제4투","대통령선거","광주광역시","서구",2939,2362,1433,36,738,45,100,0,0,4,0,3,0,0,1,2360,2,577
"10620","화정3동","관내사전투표","대통령선거","광주광역시","서구",1558,1558,925,24,501,39,61,0,0,0,0,2,0,0,1,1553,5,0
"10621","화정3동","화정3동제1투","대통령선거","광주광역시","서구",1564,1171,635,22,439,14,51,0,0,2,0,4,0,0,1,1168,3,393
"10622","화정3동","화정3동제2투","대통령선거","광주광역시","서구",1892,1305,718,24,488,18,48,0,0,0,0,4,0,0,1,1301,4,587
"10623","화정3동","화정3동제3투","대통령선거","광주광역시","서구",2938,2272,1271,45,825,42,79,0,0,0,0,2,0,0,2,2266,6,666
"10624","화정4동","관내사전투표","대통령선거","광주광역시","서구",3878,3877,2259,67,1276,100,150,0,0,2,1,10,0,3,1,3869,8,1
"10625","화정4동","화정4동제1투","대통령선거","광주광역시","서구",2659,1817,1009,36,660,35,70,0,1,1,0,2,0,0,2,1816,1,842
"10626","화정4동","화정4동제2투","대통령선거","광주광역시","서구",1803,1483,837,30,538,27,44,0,0,0,0,5,0,0,1,1482,1,320
"10627","화정4동","화정4동제3투","대통령선거","광주광역시","서구",1498,1166,687,24,375,14,61,0,0,0,0,3,0,0,0,1164,2,332
"10628","화정4동","화정4동제4투","대통령선거","광주광역시","서구",1899,1532,918,29,479,29,71,0,0,1,0,2,0,1,0,1530,2,367
"10629","화정4동","화정4동제5투","대통령선거","광주광역시","서구",1804,1269,750,21,425,15,49,2,0,1,0,5,0,0,0,1268,1,535
"10630","서창동","관내사전투표","대통령선거","광주광역시","서구",546,546,308,8,184,12,21,0,0,1,0,6,0,0,1,541,5,0
"10631","서창동","서창동제1투","대통령선거","광주광역시","서구",1243,746,430,12,258,11,23,1,2,0,0,7,1,0,0,745,1,497
"10632","서창동","서창동제2투","대통령선거","광주광역시","서구",560,408,219,4,164,7,13,0,0,0,0,0,0,0,0,407,1,152
"10633","서창동","서창동제3투","대통령선거","광주광역시","서구",1533,1226,686,28,441,28,41,0,0,0,0,0,0,0,0,1224,2,307
"10634","금호1동","관내사전투표","대통령선거","광주광역시","서구",3711,3711,2218,43,1213,66,146,2,0,3,2,8,0,2,1,3704,7,0
"10635","금호1동","금호1동제1투","대통령선거","광주광역시","서구",2464,1876,1101,37,630,25,79,0,0,0,0,0,1,1,0,1874,2,588
"10636","금호1동","금호1동제2투","대통령선거","광주광역시","서구",2806,2117,1215,36,715,46,94,0,0,2,0,3,1,0,2,2114,3,689
"10637","금호1동","금호1동제3투","대통령선거","광주광역시","서구",2101,1309,741,19,471,15,55,0,0,0,1,2,0,0,0,1304,5,792
"10638","금호1동","금호1동제4투","대통령선거","광주광역시","서구",2866,2299,1469,18,654,46,100,0,0,2,0,7,0,0,2,2298,1,567
"10639","금호1동","금호1동제5투","대통령선거","광주광역시","서구",1722,1277,778,19,388,35,53,0,0,0,0,2,0,0,0,1275,2,445
"10640","금호2동","관내사전투표","대통령선거","광주광역시","서구",7061,7061,4602,70,1794,171,360,0,0,44,0,14,0,0,2,7057,4,0
"10641","금호2동","금호2동제1투","대통령선거","광주광역시","서구",3178,2327,1464,29,655,57,100,0,0,13,0,4,0,1,1,2324,3,851
"10642","금호2동","금호2동제2투","대통령선거","광주광역시","서구",2941,2327,1499,31,630,34,114,0,0,6,1,7,0,0,1,2323,4,614
"10643","금호2동","금호2동제3투","대통령선거","광주광역시","서구",2968,2525,1623,21,713,50,98,0,0,2,1,12,0,1,1,2522,3,443
"10644","금호2동","금호2동제4투","대통령선거","광주광역시","서구",2744,2195,1401,27,619,38,95,0,0,2,0,4,0,0,2,2188,7,549
"10645","금호2동","금호2동제5투","대통령선거","광주광역시","서구",1812,1484,881,25,459,38,67,0,0,2,0,9,0,0,1,1482,2,328
"10646","풍암동","관내사전투표","대통령선거","광주광역시","서구",7267,7266,4522,81,2108,166,346,1,0,10,0,14,0,2,4,7254,12,1
"10647","풍암동","풍암동제1투","대통령선거","광주광역시","서구",2375,1872,1114,34,608,38,73,0,0,0,0,2,0,0,1,1870,2,503
"10648","풍암동","풍암동제2투","대통령선거","광주광역시","서구",1693,1306,872,8,339,21,58,0,0,2,1,4,0,0,0,1305,1,387
"10649","풍암동","풍암동제3투","대통령선거","광주광역시","서구",2189,1789,1133,27,500,33,89,0,0,3,0,2,1,0,0,1788,1,400
"10650","풍암동","풍암동제4투","대통령선거","광주광역시","서구",2340,1926,1149,36,603,60,74,0,0,1,1,1,0,0,0,1925,1,414
"10651","풍암동","풍암동제5투","대통령선거","광주광역시","서구",2044,1625,1048,22,442,25,84,0,0,0,0,3,0,0,0,1624,1,419
"10652","풍암동","풍암동제6투","대통령선거","광주광역시","서구",2893,2017,1271,41,570,39,88,0,0,0,0,3,0,0,2,2014,3,876
"10653","풍암동","풍암동제7투","대통령선거","광주광역시","서구",3393,2186,1351,16,672,40,89,0,0,2,0,6,0,2,2,2180,6,1207
"10654","풍암동","풍암동제8투","대통령선거","광주광역시","서구",1944,1683,893,30,655,44,56,0,0,0,0,1,0,0,0,1679,4,261
"10655","동천동","관내사전투표","대통령선거","광주광역시","서구",3204,3204,2105,47,814,75,144,0,0,1,0,12,1,1,1,3201,3,0
"10656","동천동","동천동제1투","대통령선거","광주광역시","서구",1904,1469,898,21,455,23,60,0,0,0,1,7,0,0,1,1466,3,435
"10657","동천동","동천동제2투","대통령선거","광주광역시","서구",2096,1750,1200,17,418,25,76,0,0,0,1,8,0,0,1,1746,4,346
"10658","동천동","동천동제3투","대통령선거","광주광역시","서구",2297,1962,1268,26,531,39,89,1,0,0,0,7,0,0,0,1961,1,335
"10659","동천동","동천동제4투","대통령선거","광주광역시","서구",2144,1504,950,16,444,29,60,0,0,0,0,2,0,0,2,1503,1,640
"10660","잘못 투입·구분된 투표지","잘못 투입·구분된 투표지","대통령선거","광주광역시","서구",0,3,2,0,0,0,1,0,0,0,0,0,0,0,0,3,0,-3
"10661","거소·선상투표","거소·선상투표","대통령선거","광주광역시","남구",439,407,212,12,151,8,6,0,2,2,0,2,1,3,0,399,8,32
"10662","관외사전투표","관외사전투표","대통령선거","광주광역시","남구",22072,22072,13823,341,5742,739,1244,5,1,17,2,45,2,4,22,21987,85,0
"10663","재외투표","재외투표","대통령선거","광주광역시","남구",875,710,521,15,89,14,68,0,0,0,0,1,0,1,0,709,1,165
"10664","양림동","관내사전투표","대통령선거","광주광역시","남구",2136,2136,1297,26,659,40,96,0,1,2,0,7,0,1,0,2129,7,0
"10665","양림동","양림동제1투","대통령선거","광주광역시","남구",1451,911,490,15,345,9,46,0,0,0,0,2,0,0,0,907,4,540
"10666","양림동","양림동제2투","대통령선거","광주광역시","남구",2619,1989,1146,32,681,39,76,0,1,0,2,5,1,1,0,1984,5,630
"10667","방림1동","관내사전투표","대통령선거","광주광역시","남구",1897,1897,1134,35,603,46,65,0,0,4,0,5,0,0,0,1892,5,0
"10668","방림1동","방림1동제1투","대통령선거","광주광역시","남구",2180,1573,892,27,556,22,64,1,0,1,0,3,0,1,0,1567,6,607
"10669","방림1동","방림1동제2투","대통령선거","광주광역시","남구",1781,1243,701,21,456,21,31,0,0,2,0,2,0,0,1,1235,8,538
"10670","방림2동","관내사전투표","대통령선거","광주광역시","남구",1417,1416,817,23,482,25,51,0,0,2,0,8,0,0,2,1410,6,1
"10671","방림2동","방림2동제1투","대통령선거","광주광역시","남구",1873,1176,645,22,431,22,42,3,0,3,0,3,0,1,0,1172,4,697
"10672","방림2동","방림2동제2투","대통령선거","광주광역시","남구",2515,1958,1156,43,639,39,72,1,0,2,0,5,0,0,0,1957,1,557
"10673","방림2동","방림2동제3투","대통령선거","광주광역시","남구",1506,1252,695,18,464,21,49,0,0,2,0,2,0,0,0,1251,1,254
"10674","봉선1동","관내사전투표","대통령선거","광주광역시","남구",3874,3874,2247,68,1306,69,156,0,0,7,0,9,0,2,0,3864,10,0
"10675","봉선1동","봉선1동제1투","대통령선거","광주광역시","남구",1948,1367,776,31,468,29,50,1,0,1,0,3,0,1,2,1362,5,581
"10676","봉선1동","봉선1동제2투","대통령선거","광주광역시","남구",1811,1290,721,33,462,19,51,1,0,0,0,2,0,0,1,1290,0,521
"10677","봉선1동","봉선1동제3투","대통령선거","광주광역시","남구",2449,1755,1009,34,611,28,56,0,1,2,0,7,0,1,1,1750,5,694
"10678","봉선1동","봉선1동제4투","대통령선거","광주광역시","남구",2462,1630,1011,24,514,24,47,1,0,3,1,1,0,0,2,1628,2,832
"10679","봉선2동","관내사전투표","대통령선거","광주광역시","남구",5564,5564,3326,107,1665,150,238,3,3,8,1,11,2,5,5,5524,40,0
"10680","봉선2동","봉선2동제1투","대통령선거","광주광역시","남구",2936,2305,1264,67,829,62,78,0,0,0,0,1,0,0,0,2301,4,631
"10681","봉선2동","봉선2동제2투","대통령선거","광주광역시","남구",2150,1527,846,49,500,38,59,5,1,1,0,1,1,2,2,1505,22,623
"10682","봉선2동","봉선2동제3투","대통령선거","광주광역시","남구",2563,2039,1127,31,733,37,98,1,0,3,0,5,0,0,1,2036,3,524
"10683","봉선2동","봉선2동제4투","대통령선거","광주광역시","남구",3134,2558,1502,78,804,47,111,3,0,6,0,2,1,0,1,2555,3,576
"10684","봉선2동","봉선2동제5투","대통령선거","광주광역시","남구",2801,2335,1215,71,896,82,68,0,0,0,0,2,0,0,0,2334,1,466
"10685","사직동","관내사전투표","대통령선거","광주광역시","남구",860,860,485,15,302,12,38,0,0,1,0,1,2,0,1,857,3,0
"10686","사직동","사직동제1투","대통령선거","광주광역시","남구",1513,847,409,23,369,9,30,0,0,1,1,1,0,0,2,845,2,666
"10687","사직동","사직동제2투","대통령선거","광주광역시","남구",1977,1247,661,32,487,19,38,0,0,1,0,3,0,1,0,1242,5,730
"10688","월산동","관내사전투표","대통령선거","광주광역시","남구",1496,1496,763,22,604,35,61,0,0,3,0,0,0,0,2,1490,6,0
"10689","월산동","월산동제1투","대통령선거","광주광역시","남구",1056,666,362,6,267,5,21,0,0,1,0,1,0,1,0,664,2,390
"10690","월산동","월산동제2투","대통령선거","광주광역시","남구",1473,970,476,22,416,12,38,0,0,0,0,1,1,0,1,967,3,503
"10691","월산동","월산동제3투","대통령선거","광주광역시","남구",1595,937,510,16,372,12,21,0,0,1,0,1,2,0,1,936,1,658
"10692","월산동","월산동제4투","대통령선거","광주광역시","남구",2107,1495,818,24,584,22,40,0,0,1,0,2,0,1,0,1492,3,612
"10693","월산4동","관내사전투표","대통령선거","광주광역시","남구",1468,1468,786,32,569,27,46,0,0,3,0,1,0,0,2,1466,2,0
"10694","월산4동","월산4동제1투","대통령선거","광주광역시","남구",2177,1343,734,26,473,36,56,0,0,0,0,7,0,2,2,1336,7,834
"10695","월산4동","월산4동제2투","대통령선거","광주광역시","남구",1788,1237,683,29,478,15,25,0,1,0,0,1,0,0,2,1234,3,551
"10696","월산4동","월산4동제3투","대통령선거","광주광역시","남구",1910,1304,659,28,533,21,51,0,0,0,0,2,0,2,0,1296,8,606
"10697","월산5동","관내사전투표","대통령선거","광주광역시","남구",1665,1665,929,38,588,31,61,0,0,4,0,5,0,2,1,1659,6,0
"10698","월산5동","월산5동제1투","대통령선거","광주광역시","남구",2329,1518,811,17,609,20,51,0,0,2,0,1,0,1,2,1514,4,811
"10699","월산5동","월산5동제2투","대통령선거","광주광역시","남구",1972,1345,736,24,500,26,48,0,1,0,0,4,0,0,1,1340,5,627
"10700","백운1동","관내사전투표","대통령선거","광주광역시","남구",2322,2322,1410,35,737,33,94,0,0,2,0,4,0,1,4,2320,2,0
"10701","백운1동","백운1동제1투","대통령선거","광주광역시","남구",2514,1803,965,32,688,48,62,1,0,0,0,2,0,0,2,1800,3,711
"10702","백운1동","백운1동제2투","대통령선거","광주광역시","남구",2388,1880,1166,35,583,29,54,0,0,2,0,6,0,0,0,1875,5,508
"10703","백운1동","백운1동제3투","대통령선거","광주광역시","남구",2425,1899,1091,35,653,28,82,0,0,2,0,4,0,0,0,1895,4,526
"10704","백운2동","관내사전투표","대통령선거","광주광역시","남구",1189,1189,695,13,408,26,38,0,0,0,0,3,0,0,1,1184,5,0
"10705","백운2동","백운2동제1투","대통령선거","광주광역시","남구",2445,1577,840,31,596,30,65,2,0,1,1,2,0,0,2,1570,7,868
"10706","백운2동","백운2동제2투","대통령선거","광주광역시","남구",1202,888,487,15,346,12,23,0,0,0,0,1,0,0,0,884,4,314
"10707","주월1동","관내사전투표","대통령선거","광주광역시","남구",4113,4113,2487,50,1325,82,157,1,1,1,0,3,1,0,0,4108,5,0
"10708","주월1동","주월1동제1투","대통령선거","광주광역시","남구",2644,1908,1037,29,714,37,77,0,1,1,1,3,0,0,3,1903,5,736
"10709","주월1동","주월1동제2투","대통령선거","광주광역시","남구",2519,1786,1022,28,625,28,69,0,1,0,1,3,1,0,0,1778,8,733
"10710","주월1동","주월1동제3투","대통령선거","광주광역시","남구",2458,1700,1001,27,569,24,67,1,0,2,0,1,0,1,2,1695,5,758
"10711","주월1동","주월1동제4투","대통령선거","광주광역시","남구",2434,1847,1160,36,540,26,72,0,0,2,1,6,0,1,0,1844,3,587
"10712","주월2동","관내사전투표","대통령선거","광주광역시","남구",1755,1755,1001,28,626,26,63,0,0,2,0,2,0,1,0,1749,6,0
"10713","주월2동","주월2동제1투","대통령선거","광주광역시","남구",1516,978,505,16,384,13,48,0,0,5,0,3,0,0,1,975,3,538
"10714","주월2동","주월2동제2투","대통령선거","광주광역시","남구",1871,1351,806,24,435,24,51,0,0,2,0,2,1,0,0,1345,6,520
"10715","주월2동","주월2동제3투","대통령선거","광주광역시","남구",2075,1488,824,25,543,24,61,0,1,1,0,2,0,1,3,1485,3,587
"10716","효덕동","관내사전투표","대통령선거","광주광역시","남구",7005,7005,4373,75,2045,149,321,0,0,4,1,20,0,5,1,6994,11,0
"10717","효덕동","효덕동제1투","대통령선거","광주광역시","남구",2698,2033,1261,23,612,38,87,0,0,3,0,3,0,2,0,2029,4,665
"10718","효덕동","효덕동제2투","대통령선거","광주광역시","남구",2774,2165,1320,27,668,36,97,2,0,5,0,4,0,0,1,2160,5,609
"10719","효덕동","효덕동제3투","대통령선거","광주광역시","남구",2663,2163,1191,38,787,45,95,0,0,2,0,2,0,0,0,2160,3,500
"10720","효덕동","효덕동제4투","대통령선거","광주광역시","남구",2531,2033,1207,43,658,51,65,1,0,0,0,3,1,1,1,2031,2,498
"10721","효덕동","효덕동제5투","대통령선거","광주광역시","남구",2823,2206,1355,30,676,43,90,0,0,2,0,4,0,0,0,2200,6,617
"10722","효덕동","효덕동제6투","대통령선거","광주광역시","남구",2054,1589,966,33,481,33,65,0,0,3,0,5,0,0,0,1586,3,465
"10723","효덕동","효덕동제7투","대통령선거","광주광역시","남구",2823,2142,1322,32,643,41,91,0,0,2,0,5,0,0,0,2136,6,681
"10724","효덕동","효덕동제8투","대통령선거","광주광역시","남구",2674,2143,1310,32,701,34,59,0,0,0,0,2,0,1,0,2139,4,531
"10725","효덕동","효덕동제9투","대통령선거","광주광역시","남구",2785,2152,1330,22,637,51,96,2,0,1,0,9,0,0,1,2149,3,633
"10726","송암동","관내사전투표","대통령선거","광주광역시","남구",1343,1343,909,17,326,32,46,0,0,1,0,8,0,0,1,1340,3,0
"10727","송암동","송암동제1투","대통령선거","광주광역시","남구",1003,633,401,8,189,6,23,0,1,0,0,1,0,0,1,630,3,370
"10728","송암동","송암동제2투","대통령선거","광주광역시","남구",1919,1567,906,29,518,30,71,1,0,2,0,3,1,0,0,1561,6,352
"10729","송암동","송암동제3투","대통령선거","광주광역시","남구",1820,1471,921,18,414,31,84,0,0,1,0,1,0,0,0,1470,1,349
"10730","대촌동","관내사전투표","대통령선거","광주광역시","남구",949,949,530,14,346,20,22,0,0,3,0,6,1,1,2,945,4,0
"10731","대촌동","대촌동제1투","대통령선거","광주광역시","남구",1700,1194,659,21,448,16,34,2,0,2,0,5,0,4,2,1193,1,506
"10732","대촌동","대촌동제2투","대통령선거","광주광역시","남구",671,433,228,8,174,4,13,0,1,1,0,2,0,0,1,432,1,238
"10733","대촌동","대촌동제3투","대통령선거","광주광역시","남구",1303,950,561,15,331,3,24,0,1,1,0,1,2,4,3,946,4,353
"10734","잘못 투입·구분된 투표지","잘못 투입·구분된 투표지","대통령선거","광주광역시","남구",0,0,0,0,0,0,0,0,0,0,0,0,0,0,0,0,0,0
"10735","거소·선상투표","거소·선상투표","대통령선거","광주광역시","북구",826,774,417,25,262,19,24,1,1,0,0,3,0,1,6,759,15,52
"10736","관외사전투표","관외사전투표","대통령선거","광주광역시","북구",38387,38382,24468,596,9427,1253,2293,5,7,20,6,77,4,8,37,38201,181,5
"10737","재외투표","재외투표","대통령선거","광주광역시","북구",1497,1205,895,12,144,28,116,0,0,0,0,1,0,3,0,1199,6,292
"10738","중흥1동","관내사전투표","대통령선거","광주광역시","북구",830,830,478,15,277,20,34,0,0,3,0,1,0,0,0,828,2,0
"10739","중흥1동","중흥1동투표소","대통령선거","광주광역시","북구",2364,1455,789,22,566,25,43,0,0,0,0,2,1,1,0,1449,6,909
"10740","중흥2동","관내사전투표","대통령선거","광주광역시","북구",1825,1825,989,27,667,48,78,0,0,0,0,6,0,2,2,1819,6,0
"10741","중흥2동","중흥2동제1투","대통령선거","광주광역시","북구",1548,1164,609,26,462,21,38,1,0,0,0,4,0,0,1,1162,2,384
"10742","중흥2동","중흥2동제2투","대통령선거","광주광역시","북구",1617,1023,566,17,365,22,41,0,0,0,1,6,1,0,1,1020,3,594
"10743","중흥2동","중흥2동제3투","대통령선거","광주광역시","북구",1671,1087,549,14,456,19,39,1,1,1,0,4,0,0,1,1085,2,584
"10744","중흥3동","관내사전투표","대통령선거","광주광역시","북구",1293,1293,702,16,498,20,50,0,0,0,0,2,1,1,1,1291,2,0
"10745","중흥3동","중흥3동제1투","대통령선거","광주광역시","북구",1847,1214,733,20,393,21,37,0,0,1,0,5,1,0,0,1211,3,633
"10746","중흥3동","중흥3동제2투","대통령선거","광주광역시","북구",1590,1031,567,21,380,16,40,0,0,0,0,2,0,0,0,1026,5,559
"10747","중앙동","관내사전투표","대통령선거","광주광역시","북구",901,901,479,22,337,20,34,0,0,4,0,2,0,0,0,898,3,0
"10748","중앙동","중앙동투표소","대통령선거","광주광역시","북구",2425,1439,745,22,590,25,48,1,0,0,0,2,0,0,0,1433,6,986
"10749","임동","관내사전투표","대통령선거","광주광역시","북구",1899,1899,1134,22,632,28,75,0,0,1,0,3,0,2,0,1897,2,0
"10750","임동","임동제1투","대통령선거","광주광역시","북구",2890,2088,1237,34,712,32,66,0,1,1,0,0,0,1,0,2084,4,802
"10751","임동","임동제2투","대통령선거","광주광역시","북구",2490,1684,933,38,627,26,51,0,0,2,0,1,0,1,0,1679,5,806
"10752","신안동","관내사전투표","대통령선거","광주광역시","북구",2211,2211,1270,41,734,52,93,0,1,2,0,8,0,2,1,2204,7,0
"10753","신안동","신안동제1투","대통령선거","광주광역시","북구",2513,1428,794,20,532,28,49,0,0,1,0,1,0,1,1,1427,1,1085
"10754","신안동","신안동제2투","대통령선거","광주광역시","북구",1750,1177,712,12,383,23,40,0,0,0,0,2,0,0,1,1173,4,573
"10755","신안동","신안동제3투","대통령선거","광주광역시","북구",2353,1583,891,31,547,39,63,1,0,1,0,5,0,0,1,1579,4,770
"10756","용봉동","관내사전투표","대통령선거","광주광역시","북구",6422,6422,4171,67,1517,215,405,3,0,2,1,18,0,1,5,6405,17,0
"10757","용봉동","용봉동제1투","대통령선거","광주광역시","북구",2556,1707,1001,31,546,42,76,0,0,1,0,2,0,1,0,1700,7,849
"10758","용봉동","용봉동제2투","대통령선거","광주광역시","북구",2380,1828,1056,55,594,36,75,2,0,0,1,3,1,1,0,1824,4,552
"10759","용봉동","용봉동제3투","대통령선거","광주광역시","북구",2567,1991,1213,24,595,48,102,0,0,0,0,5,0,0,2,1989,2,576
"10760","용봉동","용봉동제4투","대통령선거","광주광역시","북구",1884,1201,655,22,434,16,70,1,0,1,0,0,0,0,0,1199,2,683
"10761","용봉동","용봉동제5투","대통령선거","광주광역시","북구",3737,2985,1925,27,838,57,125,0,0,4,3,4,0,0,1,2984,1,752
"10762","용봉동","용봉동제6투","대통령선거","광주광역시","북구",3861,2993,1750,54,974,70,132,0,0,2,0,5,0,1,1,2989,4,868
"10763","용봉동","용봉동제7투","대통령선거","광주광역시","북구",2130,1753,1037,32,580,42,55,0,1,2,0,1,0,1,0,1751,2,377
"10764","용봉동","용봉동제8투","대통령선거","광주광역시","북구",2470,1948,1244,20,559,32,89,0,0,0,0,2,0,1,0,1947,1,522
"10765","운암1동","관내사전투표","대통령선거","광주광역시","북구",4137,4137,2581,38,1228,91,181,0,0,2,1,3,2,2,2,4131,6,0
"10766","운암1동","운암1동제1투","대통령선거","광주광역시","북구",2931,2224,1383,28,655,45,107,1,0,0,0,1,0,0,0,2220,4,707
"10767","운암1동","운암1동제2투","대통령선거","광주광역시","북구",2741,2097,1184,30,743,38,93,0,0,1,0,3,0,1,1,2094,3,644
"10768","운암1동","운암1동제3투","대통령선거","광주광역시","북구",1793,1537,926,37,478,34,51,0,0,0,0,7,0,0,1,1534,3,256
"10769","운암1동","운암1동제4투","대통령선거","광주광역시","북구",2839,2388,1464,35,723,54,99,0,1,1,0,4,0,2,0,2383,5,451
"10770","운암2동","관내사전투표","대통령선거","광주광역시","북구",3182,3182,1912,48,1024,57,120,0,1,5,1,7,0,0,0,3175,7,0
"10771","운암2동","운암2동제1투","대통령선거","광주광역시","북구",1773,1072,610,17,401,15,22,0,1,0,0,2,0,0,1,1069,3,701
"10772","운암2동","운암2동제2투","대통령선거","광주광역시","북구",1569,987,555,9,367,20,28,1,0,0,0,4,0,0,0,984,3,582
"10773","운암2동","운암2동제3투","대통령선거","광주광역시","북구",2141,1564,882,14,548,33,80,0,0,1,0,1,0,1,0,1560,4,577
"10774","운암2동","운암2동제4투","대통령선거","광주광역시","북구",2211,1574,890,25,564,21,55,0,0,2,0,11,0,0,1,1569,5,637
"10775","운암3동","관내사전투표","대통령선거","광주광역시","북구",4068,4068,2443,56,1266,105,179,0,0,2,0,8,2,1,1,4063,5,0
"10776","운암3동","운암3동제1투","대통령선거","광주광역시","북구",1791,1349,760,27,477,26,51,0,0,0,0,4,0,1,0,1346,3,442
"10777","운암3동","운암3동제2투","대통령선거","광주광역시","북구",2076,1587,972,33,468,28,77,0,0,0,0,5,0,0,1,1584,3,489
"10778","운암3동","운암3동제3투","대통령선거","광주광역시","북구",1791,1288,746,20,425,24,64,2,0,1,0,3,0,0,2,1287,1,503
"10779","운암3동","운암3동제4투","대통령선거","광주광역시","북구",2799,2112,1316,33,637,27,84,0,0,0,0,7,0,1,2,2107,5,687
"10780","동림동","관내사전투표","대통령선거","광주광역시","북구",3161,3161,1968,35,895,75,161,0,0,1,0,13,2,1,0,3151,10,0
"10781","동림동","동림동제1투","대통령선거","광주광역시","북구",2677,1978,1311,24,525,28,75,1,0,1,0,7,0,1,2,1975,3,699
"10782","동림동","동림동제2투","대통령선거","광주광역시","북구",2141,1578,950,14,496,43,66,1,0,1,1,2,0,0,1,1575,3,563
"10783","동림동","동림동제3투","대통령선거","광주광역시","북구",2433,1978,1283,23,539,32,85,1,0,0,0,5,0,1,1,1970,8,455
"10784","동림동","동림동제4투","대통령선거","광주광역시","북구",2518,2063,1234,23,673,33,83,1,0,0,0,9,0,2,0,2058,5,455
"10785","동림동","동림동제5투","대통령선거","광주광역시","북구",1699,1249,769,8,396,19,48,0,0,0,0,1,0,1,1,1243,6,450
"10786","우산동","관내사전투표","대통령선거","광주광역시","북구",2494,2494,1379,37,917,52,99,0,1,0,0,4,0,0,0,2489,5,0
"10787","우산동","우산동제1투","대통령선거","광주광역시","북구",1647,935,505,21,363,18,24,0,0,0,0,1,0,0,0,932,3,712
"10788","우산동","우산동제2투","대통령선거","광주광역시","북구",1914,1290,690,25,497,29,40,0,0,1,0,1,0,0,3,1286,4,624
"10789","우산동","우산동제3투","대통령선거","광주광역시","북구",1449,1023,560,16,377,20,42,0,0,3,0,1,0,0,0,1019,4,426
"10790","우산동","우산동제4투","대통령선거","광주광역시","북구",1493,949,477,14,411,11,26,0,0,2,0,2,0,0,0,943,6,544
"10791","우산동","우산동제5투","대통령선거","광주광역시","북구",1525,1130,608,34,420,19,41,0,0,2,0,1,0,2,0,1127,3,395
"10792","풍향동","관내사전투표","대통령선거","광주광역시","북구",1031,1031,641,10,307,20,47,0,0,1,0,3,0,0,0,1029,2,0
"10793","풍향동","풍향동제1투","대통령선거","광주광역시","북구",1321,889,495,21,323,13,34,0,0,1,0,1,0,0,0,888,1,432
"10794","풍향동","풍향동제2투","대통령선거","광주광역시","북구",1262,793,445,19,277,8,33,0,0,1,0,4,0,1,1,789,4,469
"10795","문화동","관내사전투표","대통령선거","광주광역시","북구",2545,2545,1423,41,915,40,104,0,0,3,0,7,0,0,1,2534,11,0
"10796","문화동","문화동제1투","대통령선거","광주광역시","북구",2446,1527,793,49,608,27,37,2,0,0,0,2,0,0,4,1522,5,919
"10797","문화동","문화동제2투","대통령선거","광주광역시","북구",1961,1458,809,42,540,21,39,0,0,1,0,5,0,0,0,1457,1,503
"10798","문화동","문화동제3투","대통령선거","광주광역시","북구",2279,1798,1058,37,587,41,64,0,0,1,1,2,1,2,1,1795,3,481
"10799","문화동","문화동제4투","대통령선거","광주광역시","북구",1336,921,527,16,325,11,37,1,0,0,0,3,0,1,0,921,0,415
"10800","문흥1동","관내사전투표","대통령선거","광주광역시","북구",4100,4100,2575,56,1205,88,147,2,1,1,0,16,0,1,0,4092,8,0
"10801","문흥1동","문흥1동제1투","대통령선거","광주광역시","북구",1804,1327,850,14,367,23,67,1,0,0,1,1,0,0,1,1325,2,477
"10802","문흥1동","문흥1동제2투","대통령선거","광주광역시","북구",1662,1218,747,24,369,20,51,0,0,0,0,3,0,0,0,1214,4,444
"10803","문흥1동","문흥1동제3투","대통령선거","광주광역시","북구",1936,1528,909,22,506,26,60,0,0,0,0,2,0,1,0,1526,2,408
"10804","문흥1동","문흥1동제4투","대통령선거","광주광역시","북구",1772,1390,874,13,411,32,52,0,0,1,0,1,0,0,1,1385,5,382
"10805","문흥1동","문흥1동제5투","대통령선거","광주광역시","북구",1588,1146,709,9,362,23,39,0,0,0,0,3,0,0,1,1146,0,442
"10806","문흥2동","관내사전투표","대통령선거","광주광역시","북구",3781,3781,2363,32,1124,76,154,0,1,3,0,16,0,2,3,3774,7,0
"10807","문흥2동","문흥2동제1투","대통령선거","광주광역시","북구",1821,1419,896,20,422,16,58,0,0,2,0,0,0,1,0,1415,4,402
"10808","문흥2동","문흥2동제2투","대통령선거","광주광역시","북구",1578,1234,764,4,386,22,55,0,0,0,0,1,0,0,2,1234,0,344
"10809","문흥2동","문흥2동제3투","대통령선거","광주광역시","북구",2023,1567,1017,9,423,36,75,0,0,0,0,4,0,1,1,1566,1,456
"10810","문흥2동","문흥2동제4투","대통령선거","광주광역시","북구",1794,1228,683,21,447,17,49,0,1,2,0,0,1,1,1,1223,5,566
"10811","문흥2동","문흥2동제5투","대통령선거","광주광역시","북구",1932,1368,812,14,440,28,64,1,0,0,0,6,0,0,0,1365,3,564
"10812","두암1동","관내사전투표","대통령선거","광주광역시","북구",1918,1918,1043,27,727,38,71,0,0,2,0,4,0,0,2,1914,4,0
"10813","두암1동","두암1동제1투","대통령선거","광주광역시","북구",1553,1112,577,16,458,19,35,1,0,1,0,1,1,1,2,1112,0,441
"10814","두암1동","두암1동제2투","대통령선거","광주광역시","북구",1831,1188,695,10,414,14,48,0,0,2,1,2,0,0,1,1187,1,643
"10815","두암1동","두암1동제3투","대통령선거","광주광역시","북구",1499,1052,602,25,369,14,35,0,0,1,0,1,1,0,2,1050,2,447
"10816","두암2동","관내사전투표","대통령선거","광주광역시","북구",3380,3380,2002,38,1125,68,130,0,0,2,0,7,1,1,1,3375,5,0
"10817","두암2동","두암2동제1투","대통령선거","광주광역시","북구",1976,1266,667,24,489,26,55,0,0,1,0,1,0,1,0,1264,2,710
"10818","두암2동","두암2동제2투","대통령선거","광주광역시","북구",1659,1165,637,22,426,17,55,0,0,2,0,0,0,1,0,1160,5,494
"10819","두암2동","두암2동제3투","대통령선거","광주광역시","북구",1741,1156,647,21,410,17,50,0,0,3,0,1,1,0,2,1152,4,585
"10820","두암2동","두암2동제4투","대통령선거","광주광역시","북구",2134,1580,927,24,544,19,59,1,0,0,0,1,0,0,0,1575,5,554
"10821","두암2동","두암2동제5투","대통령선거","광주광역시","북구",2443,1869,1082,19,653,38,68,0,0,2,0,4,0,0,2,1868,1,574
"10822","두암3동","관내사전투표","대통령선거","광주광역시","북구",2839,2839,1581,29,1076,40,95,0,0,2,0,6,0,0,3,2832,7,0
"10823","두암3동","두암3동제1투","대통령선거","광주광역시","북구",1205,614,332,15,239,5,18,0,0,0,0,1,0,1,0,611,3,591
"10824","두암3동","두암3동제2투","대통령선거","광주광역시","북구",1916,1455,822,19,498,31,71,0,0,4,0,3,0,0,2,1450,5,461
"10825","두암3동","두암3동제3투","대통령선거","광주광역시","북구",1852,1213,733,20,398,16,40,0,0,1,1,1,0,1,0,1211,2,639
"10826","두암3동","두암3동제4투","대통령선거","광주광역시","북구",2087,1391,739,21,565,21,29,0,0,2,1,1,0,2,3,1384,7,696
"10827","두암3동","두암3동제5투","대통령선거","광주광역시","북구",2149,1596,862,35,588,28,70,1,0,0,0,8,0,0,3,1595,1,553
"10828","삼각동","관내사전투표","대통령선거","광주광역시","북구",2689,2689,1703,29,730,78,133,0,0,3,1,7,0,0,0,2684,5,0
"10829","삼각동","삼각동제1투","대통령선거","광주광역시","북구",3094,2081,1254,36,637,47,100,0,0,0,0,3,0,1,2,2080,1,1013
"10830","삼각동","삼각동제2투","대통령선거","광주광역시","북구",2194,1815,1099,17,568,35,82,0,0,1,0,6,0,0,1,1809,6,379
"10831","삼각동","삼각동제3투","대통령선거","광주광역시","북구",2181,1649,998,15,517,36,74,0,0,1,0,4,0,0,0,1645,4,532
"10832","일곡동","관내사전투표","대통령선거","광주광역시","북구",6173,6173,4046,62,1517,160,356,2,0,3,0,11,0,2,3,6162,11,0
"10833","일곡동","일곡동제1투","대통령선거","광주광역시","북구",3107,2335,1566,27,571,45,112,1,2,0,0,6,0,0,3,2333,2,772
"10834","일곡동","일곡동제2투","대통령선거","광주광역시","북구",2593,1813,1141,24,510,37,85,0,0,0,0,7,1,2,1,1808,5,780
"10835","일곡동","일곡동제3투","대통령선거","광주광역시","북구",1749,1410,942,13,349,26,73,0,0,0,0,5,0,0,1,1409,1,339
"10836","일곡동","일곡동제4투","대통령선거","광주광역시","북구",2398,1921,1267,38,479,41,90,0,0,2,0,0,0,1,2,1920,1,477
"10837","일곡동","일곡동제5투","대통령선거","광주광역시","북구",2656,2228,1448,32,580,49,107,0,0,1,0,7,0,0,0,2224,4,428
"10838","일곡동","일곡동제6투","대통령선거","광주광역시","북구",2666,2080,1260,43,601,48,115,0,0,1,0,5,0,0,2,2075,5,586
"10839","매곡동","관내사전투표","대통령선거","광주광역시","북구",3700,3700,2373,57,1034,63,154,0,0,0,0,12,0,0,1,3694,6,0
"10840","매곡동","매곡동제1투","대통령선거","광주광역시","북구",1990,1540,915,19,494,30,74,0,0,0,0,0,0,0,3,1535,5,450
"10841","매곡동","매곡동제2투","대통령선거","광주광역시","북구",2754,2058,1241,33,654,44,73,0,0,0,0,7,0,1,0,2053,5,696
"10842","매곡동","매곡동제3투","대통령선거","광주광역시","북구",2477,1959,1248,21,573,33,75,0,0,1,0,3,0,1,1,1956,3,518
"10843","오치1동","관내사전투표","대통령선거","광주광역시","북구",2105,2105,1293,32,634,31,104,0,0,2,0,2,0,0,0,2098,7,0
"10844","오치1동","오치1동제1투","대통령선거","광주광역시","북구",2406,1563,916,22,525,34,56,0,0,1,0,4,0,0,0,1558,5,843
"10845","오치1동","오치1동제2투","대통령선거","광주광역시","북구",2118,1517,896,19,499,33,64,0,0,0,0,3,0,0,0,1514,3,601
"10846","오치1동","오치1동제3투","대통령선거","광주광역시","북구",2491,1740,973,32,606,36,82,0,0,1,0,1,1,0,0,1732,8,751
"10847","오치2동","관내사전투표","대통령선거","광주광역시","북구",3728,3728,2232,56,1171,67,163,2,0,3,0,14,0,2,4,3714,14,0
"10848","오치2동","오치2동제1투","대통령선거","광주광역시","북구",1877,1301,790,21,402,25,53,1,0,0,0,2,0,0,1,1295,6,576
"10849","오치2동","오치2동제2투","대통령선거","광주광역시","북구",1836,1086,586,18,418,13,44,0,0,2,0,2,1,0,1,1085,1,750
"10850","오치2동","오치2동제3투","대통령선거","광주광역시","북구",2009,1350,772,17,459,24,71,0,0,0,0,2,0,1,2,1348,2,659
"10851","오치2동","오치2동제4투","대통령선거","광주광역시","북구",2262,1643,931,19,580,37,66,0,0,0,0,6,0,1,1,1641,2,619
"10852","석곡동","관내사전투표","대통령선거","광주광역시","북구",553,553,320,5,190,9,23,0,0,0,0,2,0,0,0,549,4,0
"10853","석곡동","석곡동제1투","대통령선거","광주광역시","북구",1203,797,455,11,292,3,30,1,0,1,0,1,0,2,1,797,0,406
"10854","석곡동","석곡동제2투","대통령선거","광주광역시","북구",431,315,159,8,126,5,8,1,0,1,0,0,0,0,1,309,6,116
"10855","건국동","관내사전투표","대통령선거","광주광역시","북구",4101,4101,2708,52,1010,88,205,1,0,3,1,10,0,0,2,4080,21,0
"10856","건국동","건국동제1투","대통령선거","광주광역시","북구",3169,2376,1547,25,629,48,112,0,1,1,0,6,0,0,3,2372,4,793
"10857","건국동","건국동제2투","대통령선거","광주광역시","북구",2194,1732,1121,15,481,43,70,0,0,0,0,0,0,0,1,1731,1,462
"10858","건국동","건국동제3투","대통령선거","광주광역시","북구",2538,1951,1267,44,503,40,88,0,0,1,0,5,0,0,0,1948,3,587
"10859","건국동","건국동제4투","대통령선거","광주광역시","북구",2604,1897,1187,37,553,33,76,0,0,0,0,4,0,0,1,1891,6,707
"10860","건국동","건국동제5투","대통령선거","광주광역시","북구",3307,2409,1560,40,629,60,111,1,0,0,0,2,0,0,1,2404,5,898
"10861","건국동","건국동제6투","대통령선거","광주광역시","북구",1756,1133,677,23,372,27,25,0,0,1,0,0,1,2,1,1129,4,623
"10862","건국동","건국동제7투","대통령선거","광주광역시","북구",3793,2986,2012,34,739,58,135,1,0,0,0,5,0,0,0,2984,2,807
"10863","건국동","건국동제8투","대통령선거","광주광역시","북구",3668,3079,2146,35,674,53,166,0,0,0,0,3,1,0,0,3078,1,589
"10864","양산동","관내사전투표","대통령선거","광주광역시","북구",7380,7380,4866,79,1803,156,411,1,2,3,0,23,3,3,5,7355,25,0
"10865","양산동","양산동제1투","대통령선거","광주광역시","북구",4100,2724,1740,37,737,57,136,0,0,1,1,6,1,1,1,2718,6,1376
"10866","양산동","양산동제2투","대통령선거","광주광역시","북구",2987,2211,1397,30,625,52,98,1,0,0,0,4,0,1,1,2209,2,776
"10867","양산동","양산동제3투","대통령선거","광주광역시","북구",2731,2067,1270,22,647,31,83,0,0,1,0,9,1,0,0,2064,3,664
"10868","양산동","양산동제4투","대통령선거","광주광역시","북구",3437,2599,1602,45,781,48,116,1,0,0,0,4,0,0,2,2599,0,838
"10869","양산동","양산동제5투","대통령선거","광주광역시","북구",2594,1858,1117,29,605,31,65,0,0,0,0,2,0,0,1,1850,8,736
"10870","양산동","양산동제6투","대통령선거","광주광역시","북구",2417,1772,1104,21,533,21,85,0,0,5,0,1,0,1,0,1771,1,645
"10871","잘못 투입·구분된 투표지","잘못 투입·구분된 투표지","대통령선거","광주광역시","북구",0,0,0,0,0,0,0,0,0,0,0,0,0,0,0,0,0,0
"10872","거소·선상투표","거소·선상투표","대통령선거","광주광역시","광산구",684,646,340,13,213,20,21,1,3,1,1,2,1,1,5,622,24,38
"10873","관외사전투표","관외사전투표","대통령선거","광주광역시","광산구",30269,30266,19305,576,7055,1057,1952,8,12,12,3,76,7,10,38,30111,155,3
"10874","재외투표","재외투표","대통령선거","광주광역시","광산구",1003,804,601,13,91,19,79,1,0,0,0,0,0,0,0,804,0,199
"10875","송정1동","관내사전투표","대통령선거","광주광역시","광산구",2113,2113,1254,39,679,47,79,0,0,2,0,4,0,1,1,2106,7,0
"10876","송정1동","송정1동제1투","대통령선거","광주광역시","광산구",2260,1509,862,26,520,25,68,0,0,1,0,1,0,1,2,1506,3,751
"10877","송정1동","송정1동제2투","대통령선거","광주광역시","광산구",1794,1198,703,26,401,19,38,0,0,2,0,2,0,0,1,1192,6,596
"10878","송정1동","송정1동제3투","대통령선거","광주광역시","광산구",2266,1802,1145,30,504,34,73,1,0,0,0,9,0,0,3,1799,3,464
"10879","송정2동","관내사전투표","대통령선거","광주광역시","광산구",2152,2152,1256,31,649,51,131,0,1,2,1,11,0,1,5,2139,13,0
"10880","송정2동","송정2동제1투","대통령선거","광주광역시","광산구",1388,828,423,20,330,16,33,0,0,0,0,2,0,0,0,824,4,560
"10881","송정2동","송정2동제2투","대통령선거","광주광역시","광산구",1411,999,556,30,360,15,34,0,0,0,0,1,0,0,2,998,1,412
"10882","송정2동","송정2동제3투","대통령선거","광주광역시","광산구",1170,913,514,18,318,18,40,0,0,0,0,1,0,0,1,910,3,257
"10883","도산동","관내사전투표","대통령선거","광주광역시","광산구",3280,3280,2038,61,938,62,142,1,0,1,0,17,2,1,4,3267,13,0
"10884","도산동","도산동제1투","대통령선거","광주광역시","광산구",2180,1439,862,16,450,33,69,0,0,0,0,3,0,0,0,1433,6,741
"10885","도산동","도산동제2투","대통령선거","광주광역시","광산구",2592,1712,1038,24,506,46,80,0,0,1,0,8,0,2,1,1706,6,880
"10886","도산동","도산동제3투","대통령선거","광주광역시","광산구",2775,2000,1277,36,542,36,96,0,0,0,0,4,0,0,2,1993,7,775
"10887","신흥동","관내사전투표","대통령선거","광주광역시","광산구",895,895,511,14,307,23,36,0,0,0,0,1,0,1,2,895,0,0
"10888","신흥동","신흥동제1투","대통령선거","광주광역시","광산구",1233,777,433,15,282,12,28,0,0,0,0,1,2,0,0,773,4,456
"10889","신흥동","신흥동제2투","대통령선거","광주광역시","광산구",1505,1043,626,34,320,16,44,0,0,0,0,0,0,0,1,1041,2,462
"10890","어룡동","관내사전투표","대통령선거","광주광역시","광산구",3752,3752,2455,40,940,61,233,1,1,2,0,11,1,0,0,3745,7,0
"10891","어룡동","어룡동제1투","대통령선거","광주광역시","광산구",1493,973,533,18,366,11,37,0,0,2,0,5,0,0,0,972,1,520
"10892","어룡동","어룡동제2투","대통령선거","광주광역시","광산구",2177,1550,942,28,463,27,81,1,0,1,1,2,0,0,1,1547,3,627
"10893","어룡동","어룡동제3투","대통령선거","광주광역시","광산구",1823,1300,813,21,388,22,47,0,0,0,0,5,0,0,2,1298,2,523
"10894","어룡동","어룡동제4투","대통령선거","광주광역시","광산구",2340,1429,840,23,471,20,57,0,1,1,0,7,0,1,2,1423,6,911
"10895","어룡동","어룡동제5투","대통령선거","광주광역시","광산구",2043,1549,998,14,408,28,88,0,0,0,0,6,0,0,3,1545,4,494
"10896","어룡동","어룡동제6투","대통령선거","광주광역시","광산구",2596,2047,1282,29,583,47,92,0,0,3,0,3,1,1,1,2042,5,549
"10897","어룡동","어룡동제7투","대통령선거","광주광역시","광산구",3163,2499,1610,35,658,47,135,0,0,0,0,8,0,0,1,2494,5,664
"10898","우산동","관내사전투표","대통령선거","광주광역시","광산구",4110,4110,2636,55,1093,86,207,1,0,2,2,15,0,1,4,4102,8,0
"10899","우산동","우산동제1투","대통령선거","광주광역시","광산구",2860,1913,1093,33,644,34,94,1,1,2,1,2,2,0,0,1907,6,947
"10900","우산동","우산동제2투","대통령선거","광주광역시","광산구",756,437,242,11,151,9,21,0,0,0,0,0,0,0,1,435,2,319
"10901","우산동","우산동제3투","대통령선거","광주광역시","광산구",2057,1310,708,38,496,11,38,0,0,2,0,4,0,1,4,1302,8,747
"10902","우산동","우산동제4투","대통령선거","광주광역시","광산구",1524,1003,617,18,289,18,50,0,0,0,0,7,0,0,1,1000,3,521
"10903","우산동","우산동제5투","대통령선거","광주광역시","광산구",3716,2737,1727,39,767,55,133,0,0,2,1,5,1,1,2,2733,4,979
"10904","우산동","우산동제6투","대통령선거","광주광역시","광산구",1363,856,519,15,248,15,52,0,0,2,0,3,1,0,0,855,1,507
"10905","우산동","우산동제7투","대통령선거","광주광역시","광산구",1698,1045,540,26,409,20,37,1,0,1,1,3,1,1,1,1041,4,653
"10906","월곡1동","관내사전투표","대통령선거","광주광역시","광산구",3403,3403,2186,52,904,76,153,1,0,3,0,20,0,0,2,3397,6,0
"10907","월곡1동","월곡1동제1투","대통령선거","광주광역시","광산구",1730,1052,590,18,387,15,35,0,0,0,0,2,0,0,2,1049,3,678
"10908","월곡1동","월곡1동제2투","대통령선거","광주광역시","광산구",1231,802,457,24,258,10,49,0,0,0,0,2,0,0,0,800,2,429
"10909","월곡1동","월곡1동제3투","대통령선거","광주광역시","광산구",2478,1977,1191,15,583,52,117,0,2,0,0,11,1,0,1,1973,4,501
"10910","월곡1동","월곡1동제4투","대통령선거","광주광역시","광산구",2169,1479,904,21,456,19,68,0,0,2,0,2,1,0,2,1475,4,690
"10911","월곡2동","관내사전투표","대통령선거","광주광역시","광산구",2551,2551,1625,35,696,48,123,0,0,1,1,10,1,1,3,2544,7,0
"10912","월곡2동","월곡2동제1투","대통령선거","광주광역시","광산구",1950,1123,619,21,393,32,45,0,0,1,2,2,0,0,1,1116,7,827
"10913","월곡2동","월곡2동제2투","대통령선거","광주광역시","광산구",1663,1061,586,17,377,18,52,0,2,1,0,0,1,1,3,1058,3,602
"10914","월곡2동","월곡2동제3투","대통령선거","광주광역시","광산구",2254,1654,1033,15,493,26,71,0,0,0,0,10,1,1,1,1651,3,600
"10915","월곡2동","월곡2동제4투","대통령선거","광주광역시","광산구",2019,1670,1087,17,416,20,115,0,0,0,0,12,1,0,0,1668,2,349
"10916","월곡2동","월곡2동제5투","대통령선거","광주광역시","광산구",1865,1508,1010,12,362,33,78,0,0,0,0,12,0,0,1,1508,0,357
"10917","비아동","관내사전투표","대통령선거","광주광역시","광산구",1596,1596,997,27,474,34,54,0,1,1,0,4,0,0,0,1592,4,0
"10918","비아동","비아동제1투","대통령선거","광주광역시","광산구",1305,855,528,14,243,19,45,0,0,2,0,1,1,0,1,854,1,450
"10919","비아동","비아동제2투","대통령선거","광주광역시","광산구",2311,1539,952,19,460,23,77,0,0,0,1,1,1,0,1,1535,4,772
"10920","첨단1동","관내사전투표","대통령선거","광주광역시","광산구",5454,5454,3643,61,1231,160,329,0,0,2,0,14,0,1,2,5443,11,0
"10921","첨단1동","첨단1동제1투","대통령선거","광주광역시","광산구",3037,2250,1407,37,619,61,115,0,0,1,0,7,0,0,0,2247,3,787
"10922","첨단1동","첨단1동제2투","대통령선거","광주광역시","광산구",2784,2259,1419,53,611,61,105,0,0,1,0,3,0,0,0,2253,6,525
"10923","첨단1동","첨단1동제3투","대통령선거","광주광역시","광산구",3244,2610,1619,35,747,65,124,0,0,2,0,6,0,0,3,2601,9,634
"10924","첨단1동","첨단1동제4투","대통령선거","광주광역시","광산구",2464,1951,1228,21,547,34,107,0,0,1,0,2,0,0,1,1941,10,513
"10925","첨단2동","관내사전투표","대통령선거","광주광역시","광산구",5538,5538,3695,62,1280,137,318,2,1,2,1,27,0,0,4,5529,9,0
"10926","첨단2동","첨단2동제1투","대통령선거","광주광역시","광산구",1558,1043,629,17,309,22,59,0,0,0,0,5,0,0,0,1041,2,515
"10927","첨단2동","첨단2동제2투","대통령선거","광주광역시","광산구",3103,2039,1294,36,509,52,136,0,0,0,0,6,0,0,2,2035,4,1064
"10928","첨단2동","첨단2동제3투","대통령선거","광주광역시","광산구",2316,1679,1025,18,461,41,115,3,2,0,0,8,1,0,1,1675,4,637
"10929","첨단2동","첨단2동제4투","대통령선거","광주광역시","광산구",2135,1587,1043,28,374,38,90,0,0,1,0,9,0,0,0,1583,4,548
"10930","첨단2동","첨단2동제5투","대통령선거","광주광역시","광산구",2853,2390,1560,36,603,61,114,0,0,0,0,7,0,2,1,2384,6,463
"10931","첨단2동","첨단2동제6투","대통령선거","광주광역시","광산구",2087,1744,1185,23,410,29,81,0,1,1,1,8,1,0,0,1740,4,343
"10932","첨단2동","첨단2동제7투","대통령선거","광주광역시","광산구",2759,2250,1534,23,529,42,113,0,0,1,0,7,0,0,1,2250,0,509
"10933","첨단2동","첨단2동제8투","대통령선거","광주광역시","광산구",2120,1334,813,19,396,28,71,0,0,2,0,1,1,0,1,1332,2,786
"10934","첨단2동","첨단2동제9투","대통령선거","광주광역시","광산구",2394,1985,1329,24,467,38,115,0,1,1,0,5,1,0,0,1981,4,409
"10935","신가동","관내사전투표","대통령선거","광주광역시","광산구",3333,3333,2202,75,803,65,164,1,1,0,0,12,0,0,1,3324,9,0
"10936","신가동","신가동제1투","대통령선거","광주광역시","광산구",1893,1110,613,20,388,24,52,0,0,0,0,3,2,0,2,1104,6,783
"10937","신가동","신가동제2투","대통령선거","광주광역시","광산구",2578,2065,1397,30,493,28,100,0,0,2,0,11,0,0,0,2061,4,513
"10938","신가동","신가동제3투","대통령선거","광주광역시","광산구",979,654,395,10,207,12,23,0,0,1,0,4,0,0,0,652,2,325
"10939","신가동","신가동제4투","대통령선거","광주광역시","광산구",2916,2119,1383,34,561,36,93,0,0,1,0,6,0,0,0,2114,5,797
"10940","신가동","신가동제5투","대통령선거","광주광역시","광산구",3835,2970,2035,36,663,57,168,0,0,0,1,8,0,0,0,2968,2,865
"10941","운남동","관내사전투표","대통령선거","광주광역시","광산구",5190,5190,3527,37,1217,103,273,0,0,1,0,24,0,1,1,5184,6,0
"10942","운남동","운남동제1투","대통령선거","광주광역시","광산구",2389,1781,1156,10,481,40,80,0,0,0,0,12,0,0,1,1780,1,608
"10943","운남동","운남동제2투","대통령선거","광주광역시","광산구",1513,1214,811,28,282,21,66,0,0,0,0,2,0,1,1,1212,2,299
"10944","운남동","운남동제3투","대통령선거","광주광역시","광산구",1852,1285,827,19,345,27,59,0,0,0,0,1,0,0,2,1280,5,567
"10945","운남동","운남동제4투","대통령선거","광주광역시","광산구",1288,1001,614,18,295,21,49,0,1,0,0,0,0,0,3,1001,0,287
"10946","운남동","운남동제5투","대통령선거","광주광역시","광산구",2192,1661,1082,23,428,27,88,0,0,1,0,6,0,0,1,1656,5,531
"10947","운남동","운남동제6투","대통령선거","광주광역시","광산구",1899,1556,922,28,474,38,85,0,0,0,0,2,2,0,4,1555,1,343
"10948","운남동","운남동제7투","대통령선거","광주광역시","광산구",2000,1668,1099,15,421,30,95,0,1,0,0,3,1,0,1,1666,2,332
"10949","운남동","운남동제8투","대통령선거","광주광역시","광산구",2090,1606,1061,13,400,21,85,0,0,3,0,14,0,2,4,1603,3,484
"10950","운남동","운남동제9투","대통령선거","광주광역시","광산구",1818,1463,980,8,352,30,81,0,1,0,0,7,0,0,0,1459,4,355
"10951","신창동","관내사전투표","대통령선거","광주광역시","광산구",6395,6395,4493,61,1304,150,349,1,2,5,1,17,0,1,2,6386,9,0
"10952","신창동","신창동제1투","대통령선거","광주광역시","광산구",850,557,307,8,211,7,20,0,0,0,0,1,0,2,0,556,1,293
"10953","신창동","신창동제2투","대통령선거","광주광역시","광산구",2993,2303,1484,27,591,33,144,0,0,0,0,19,0,0,1,2299,4,690
"10954","신창동","신창동제3투","대통령선거","광주광역시","광산구",1471,1107,766,24,224,28,59,0,0,1,0,3,0,1,0,1106,1,364
"10955","신창동","신창동제4투","대통령선거","광주광역시","광산구",3184,2226,1493,34,496,50,137,0,0,0,0,7,1,0,1,2219,7,958
"10956","신창동","신창동제5투","대통령선거","광주광역시","광산구",2901,2005,1304,24,514,52,103,0,0,2,0,3,0,0,1,2003,2,896
"10957","신창동","신창동제6투","대통령선거","광주광역시","광산구",2313,1961,1324,19,472,34,100,0,0,0,0,6,1,0,0,1956,5,352
"10958","신창동","신창동제7투","대통령선거","광주광역시","광산구",2792,2125,1400,25,554,34,100,0,0,2,0,3,1,1,1,2121,4,667
"10959","수완동","관내사전투표","대통령선거","광주광역시","광산구",9129,9129,6559,85,1850,205,405,3,1,1,0,12,0,0,0,9121,8,0
"10960","수완동","수완동제1투","대통령선거","광주광역시","광산구",2850,2457,1665,31,589,52,112,0,0,1,0,5,0,0,0,2455,2,393
"10961","수완동","수완동제2투","대통령선거","광주광역시","광산구",3067,2476,1634,29,622,55,122,0,0,1,0,8,0,1,1,2473,3,591
"10962","수완동","수완동제3투","대통령선거","광주광역시","광산구",2147,1599,1064,23,396,36,75,0,0,1,1,0,0,0,0,1596,3,548
"10963","수완동","수완동제4투","대통령선거","광주광역시","광산구",4310,3250,2194,38,790,63,152,0,0,1,0,4,0,0,4,3246,4,1060
"10964","수완동","수완동제5투","대통령선거","광주광역시","광산구",2621,2161,1430,34,565,46,82,0,0,0,0,2,0,1,0,2160,1,460
"10965","수완동","수완동제6투","대통령선거","광주광역시","광산구",3476,2767,1872,34,650,61,141,0,0,2,0,4,0,1,0,2765,2,709
"10966","수완동","수완동제7투","대통령선거","광주광역시","광산구",3789,2656,1766,27,688,48,115,0,1,0,0,5,0,1,1,2652,4,1133
"10967","수완동","수완동제8투","대통령선거","광주광역시","광산구",3234,2703,1868,23,610,69,123,0,1,1,1,4,0,0,0,2700,3,531
"10968","수완동","수완동제9투","대통령선거","광주광역시","광산구",2951,2161,1418,26,551,51,105,0,0,1,0,5,0,3,0,2160,1,790
"10969","수완동","수완동제10투","대통령선거","광주광역시","광산구",1991,1573,1035,35,373,45,79,0,0,0,1,1,0,0,1,1570,3,418
"10970","수완동","수완동제11투","대통령선거","광주광역시","광산구",2744,2136,1423,25,533,48,94,0,0,3,0,7,0,0,1,2134,2,608
"10971","수완동","수완동제12투","대통령선거","광주광역시","광산구",2123,1600,1094,25,350,38,86,1,0,1,0,2,0,0,1,1598,2,523
"10972","수완동","수완동제13투","대통령선거","광주광역시","광산구",2156,1676,1109,35,428,38,58,1,0,0,0,2,0,0,3,1674,2,480
"10973","하남동","관내사전투표","대통령선거","광주광역시","광산구",3924,3924,2724,37,877,92,163,0,2,1,0,21,0,1,0,3918,6,0
"10974","하남동","하남동제1투","대통령선거","광주광역시","광산구",2418,1651,1035,20,466,31,84,0,0,0,0,6,0,0,2,1644,7,767
"10975","하남동","하남동제2투","대통령선거","광주광역시","광산구",334,235,104,2,110,5,10,1,1,1,0,1,0,0,0,235,0,99
"10976","하남동","하남동제3투","대통령선거","광주광역시","광산구",3699,2850,1935,29,682,50,129,0,0,3,0,16,0,3,2,2849,1,849
"10977","하남동","하남동제4투","대통령선거","광주광역시","광산구",3189,2533,1665,21,651,59,122,0,1,0,0,8,0,0,1,2528,5,656
"10978","임곡동","관내사전투표","대통령선거","광주광역시","광산구",638,638,348,19,232,7,24,1,0,0,0,4,0,1,1,637,1,0
"10979","임곡동","임곡동제1투","대통령선거","광주광역시","광산구",657,413,231,5,149,5,16,0,0,0,0,3,0,0,1,410,3,244
"10980","임곡동","임곡동제2투","대통령선거","광주광역시","광산구",617,404,242,11,132,4,11,0,0,0,0,1,0,0,2,403,1,213
"10981","동곡동","관내사전투표","대통령선거","광주광역시","광산구",374,374,224,9,121,0,11,0,0,0,0,7,0,0,1,373,1,0
"10982","동곡동","동곡동투표소","대통령선거","광주광역시","광산구",1327,899,473,11,360,9,33,0,0,1,0,2,1,0,4,894,5,428
"10983","평동","관내사전투표","대통령선거","광주광역시","광산구",1010,1010,634,11,308,11,31,0,1,0,0,8,0,1,1,1006,4,0
"10984","평동","평동제1투","대통령선거","광주광역시","광산구",1405,784,425,13,292,15,23,0,1,2,0,7,0,1,0,779,5,621
"10985","평동","평동제2투","대통령선거","광주광역시","광산구",1177,804,439,13,313,4,16,0,0,0,1,9,0,1,1,797,7,373
"10986","삼도동","관내사전투표","대통령선거","광주광역시","광산구",452,452,226,14,164,4,22,0,1,1,1,5,0,2,3,443,9,0
"10987","삼도동","삼도동제1투","대통령선거","광주광역시","광산구",948,588,329,6,222,9,11,0,0,0,1,3,0,1,2,584,4,360
"10988","삼도동","삼도동제2투","대통령선거","광주광역시","광산구",607,425,223,11,174,1,6,0,0,1,0,2,3,0,1,422,3,182
"10989","본량동","관내사전투표","대통령선거","광주광역시","광산구",357,357,152,15,133,11,16,0,0,3,0,5,3,0,2,340,17,0
"10990","본량동","본량동제1투","대통령선거","광주광역시","광산구",955,669,307,19,306,6,15,1,1,0,0,6,2,0,1,664,5,286
"10991","본량동","본량동제2투","대통령선거","광주광역시","광산구",432,231,110,3,105,4,4,0,0,0,1,0,3,0,1,231,0,201
"10992","잘못 투입·구분된 투표지","잘못 투입·구분된 투표지","대통령선거","광주광역시","광산구",0,0,0,0,0,0,0,0,0,0,0,0,0,0,0,0,0,0
"10993","거소·선상투표","거소·선상투표","대통령선거","인천광역시","중구",210,200,83,32,58,9,6,3,0,3,1,0,0,0,1,196,4,10
"10994","관외사전투표","관외사전투표","대통령선거","인천광역시","중구",8556,8556,3743,1588,1788,631,697,18,3,6,1,9,3,2,11,8500,56,0
"10995","재외투표","재외투표","대통령선거","인천광역시","중구",719,542,338,51,66,23,58,3,0,0,0,0,0,0,1,540,2,177
"10996","신포동","관내사전투표","대통령선거","인천광역시","중구",707,707,272,218,134,41,39,3,0,0,0,0,0,0,0,707,0,0
"10997","신포동","신포동제1투","대통령선거","인천광역시","중구",1997,1372,520,382,310,74,76,1,0,4,1,0,0,0,1,1369,3,625
"10998","신포동","신포동제2투","대통령선거","인천광역시","중구",1819,986,296,366,216,45,51,1,0,3,2,2,0,0,0,982,4,833
"10999","연안동","관내사전투표","대통령선거","인천광역시","중구",972,972,377,285,216,52,38,0,0,0,0,0,0,0,0,968,4,0
"11000","연안동","연안동제1투","대통령선거","인천광역시","중구",843,521,178,155,125,23,37,1,0,1,0,0,0,0,0,520,1,322
"11001","연안동","연안동제2투","대통령선거","인천광역시","중구",2095,1140,366,359,312,52,44,0,0,0,0,0,0,0,1,1134,6,955
"11002","연안동","연안동제3투","대통령선거","인천광역시","중구",1980,1240,383,393,324,77,57,0,0,1,0,0,0,0,1,1236,4,740
"11003","신흥동","관내사전투표","대통령선거","인천광역시","중구",1556,1556,576,418,345,86,119,0,0,2,0,1,0,1,0,1548,8,0
"11004","신흥동","신흥동제1투","대통령선거","인천광역시","중구",1977,1186,405,367,269,65,63,1,0,1,0,3,1,4,2,1181,5,791
"11005","신흥동","신흥동제2투","대통령선거","인천광역시","중구",2641,1811,665,507,402,90,134,3,0,1,1,1,0,0,5,1809,2,830
"11006","신흥동","신흥동제3투","대통령선거","인천광역시","중구",534,337,93,90,106,23,23,1,0,0,0,0,0,0,0,336,1,197
"11007","신흥동","신흥동제4투","대통령선거","인천광역시","중구",2569,1807,733,399,415,114,135,1,1,2,0,0,1,0,2,1803,4,762
"11008","신흥동","신흥동제5투","대통령선거","인천광역시","중구",1518,915,290,296,228,44,44,1,0,1,0,1,0,1,2,908,7,603
"11009","도원동","관내사전투표","대통령선거","인천광역시","중구",774,774,267,243,173,34,50,2,1,1,1,0,0,0,0,772,2,0
"11010","도원동","도원동제1투","대통령선거","인천광역시","중구",1692,1017,353,307,244,46,58,0,0,1,1,0,0,1,1,1012,5,675
"11011","도원동","도원동제2투","대통령선거","인천광역시","중구",1374,884,274,289,209,54,49,0,0,1,0,1,1,1,1,880,4,490
"11012","율목동","관내사전투표","대통령선거","인천광역시","중구",663,663,219,202,156,33,47,1,0,0,0,1,1,0,1,661,2,0
"11013","율목동","율목동투표소","대통령선거","인천광역시","중구",2724,1507,440,508,365,83,99,1,0,0,2,1,1,1,0,1501,6,1217
"11014","동인천동","관내사전투표","대통령선거","인천광역시","중구",907,907,333,272,186,47,59,0,1,0,2,1,0,0,0,901,6,0
"11015","동인천동","동인천동제1투","대통령선거","인천광역시","중구",1416,756,205,268,187,45,42,0,0,1,1,1,2,1,1,754,2,660
"11016","동인천동","동인천동제2투","대통령선거","인천광역시","중구",2807,1668,552,488,424,84,101,4,0,3,1,1,3,1,4,1666,2,1139
"11017","북성동","관내사전투표","대통령선거","인천광역시","중구",364,364,151,81,80,29,20,0,0,0,0,0,0,1,2,364,0,0
"11018","북성동","북성동제1투","대통령선거","인천광역시","중구",1671,981,310,311,234,64,55,2,0,0,1,0,1,0,1,979,2,690
"11019","북성동","북성동제2투","대통령선거","인천광역시","중구",721,510,149,198,115,19,24,1,0,2,0,0,0,0,0,508,2,211
"11020","송월동","관내사전투표","대통령선거","인천광역시","중구",729,729,282,195,156,36,52,2,0,0,0,0,0,0,1,724,5,0
"11021","송월동","송월동제1투","대통령선거","인천광역시","중구",2189,1428,495,386,341,92,99,3,1,2,1,0,0,0,3,1423,5,761
"11022","송월동","송월동제2투","대통령선거","인천광역시","중구",1105,640,193,196,160,39,45,0,0,1,0,1,0,1,1,637,3,465
"11023","영종동","관내사전투표","대통령선거","인천광역시","중구",3542,3542,1743,623,699,202,247,14,1,2,0,5,0,1,1,3538,4,0
"11024","영종동","영종동제1투","대통령선거","인천광역시","중구",1692,1022,304,381,223,47,65,0,0,0,1,0,0,0,0,1021,1,670
"11025","영종동","영종동제2투","대통령선거","인천광역시","중구",1939,1263,502,286,293,86,86,3,0,3,0,0,0,1,1,1261,2,676
"11026","영종동","영종동제3투","대통령선거","인천광역시","중구",1524,897,268,324,199,42,45,3,3,0,0,3,1,0,1,889,8,627
"11027","영종동","영종동제4투","대통령선거","인천광역시","중구",1941,1099,291,423,277,46,48,0,0,3,0,4,0,0,0,1092,7,842
"11028","영종동","영종동제5투","대통령선거","인천광역시","중구",4724,3221,1491,536,735,191,247,7,1,2,0,1,1,3,2,3217,4,1503
"11029","영종동","영종동제6투","대통령선거","인천광역시","중구",3995,2793,1345,346,646,218,220,1,0,0,2,0,1,1,4,2784,9,1202
"11030","영종동","영종동제7투","대통령선거","인천광역시","중구",4116,3074,1451,539,677,186,210,6,0,0,0,2,0,1,0,3072,2,1042
"11031","용유동","관내사전투표","대통령선거","인천광역시","중구",402,402,116,145,87,26,26,0,0,0,0,1,0,0,0,401,1,0
"11032","용유동","용유동제1투","대통령선거","인천광역시","중구",1445,777,200,303,186,38,36,1,1,3,0,1,0,0,1,770,7,668
"11033","용유동","용유동제2투","대통령선거","인천광역시","중구",1159,644,160,257,159,28,31,1,0,2,0,0,0,1,2,641,3,515
"11034","용유동","용유동제3투","대통령선거","인천광역시","중구",532,348,42,206,81,10,6,1,0,0,0,0,0,0,1,347,1,184
"11035","용유동","용유동제4투","대통령선거","인천광역시","중구",66,51,6,19,22,2,2,0,0,0,0,0,0,0,0,51,0,15
"11036","운서동","관내사전투표","대통령선거","인천광역시","중구",4906,4906,2604,574,887,332,479,12,0,0,1,3,1,1,4,4898,8,0
"11037","운서동","운서동제1투","대통령선거","인천광역시","중구",2422,1764,874,268,380,105,122,6,1,2,0,1,1,0,0,1760,4,658
"11038","운서동","운서동제2투","대통령선거","인천광역시","중구",1945,1201,554,199,247,90,99,1,0,4,0,3,0,0,2,1199,2,744
"11039","운서동","운서동제3투","대통령선거","인천광역시","중구",2304,1703,791,271,402,93,140,0,0,1,0,2,0,0,0,1700,3,601
"11040","운서동","운서동제4투","대통령선거","인천광역시","중구",3746,2249,1003,374,491,186,177,7,0,0,1,2,0,3,0,2244,5,1497
"11041","운서동","운서동제5투","대통령선거","인천광역시","중구",2163,1588,744,215,370,114,130,6,0,0,1,2,0,0,2,1584,4,575
"11042","잘못 투입·구분된 투표지","잘못 투입·구분된 투표지","대통령선거","인천광역시","중구",0,0,0,0,0,0,0,0,0,0,0,0,0,0,0,0,0,0
"11043","거소·선상투표","거소·선상투표","대통령선거","인천광역시","동구",101,98,36,14,34,7,5,0,0,0,0,0,0,0,2,98,0,3
"11044","관외사전투표","관외사전투표","대통령선거","인천광역시","동구",3961,3961,1771,653,851,278,365,5,1,2,0,6,3,1,5,3941,20,0
"11045","재외투표","재외투표","대통령선거","인천광역시","동구",310,223,138,18,34,7,24,0,0,0,0,1,0,0,0,222,1,87
"11046","만석동","관내사전투표","대통령선거","인천광역시","동구",1237,1237,496,262,293,66,109,1,0,1,0,0,2,2,0,1232,5,0
"11047","만석동","만석동제1투","대통령선거","인천광역시","동구",2155,1302,412,354,360,65,89,3,1,3,0,0,1,1,2,1291,11,853
"11048","만석동","만석동제2투","대통령선거","인천광역시","동구",2730,1940,712,460,492,95,161,1,1,3,0,2,0,1,2,1930,10,790
"11049","화수1·화평동","관내사전투표","대통령선거","인천광역시","동구",868,868,309,257,176,44,75,0,0,1,0,0,0,0,0,862,6,0
"11050","화수1·화평동","화수1·화평동제1투","대통령선거","인천광역시","동구",2166,1297,409,424,314,50,88,1,0,0,1,2,1,0,1,1291,6,869
"11051","화수1·화평동","화수1·화평동제2투","대통령선거","인천광역시","동구",2375,1664,534,497,393,103,127,1,0,1,0,1,1,1,0,1659,5,711
"11052","화수2동","관내사전투표","대통령선거","인천광역시","동구",792,792,305,205,163,39,68,0,4,1,0,1,0,0,1,787,5,0
"11053","화수2동","화수2동제1투","대통령선거","인천광역시","동구",1790,1115,329,316,320,60,76,3,0,1,3,0,0,0,2,1110,5,675
"11054","화수2동","화수2동제2투","대통령선거","인천광역시","동구",2135,1496,501,427,350,83,122,0,1,3,0,1,1,1,1,1491,5,639
"11055","화수2동","화수2동제3투","대통령선거","인천광역시","동구",2025,1603,563,433,374,100,120,2,1,0,0,2,0,0,1,1596,7,422
"11056","송현1·2동","관내사전투표","대통령선거","인천광역시","동구",1877,1877,760,474,381,99,146,5,0,1,0,2,0,0,2,1870,7,0
"11057","송현1·2동","송현1·2동제1투","대통령선거","인천광역시","동구",2074,1460,500,415,354,84,100,2,0,1,0,2,0,0,1,1459,1,614
"11058","송현1·2동","송현1·2동제2투","대통령선거","인천광역시","동구",2287,1695,670,389,386,111,130,1,0,2,0,0,1,0,4,1694,1,592
"11059","송현1·2동","송현1·2동제3투","대통령선거","인천광역시","동구",2609,1850,808,356,390,129,156,1,1,1,0,1,0,1,0,1844,6,759
"11060","송현3동","관내사전투표","대통령선거","인천광역시","동구",650,650,260,141,140,41,61,3,0,0,0,0,0,0,0,646,4,0
"11061","송현3동","송현3동제1투","대통령선거","인천광역시","동구",1459,996,296,300,279,52,51,3,0,2,0,2,0,2,1,988,8,463
"11062","송현3동","송현3동제2투","대통령선거","인천광역시","동구",1353,839,273,225,223,51,53,0,1,2,1,0,0,0,1,830,9,514
"11063","송림1동","관내사전투표","대통령선거","인천광역시","동구",370,370,138,95,91,23,17,1,1,0,0,1,0,1,0,368,2,0
"11064","송림1동","송림1동제1투","대통령선거","인천광역시","동구",1158,722,229,229,158,55,38,2,0,1,0,3,2,1,2,720,2,436
"11065","송림1동","송림1동제2투","대통령선거","인천광역시","동구",762,501,136,198,106,19,32,3,0,1,0,0,0,2,1,498,3,261
"11066","송림2동","관내사전투표","대통령선거","인천광역시","동구",604,604,210,174,137,36,40,2,0,0,0,0,0,0,0,599,5,0
"11067","송림2동","송림2동제1투","대통령선거","인천광역시","동구",1128,650,172,248,163,24,37,1,0,0,0,0,1,0,0,646,4,478
"11068","송림2동","송림2동제2투","대통령선거","인천광역시","동구",1296,855,261,290,226,22,42,4,1,2,0,0,1,2,1,852,3,441
"11069","송림3·5동","관내사전투표","대통령선거","인천광역시","동구",1336,1336,580,287,279,75,102,1,0,0,0,5,4,0,0,1333,3,0
"11070","송림3·5동","송림3·5동제1투","대통령선거","인천광역시","동구",2645,1672,482,580,432,72,77,2,1,3,0,3,0,3,3,1658,14,973
"11071","송림3·5동","송림3·5동제2투","대통령선거","인천광역시","동구",3014,2087,856,416,506,115,177,2,1,3,0,1,0,1,2,2080,7,927
"11072","송림4동","관내사전투표","대통령선거","인천광역시","동구",716,716,285,181,156,40,44,4,0,0,0,0,0,0,1,711,5,0
"11073","송림4동","송림4동제1투","대통령선거","인천광역시","동구",653,333,86,114,88,24,17,1,0,0,1,0,0,1,1,333,0,320
"11074","송림4동","송림4동제2투","대통령선거","인천광역시","동구",2166,1622,660,326,401,101,115,3,3,1,1,2,0,2,2,1617,5,544
"11075","송림6동","관내사전투표","대통령선거","인천광역시","동구",872,872,375,184,182,45,78,1,0,1,0,0,0,1,2,869,3,0
"11076","송림6동","송림6동제1투","대통령선거","인천광역시","동구",1593,992,305,343,246,33,51,3,0,0,0,2,1,1,2,987,5,601
"11077","송림6동","송림6동제2투","대통령선거","인천광역시","동구",3152,2317,974,469,530,151,182,1,1,0,1,0,0,1,0,2310,7,835
"11078","금창동","관내사전투표","대통령선거","인천광역시","동구",650,650,240,204,131,24,45,0,1,1,1,2,0,0,0,649,1,0
"11079","금창동","금창동제1투","대통령선거","인천광역시","동구",1122,646,208,218,164,26,20,1,0,3,0,0,0,1,0,641,5,476
"11080","금창동","금창동제2투","대통령선거","인천광역시","동구",1171,764,222,270,176,35,56,0,1,1,1,0,0,1,0,763,1,407
"11081","잘못 투입·구분된 투표지","잘못 투입·구분된 투표지","대통령선거","인천광역시","동구",0,0,0,0,0,0,0,0,0,0,0,0,0,0,0,0,0,0
"11082","거소·선상투표","거소·선상투표","대통령선거","인천광역시","남구",679,626,232,110,196,34,26,3,3,0,0,0,5,2,1,612,14,53
"11083","관외사전투표","관외사전투표","대통령선거","인천광역시","남구",25549,25547,11537,4003,5650,1848,2177,35,10,26,8,17,15,9,34,25369,178,2
"11084","재외투표","재외투표","대통령선거","인천광역시","남구",1791,1340,808,102,222,55,144,6,0,0,0,0,0,0,1,1338,2,451
"11085","숭의1·3동","관내사전투표","대통령선거","인천광역시","남구",1652,1652,600,471,322,94,146,4,1,0,1,4,0,3,0,1646,6,0
"11086","숭의1·3동","숭의1·3동제1투","대통령선거","인천광역시","남구",2579,1456,523,405,365,69,80,1,0,2,0,1,1,0,1,1448,8,1123
"11087","숭의1·3동","숭의1·3동제2투","대통령선거","인천광역시","남구",3084,1827,635,506,424,115,131,6,0,0,0,0,1,2,1,1821,6,1257
"11088","숭의1·3동","숭의1·3동제3투","대통령선거","인천광역시","남구",2396,1397,499,374,342,82,91,1,1,1,0,0,0,1,0,1392,5,999
"11089","숭의2동","관내사전투표","대통령선거","인천광역시","남구",2596,2596,1009,646,579,126,216,6,0,1,0,1,0,0,1,2585,11,0
"11090","숭의2동","숭의2동제1투","대통령선거","인천광역시","남구",3120,1737,570,497,427,107,125,1,1,2,1,0,0,0,1,1732,5,1383
"11091","숭의2동","숭의2동제2투","대통령선거","인천광역시","남구",2809,1700,580,468,427,81,126,4,0,2,0,0,2,1,0,1691,9,1109
"11092","숭의2동","숭의2동제3투","대통령선거","인천광역시","남구",2616,1466,427,440,421,70,98,2,0,0,0,2,0,0,2,1462,4,1150
"11093","숭의4동","관내사전투표","대통령선거","인천광역시","남구",2217,2217,853,577,477,139,150,2,0,1,0,1,1,1,4,2206,11,0
"11094","숭의4동","숭의4동제1투","대통령선거","인천광역시","남구",4436,2713,926,688,728,149,201,5,1,1,0,5,0,2,0,2706,7,1723
"11095","숭의4동","숭의4동제2투","대통령선거","인천광역시","남구",2937,1732,541,562,416,92,100,4,0,2,0,2,1,0,2,1722,10,1205
"11096","숭의4동","숭의4동제3투","대통령선거","인천광역시","남구",3288,2106,696,603,534,111,148,2,0,2,0,0,1,1,4,2102,4,1182
"11097","용현1·4동","관내사전투표","대통령선거","인천광역시","남구",1609,1609,595,394,361,118,130,1,0,1,0,1,0,0,1,1602,7,0
"11098","용현1·4동","용현1·4동제1투","대통령선거","인천광역시","남구",2537,1355,391,400,390,67,83,0,1,5,0,1,3,2,0,1343,12,1182
"11099","용현1·4동","용현1·4동제2투","대통령선거","인천광역시","남구",2502,1527,460,496,385,71,97,3,1,2,1,2,0,1,3,1522,5,975
"11100","용현1·4동","용현1·4동제3투","대통령선거","인천광역시","남구",3316,2183,747,632,511,134,139,4,0,1,0,0,0,1,4,2173,10,1133
"11101","용현1·4동","용현1·4동제4투","대통령선거","인천광역시","남구",1722,1220,398,331,285,106,91,1,0,1,0,0,0,1,1,1215,5,502
"11102","용현1·4동","용현1·4동제5투","대통령선거","인천광역시","남구",2481,1647,566,437,411,110,108,4,1,1,0,1,0,0,0,1639,8,834
"11103","용현2동","관내사전투표","대통령선거","인천광역시","남구",2032,2032,821,520,412,115,155,0,0,2,0,0,0,0,1,2026,6,0
"11104","용현2동","용현2동제1투","대통령선거","인천광역시","남구",1987,1327,481,292,354,87,104,1,0,1,0,1,0,0,1,1322,5,660
"11105","용현2동","용현2동제2투","대통령선거","인천광역시","남구",3182,2021,705,522,491,136,151,1,0,3,0,0,0,1,3,2013,8,1161
"11106","용현2동","용현2동제3투","대통령선거","인천광역시","남구",3628,2648,928,653,667,172,206,7,0,2,0,2,1,0,1,2639,9,980
"11107","용현3동","관내사전투표","대통령선거","인천광역시","남구",1680,1680,581,510,390,73,109,5,0,1,0,0,0,4,2,1675,5,0
"11108","용현3동","용현3동제1투","대통령선거","인천광역시","남구",2985,1588,436,534,415,81,106,2,0,2,0,1,1,1,4,1583,5,1397
"11109","용현3동","용현3동제2투","대통령선거","인천광역시","남구",2728,1655,484,532,436,84,101,3,0,5,0,1,0,1,1,1648,7,1073
"11110","용현5동","관내사전투표","대통령선거","인천광역시","남구",6079,6079,2661,1205,1369,372,433,7,0,2,0,1,0,2,5,6057,22,0
"11111","용현5동","용현5동제1투","대통령선거","인천광역시","남구",3160,2012,744,490,474,126,167,2,0,2,1,0,0,1,1,2008,4,1148
"11112","용현5동","용현5동제2투","대통령선거","인천광역시","남구",3480,2047,681,516,550,126,153,3,0,0,0,1,0,0,1,2031,16,1433
"11113","용현5동","용현5동제3투","대통령선거","인천광역시","남구",3033,2000,737,464,480,158,144,3,0,6,0,1,0,0,1,1994,6,1033
"11114","용현5동","용현5동제4투","대통령선거","인천광역시","남구",3474,1941,664,469,530,116,143,4,0,4,0,2,1,0,1,1934,7,1533
"11115","용현5동","용현5동제5투","대통령선거","인천광역시","남구",3429,2420,932,582,562,157,177,5,0,0,0,0,0,0,1,2416,4,1009
"11116","용현5동","용현5동제6투","대통령선거","인천광역시","남구",3323,2429,824,621,584,170,214,7,0,0,0,1,1,0,0,2422,7,894
"11117","용현5동","용현5동제7투","대통령선거","인천광역시","남구",2751,2033,819,400,507,136,161,1,0,0,0,4,0,0,0,2028,5,718
"11118","용현5동","용현5동제8투","대통령선거","인천광역시","남구",3123,2431,1025,403,645,176,171,4,0,1,1,0,2,1,1,2430,1,692
"11119","용현5동","용현5동제9투","대통령선거","인천광역시","남구",2936,2226,941,362,571,186,150,1,0,0,1,0,1,3,4,2220,6,710
"11120","학익1동","관내사전투표","대통령선거","인천광역시","남구",4124,4124,1801,849,862,253,330,7,0,7,0,1,1,1,1,4113,11,0
"11121","학익1동","학익1동제1투","대통령선거","인천광역시","남구",3734,2570,839,725,706,145,142,2,0,3,1,0,1,0,0,2564,6,1164
"11122","학익1동","학익1동제2투","대통령선거","인천광역시","남구",2558,1523,538,364,383,104,113,3,1,1,1,0,0,1,1,1510,13,1035
"11123","학익1동","학익1동제3투","대통령선거","인천광역시","남구",2948,2321,813,625,565,157,154,1,1,1,0,0,0,0,1,2318,3,627
"11124","학익1동","학익1동제4투","대통령선거","인천광역시","남구",3205,2247,874,524,552,131,143,6,1,2,1,2,0,3,1,2240,7,958
"11125","학익1동","학익1동제5투","대통령선거","인천광역시","남구",2577,1715,624,429,414,100,133,3,0,3,0,3,1,1,1,1712,3,862
"11126","학익1동","학익1동제6투","대통령선거","인천광역시","남구",2457,1694,632,398,435,98,114,5,0,1,1,2,1,1,2,1690,4,763
"11127","학익1동","학익1동제7투","대통령선거","인천광역시","남구",3887,3240,1370,648,750,224,234,1,0,1,1,1,0,0,2,3232,8,647
"11128","학익2동","관내사전투표","대통령선거","인천광역시","남구",3235,3235,1312,742,697,209,251,8,1,5,0,2,0,0,1,3228,7,0
"11129","학익2동","학익2동제1투","대통령선거","인천광역시","남구",2487,1440,469,364,400,99,88,6,0,5,1,0,0,0,1,1433,7,1047
"11130","학익2동","학익2동제2투","대통령선거","인천광역시","남구",2352,1321,423,313,383,80,104,1,2,2,0,1,1,0,1,1311,10,1031
"11131","학익2동","학익2동제3투","대통령선거","인천광역시","남구",2656,1863,708,457,441,120,126,2,1,2,0,0,0,0,0,1857,6,793
"11132","학익2동","학익2동제4투","대통령선거","인천광역시","남구",2858,2270,778,614,565,163,136,0,0,2,1,0,1,1,4,2265,5,588
"11133","학익2동","학익2동제5투","대통령선거","인천광역시","남구",2895,2250,823,557,546,151,162,1,0,0,0,1,0,0,0,2241,9,645
"11134","도화1동","관내사전투표","대통령선거","인천광역시","남구",2686,2685,1081,703,543,148,185,2,0,9,1,0,1,1,1,2675,10,1
"11135","도화1동","도화1동제1투","대통령선거","인천광역시","남구",4026,2244,795,607,539,127,161,2,5,2,0,0,0,1,1,2240,4,1782
"11136","도화1동","도화1동제2투","대통령선거","인천광역시","남구",3724,2172,809,508,524,117,196,4,0,3,0,1,3,0,1,2166,6,1552
"11137","도화1동","도화1동제3투","대통령선거","인천광역시","남구",3301,2241,830,590,558,128,120,3,1,1,0,1,0,2,2,2236,5,1060
"11138","도화1동","도화1동제4투","대통령선거","인천광역시","남구",3478,2077,746,552,479,119,168,1,0,2,0,2,0,1,0,2070,7,1401
"11139","도화2·3동","관내사전투표","대통령선거","인천광역시","남구",2418,2418,970,602,540,122,168,6,0,1,0,1,0,1,3,2414,4,0
"11140","도화2·3동","도화2·3동제1투","대통령선거","인천광역시","남구",1962,880,296,239,217,42,76,0,1,2,2,0,0,0,1,876,4,1082
"11141","도화2·3동","도화2·3동제2투","대통령선거","인천광역시","남구",3212,2012,687,531,510,122,146,2,0,4,2,1,0,0,2,2007,5,1200
"11142","도화2·3동","도화2·3동제3투","대통령선거","인천광역시","남구",3051,2103,744,522,554,104,155,2,0,0,0,2,1,3,2,2089,14,948
"11143","도화2·3동","도화2·3동제4투","대통령선거","인천광역시","남구",3038,1924,708,534,434,121,110,2,0,3,0,1,2,1,0,1916,8,1114
"11144","도화2·3동","도화2·3동제5투","대통령선거","인천광역시","남구",1981,1173,337,366,311,74,77,1,0,1,1,1,0,1,0,1170,3,808
"11145","주안1동","관내사전투표","대통령선거","인천광역시","남구",2417,2417,1165,320,496,185,239,0,1,1,1,0,0,0,1,2409,8,0
"11146","주안1동","주안1동제1투","대통령선거","인천광역시","남구",4034,2109,884,389,521,129,162,7,1,2,0,2,0,0,3,2100,9,1925
"11147","주안1동","주안1동제2투","대통령선거","인천광역시","남구",4483,2464,935,543,605,145,213,0,0,4,1,2,0,0,3,2451,13,2019
"11148","주안1동","주안1동제3투","대통령선거","인천광역시","남구",4138,2211,911,430,548,134,167,8,0,4,0,1,1,0,1,2205,6,1927
"11149","주안2동","관내사전투표","대통령선거","인천광역시","남구",2600,2600,975,729,554,148,173,5,1,1,1,0,1,2,1,2591,9,0
"11150","주안2동","주안2동제1투","대통령선거","인천광역시","남구",3265,1822,622,557,457,83,84,3,0,4,1,0,1,0,3,1815,7,1443
"11151","주안2동","주안2동제2투","대통령선거","인천광역시","남구",3239,1985,626,581,519,108,131,2,0,3,1,0,2,0,3,1976,9,1254
"11152","주안2동","주안2동제3투","대통령선거","인천광역시","남구",2521,1594,546,430,425,88,94,2,1,2,0,0,1,1,1,1591,3,927
"11153","주안2동","주안2동제4투","대통령선거","인천광역시","남구",3033,1834,598,558,456,101,100,8,2,1,1,0,0,1,0,1826,8,1199
"11154","주안2동","주안2동제5투","대통령선거","인천광역시","남구",3171,1921,670,517,493,116,106,3,0,4,1,2,1,0,1,1914,7,1250
"11155","주안3동","관내사전투표","대통령선거","인천광역시","남구",1221,1221,484,278,290,66,92,0,0,1,0,0,0,1,2,1214,7,0
"11156","주안3동","주안3동제1투","대통령선거","인천광역시","남구",2407,1372,445,389,341,86,89,1,0,2,0,0,1,3,4,1361,11,1035
"11157","주안3동","주안3동제2투","대통령선거","인천광역시","남구",2953,1907,612,553,492,104,123,6,0,7,0,1,0,0,1,1899,8,1046
"11158","주안3동","주안3동제3투","대통령선거","인천광역시","남구",2425,1569,515,473,405,77,87,3,1,1,0,0,0,0,3,1565,4,856
"11159","주안4동","관내사전투표","대통령선거","인천광역시","남구",2136,2136,853,538,462,120,136,1,2,3,1,3,1,0,6,2126,10,0
"11160","주안4동","주안4동제1투","대통령선거","인천광역시","남구",3180,1871,615,506,492,103,138,5,1,0,0,1,2,2,3,1868,3,1309
"11161","주안4동","주안4동제2투","대통령선거","인천광역시","남구",2986,1873,611,576,458,102,108,4,0,1,0,1,0,1,5,1867,6,1113
"11162","주안4동","주안4동제3투","대통령선거","인천광역시","남구",2497,1598,472,539,402,85,83,1,1,0,3,5,0,0,1,1592,6,899
"11163","주안4동","주안4동제4투","대통령선거","인천광역시","남구",2649,1689,507,569,421,82,94,1,0,2,0,1,1,2,2,1682,7,960
"11164","주안4동","주안4동제5투","대통령선거","인천광역시","남구",2846,1764,566,547,450,86,102,1,0,0,0,3,0,0,1,1756,8,1082
"11165","주안5동","관내사전투표","대통령선거","인천광역시","남구",2986,2986,1340,561,666,176,212,3,0,4,1,3,2,0,8,2976,10,0
"11166","주안5동","주안5동제1투","대통령선거","인천광역시","남구",2874,1775,629,436,459,106,122,5,0,2,0,2,2,2,1,1766,9,1099
"11167","주안5동","주안5동제2투","대통령선거","인천광역시","남구",3447,2195,847,479,599,129,119,1,1,1,0,1,1,2,2,2182,13,1252
"11168","주안5동","주안5동제3투","대통령선거","인천광역시","남구",2254,1478,515,398,364,106,84,1,1,1,1,0,0,0,3,1474,4,776
"11169","주안5동","주안5동제4투","대통령선거","인천광역시","남구",2681,1597,608,387,388,92,108,1,1,0,2,1,1,1,1,1591,6,1084
"11170","주안5동","주안5동제5투","대통령선거","인천광역시","남구",3139,2217,849,483,564,130,172,5,1,1,0,0,1,0,2,2208,9,922
"11171","주안6동","관내사전투표","대통령선거","인천광역시","남구",3492,3492,1584,690,764,220,217,1,0,1,0,1,0,3,3,3484,8,0
"11172","주안6동","주안6동제1투","대통령선거","인천광역시","남구",2699,1628,640,324,410,95,140,4,1,3,0,1,1,0,1,1620,8,1071
"11173","주안6동","주안6동제2투","대통령선거","인천광역시","남구",4248,2401,907,559,613,133,172,2,0,2,0,1,0,2,0,2391,10,1847
"11174","주안6동","주안6동제3투","대통령선거","인천광역시","남구",2368,1405,469,412,326,116,75,0,0,0,0,1,0,0,0,1399,6,963
"11175","주안6동","주안6동제4투","대통령선거","인천광역시","남구",2315,1748,689,392,429,125,96,3,0,1,0,0,0,0,1,1736,12,567
"11176","주안6동","주안6동제5투","대통령선거","인천광역시","남구",2786,2005,880,417,456,135,107,4,0,2,0,1,0,0,1,2003,2,781
"11177","주안7동","관내사전투표","대통령선거","인천광역시","남구",3048,3048,1199,748,662,181,233,5,0,5,0,3,1,0,0,3037,11,0
"11178","주안7동","주안7동제1투","대통령선거","인천광역시","남구",2526,1702,554,500,417,94,120,5,0,1,0,1,1,1,3,1697,5,824
"11179","주안7동","주안7동제2투","대통령선거","인천광역시","남구",2651,1727,600,388,511,98,114,3,0,4,0,1,1,0,2,1722,5,924
"11180","주안7동","주안7동제3투","대통령선거","인천광역시","남구",2249,1245,405,344,337,64,82,1,0,3,0,0,2,0,1,1239,6,1004
"11181","주안7동","주안7동제4투","대통령선거","인천광역시","남구",2297,1489,502,396,391,72,113,1,1,2,0,4,0,0,1,1483,6,808
"11182","주안8동","관내사전투표","대통령선거","인천광역시","남구",2379,2379,1066,474,464,152,205,2,0,1,0,0,0,2,3,2369,10,0
"11183","주안8동","주안8동제1투","대통령선거","인천광역시","남구",2817,1623,612,352,406,101,130,6,0,1,0,3,1,0,2,1614,9,1194
"11184","주안8동","주안8동제2투","대통령선거","인천광역시","남구",2023,1290,498,301,330,61,83,2,0,6,0,2,0,3,3,1289,1,733
"11185","주안8동","주안8동제3투","대통령선거","인천광역시","남구",3049,2051,707,516,531,129,135,8,0,2,0,5,2,0,2,2037,14,998
"11186","주안8동","주안8동제4투","대통령선거","인천광역시","남구",3118,2345,948,496,562,154,177,0,2,1,0,1,0,0,2,2343,2,773
"11187","주안8동","주안8동제5투","대통령선거","인천광역시","남구",4050,2892,1035,779,723,168,170,3,1,2,0,0,0,0,3,2884,8,1158
"11188","관교동","관내사전투표","대통령선거","인천광역시","남구",2930,2930,1136,677,654,212,225,3,0,6,2,3,1,1,2,2922,8,0
"11189","관교동","관교동제1투","대통령선거","인천광역시","남구",2710,2027,679,609,446,161,116,4,0,1,0,1,0,0,1,2018,9,683
"11190","관교동","관교동제2투","대통령선거","인천광역시","남구",2326,1510,516,421,368,78,116,1,0,0,0,0,2,0,1,1503,7,816
"11191","관교동","관교동제3투","대통령선거","인천광역시","남구",2313,1695,639,458,375,107,101,5,0,1,0,2,0,0,1,1689,6,618
"11192","관교동","관교동제4투","대통령선거","인천광역시","남구",3062,2022,801,431,497,123,155,4,0,3,0,0,0,0,1,2015,7,1040
"11193","문학동","관내사전투표","대통령선거","인천광역시","남구",2286,2286,993,476,515,124,154,2,0,3,0,1,0,1,0,2269,17,0
"11194","문학동","문학동제1투","대통령선거","인천광역시","남구",3344,1613,597,365,426,91,121,1,2,1,0,2,1,1,1,1609,4,1731
"11195","문학동","문학동제2투","대통령선거","인천광역시","남구",3030,1683,635,343,451,110,135,0,1,2,0,0,0,1,4,1682,1,1347
"11196","문학동","문학동제3투","대통령선거","인천광역시","남구",3029,1615,583,389,425,95,105,4,0,3,0,3,0,0,2,1609,6,1414
"11197","잘못 투입·구분된 투표지","잘못 투입·구분된 투표지","대통령선거","인천광역시","남구",0,0,0,0,0,0,0,0,0,0,0,0,0,0,0,0,0,0
"11198","거소·선상투표","거소·선상투표","대통령선거","인천광역시","연수구",668,632,216,84,221,41,21,2,1,2,3,1,3,0,4,599,33,36
"11199","관외사전투표","관외사전투표","대통령선거","인천광역시","연수구",20909,20906,9295,3244,4593,1816,1744,18,4,12,4,15,8,13,32,20798,108,3
"11200","재외투표","재외투표","대통령선거","인천광역시","연수구",2056,1629,999,109,265,72,174,4,1,1,0,1,0,0,0,1626,3,427
"11201","옥련1동","관내사전투표","대통령선거","인천광역시","연수구",2198,2198,896,544,449,128,159,2,3,5,0,3,0,2,2,2193,5,0
"11202","옥련1동","옥련1동제1투","대통령선거","인천광역시","연수구",2883,1918,679,431,480,151,161,2,0,5,0,1,1,0,0,1911,7,965
"11203","옥련1동","옥련1동제2투","대통령선거","인천광역시","연수구",1739,1099,329,347,271,67,77,0,0,1,0,1,1,0,1,1095,4,640
"11204","옥련1동","옥련1동제3투","대통령선거","인천광역시","연수구",2757,1663,509,507,417,93,114,7,0,3,1,2,3,1,0,1657,6,1094
"11205","옥련1동","옥련1동제4투","대통령선거","인천광역시","연수구",2887,2129,795,447,556,152,168,0,0,1,0,0,1,2,2,2124,5,758
"11206","옥련1동","옥련1동제5투","대통령선거","인천광역시","연수구",3143,2323,916,504,559,169,161,2,0,1,1,0,0,0,1,2314,9,820
"11207","옥련2동","관내사전투표","대통령선거","인천광역시","연수구",4648,4648,2045,911,942,324,392,2,0,9,1,3,1,1,1,4632,16,0
"11208","옥련2동","옥련2동제1투","대통령선거","인천광역시","연수구",2566,1598,560,423,380,95,121,2,0,4,0,1,1,1,5,1593,5,968
"11209","옥련2동","옥련2동제2투","대통령선거","인천광역시","연수구",2022,1317,486,329,320,90,85,0,0,2,0,0,0,0,0,1312,5,705
"11210","옥련2동","옥련2동제3투","대통령선거","인천광역시","연수구",3244,2417,845,603,585,188,175,2,0,4,0,2,0,0,0,2404,13,827
"11211","옥련2동","옥련2동제4투","대통령선거","인천광역시","연수구",2695,1845,767,361,453,113,138,0,0,1,0,0,0,1,1,1835,10,850
"11212","옥련2동","옥련2동제5투","대통령선거","인천광역시","연수구",2796,2145,852,409,560,170,144,3,0,2,0,0,0,1,1,2142,3,651
"11213","선학동","관내사전투표","대통령선거","인천광역시","연수구",2770,2770,1206,600,540,189,199,9,1,4,2,0,2,1,2,2755,15,0
"11214","선학동","선학동제1투","대통령선거","인천광역시","연수구",2255,1556,585,383,356,121,98,1,1,1,0,0,0,0,1,1547,9,699
"11215","선학동","선학동제2투","대통령선거","인천광역시","연수구",2607,1999,734,497,520,120,120,0,0,0,1,0,1,1,0,1994,5,608
"11216","선학동","선학동제3투","대통령선거","인천광역시","연수구",3236,2211,800,535,566,147,150,1,0,4,0,0,1,0,2,2206,5,1025
"11217","선학동","선학동제4투","대통령선거","인천광역시","연수구",2005,969,329,248,248,75,57,0,0,3,0,2,1,0,1,964,5,1036
"11218","선학동","선학동제5투","대통령선거","인천광역시","연수구",2661,1694,581,428,440,115,103,8,1,1,4,2,1,0,2,1686,8,967
"11219","연수1동","관내사전투표","대통령선거","인천광역시","연수구",3278,3278,1415,629,716,207,280,4,1,5,0,4,2,2,2,3267,11,0
"11220","연수1동","연수1동제1투","대통령선거","인천광역시","연수구",2703,1758,683,370,431,118,145,5,0,0,0,0,0,0,0,1752,6,945
"11221","연수1동","연수1동제2투","대통령선거","인천광역시","연수구",2563,1809,685,390,433,141,134,5,0,2,0,5,2,3,1,1801,8,754
"11222","연수1동","연수1동제3투","대통령선거","인천광역시","연수구",2713,1839,640,458,474,133,118,2,1,4,1,1,0,1,4,1837,2,874
"11223","연수1동","연수1동제4투","대통령선거","인천광역시","연수구",2656,1028,380,266,249,62,65,0,0,2,1,0,1,0,0,1026,2,1628
"11224","연수1동","연수1동제5투","대통령선거","인천광역시","연수구",2540,1449,519,336,379,97,103,2,0,2,0,1,0,0,1,1440,9,1091
"11225","연수1동","연수1동제6투","대통령선거","인천광역시","연수구",2624,1190,427,296,288,64,101,2,0,0,2,1,2,0,0,1183,7,1434
"11226","연수2동","관내사전투표","대통령선거","인천광역시","연수구",3371,3370,1527,609,664,247,294,5,0,6,1,1,3,0,2,3359,11,1
"11227","연수2동","연수2동제1투","대통령선거","인천광역시","연수구",2732,2003,746,451,481,175,142,1,1,1,0,0,0,0,0,1998,5,729
"11228","연수2동","연수2동제2투","대통령선거","인천광역시","연수구",2724,2182,921,440,502,164,143,3,0,1,1,0,2,1,1,2179,3,542
"11229","연수2동","연수2동제3투","대통령선거","인천광역시","연수구",2790,1910,632,521,524,103,101,6,2,3,0,0,0,2,4,1898,12,880
"11230","연수2동","연수2동제4투","대통령선거","인천광역시","연수구",2055,1643,715,255,384,135,142,2,0,2,0,0,0,1,2,1638,5,412
"11231","연수2동","연수2동제5투","대통령선거","인천광역시","연수구",2772,1946,761,386,484,154,147,4,1,1,0,2,0,0,3,1943,3,826
"11232","연수2동","연수2동제6투","대통령선거","인천광역시","연수구",1665,1033,376,255,233,80,83,2,0,1,0,0,0,0,0,1030,3,632
"11233","연수3동","관내사전투표","대통령선거","인천광역시","연수구",2844,2844,1240,516,640,192,223,8,3,5,0,1,0,1,6,2835,9,0
"11234","연수3동","연수3동제1투","대통령선거","인천광역시","연수구",2593,1988,802,434,469,125,144,2,0,2,0,2,1,1,0,1982,6,605
"11235","연수3동","연수3동제2투","대통령선거","인천광역시","연수구",2532,1789,755,334,425,119,143,2,0,0,0,2,0,0,3,1783,6,743
"11236","연수3동","연수3동제3투","대통령선거","인천광역시","연수구",2528,1869,697,412,461,144,140,1,0,1,0,3,1,0,1,1861,8,659
"11237","연수3동","연수3동제4투","대통령선거","인천광역시","연수구",2059,1223,410,362,279,74,74,4,1,1,1,0,3,0,3,1212,11,836
"11238","연수3동","연수3동제5투","대통령선거","인천광역시","연수구",2226,1667,655,317,454,118,113,0,0,2,0,0,1,1,1,1662,5,559
"11239","청학동","관내사전투표","대통령선거","인천광역시","연수구",3336,3336,1395,799,691,196,219,6,0,10,0,2,0,2,3,3323,13,0
"11240","청학동","청학동제1투","대통령선거","인천광역시","연수구",3440,2106,748,576,503,102,151,5,0,5,1,0,1,1,1,2094,12,1334
"11241","청학동","청학동제2투","대통령선거","인천광역시","연수구",2229,1637,681,354,365,112,111,5,0,1,0,1,1,0,2,1633,4,592
"11242","청학동","청학동제3투","대통령선거","인천광역시","연수구",2549,1883,729,455,453,103,120,3,1,1,1,4,0,1,1,1872,11,666
"11243","청학동","청학동제4투","대통령선거","인천광역시","연수구",3157,2003,692,475,521,151,149,4,0,6,0,0,1,0,2,2001,2,1154
"11244","청학동","청학동제5투","대통령선거","인천광역시","연수구",2901,1855,657,484,461,103,125,5,4,4,0,1,0,0,3,1847,8,1046
"11245","청학동","청학동제6투","대통령선거","인천광역시","연수구",2556,1602,558,426,391,87,119,2,0,4,1,1,2,1,0,1592,10,954
"11246","청학동","청학동제7투","대통령선거","인천광역시","연수구",2209,1329,437,392,327,89,68,1,0,2,0,2,0,0,1,1319,10,880
"11247","동춘1동","관내사전투표","대통령선거","인천광역시","연수구",2977,2977,1349,500,598,243,257,5,1,4,1,4,0,0,1,2963,14,0
"11248","동춘1동","동춘1동제1투","대통령선거","인천광역시","연수구",1129,636,223,183,143,42,36,4,0,0,1,1,0,1,1,635,1,493
"11249","동춘1동","동춘1동제2투","대통령선거","인천광역시","연수구",2648,2047,846,401,466,148,172,1,0,1,1,0,0,2,0,2038,9,601
"11250","동춘1동","동춘1동제3투","대통령선거","인천광역시","연수구",2330,1699,672,372,385,122,137,2,0,0,0,1,0,1,1,1693,6,631
"11251","동춘1동","동춘1동제4투","대통령선거","인천광역시","연수구",2839,2142,793,482,534,175,142,7,0,0,1,0,0,1,0,2135,7,697
"11252","동춘2동","관내사전투표","대통령선거","인천광역시","연수구",3248,3248,1509,510,707,227,265,2,0,2,2,1,1,0,2,3228,20,0
"11253","동춘2동","동춘2동제1투","대통령선거","인천광역시","연수구",2631,1889,787,323,478,133,155,2,1,3,0,1,0,0,2,1885,4,742
"11254","동춘2동","동춘2동제2투","대통령선거","인천광역시","연수구",2828,2234,945,446,482,188,159,2,0,3,2,0,1,1,1,2230,4,594
"11255","동춘2동","동춘2동제3투","대통령선거","인천광역시","연수구",2767,2132,909,384,510,144,167,7,1,2,0,2,0,0,1,2127,5,635
"11256","동춘2동","동춘2동제4투","대통령선거","인천광역시","연수구",3378,2582,1044,518,594,204,206,7,0,1,0,0,0,0,0,2574,8,796
"11257","동춘3동","관내사전투표","대통령선거","인천광역시","연수구",3301,3301,1441,663,641,256,276,5,1,2,0,1,0,4,3,3293,8,0
"11258","동춘3동","동춘3동제1투","대통령선거","인천광역시","연수구",2522,1976,733,466,466,163,135,2,0,1,0,0,0,0,1,1967,9,546
"11259","동춘3동","동춘3동제2투","대통령선거","인천광역시","연수구",2737,2166,861,488,498,169,143,3,0,1,1,0,0,0,0,2164,2,571
"11260","동춘3동","동춘3동제3투","대통령선거","인천광역시","연수구",3033,2382,915,521,593,180,155,4,0,3,0,1,0,1,1,2374,8,651
"11261","동춘3동","동춘3동제4투","대통령선거","인천광역시","연수구",2320,1839,795,334,423,149,124,2,0,1,0,1,1,1,1,1832,7,481
"11262","송도1동","관내사전투표","대통령선거","인천광역시","연수구",5144,5143,2332,947,979,458,377,15,0,15,0,2,0,0,5,5130,13,1
"11263","송도1동","송도1동제1투","대통령선거","인천광역시","연수구",2604,2066,918,386,468,149,131,5,0,2,0,0,0,0,1,2060,6,538
"11264","송도1동","송도1동제2투","대통령선거","인천광역시","연수구",2637,2100,775,509,488,199,118,3,0,2,0,1,0,0,0,2095,5,537
"11265","송도1동","송도1동제3투","대통령선거","인천광역시","연수구",2618,2072,897,363,511,166,119,4,0,5,0,1,0,1,0,2067,5,546
"11266","송도1동","송도1동제4투","대통령선거","인천광역시","연수구",2309,1854,761,394,425,154,108,2,0,1,0,2,0,0,0,1847,7,455
"11267","송도1동","송도1동제5투","대통령선거","인천광역시","연수구",2555,2105,785,519,500,164,129,2,0,3,0,1,0,0,0,2103,2,450
"11268","송도1동","송도1동제6투","대통령선거","인천광역시","연수구",2580,2103,893,431,505,167,97,0,0,4,0,2,0,0,1,2100,3,477
"11269","송도1동","송도1동제7투","대통령선거","인천광역시","연수구",3269,2527,872,670,615,227,132,1,0,1,1,0,1,2,0,2522,5,742
"11270","송도2동","관내사전투표","대통령선거","인천광역시","연수구",5792,5792,2788,984,1118,531,336,14,0,5,0,2,1,1,2,5782,10,0
"11271","송도2동","송도2동제1투","대통령선거","인천광역시","연수구",2143,1714,743,252,414,172,116,2,0,6,0,3,0,1,0,1709,5,429
"11272","송도2동","송도2동제2투","대통령선거","인천광역시","연수구",2887,2238,892,458,578,190,110,2,0,1,1,0,0,1,0,2233,5,649
"11273","송도2동","송도2동제3투","대통령선거","인천광역시","연수구",3250,2364,885,542,580,229,116,4,0,2,0,1,0,1,1,2361,3,886
"11274","송도2동","송도2동제4투","대통령선거","인천광역시","연수구",2184,1703,806,242,397,147,102,4,0,1,0,0,0,1,1,1701,2,481
"11275","송도2동","송도2동제5투","대통령선거","인천광역시","연수구",2325,1873,760,339,501,164,100,1,0,2,0,1,1,1,1,1871,2,452
"11276","송도2동","송도2동제6투","대통령선거","인천광역시","연수구",2976,2324,967,439,573,191,136,7,0,1,0,3,0,1,0,2318,6,652
"11277","송도2동","송도2동제7투","대통령선거","인천광역시","연수구",2905,2249,848,509,569,195,122,2,0,1,0,0,1,0,0,2247,2,656
"11278","송도2동","송도2동제8투","대통령선거","인천광역시","연수구",2002,1410,623,217,336,143,86,1,0,1,0,0,0,0,1,1408,2,592
"11279","송도2동","송도2동제9투","대통령선거","인천광역시","연수구",3110,2509,1106,434,610,211,133,5,0,2,0,2,0,0,1,2504,5,601
"11280","송도3동","관내사전투표","대통령선거","인천광역시","연수구",3943,3943,2015,529,792,330,269,2,0,1,2,0,0,0,0,3940,3,0
"11281","송도3동","송도3동제1투","대통령선거","인천광역시","연수구",3877,2908,1268,470,693,259,201,3,0,1,0,2,0,1,1,2899,9,969
"11282","송도3동","송도3동제2투","대통령선거","인천광역시","연수구",2571,2068,913,368,493,165,119,4,0,3,0,1,0,0,0,2066,2,503
"11283","송도3동","송도3동제3투","대통령선거","인천광역시","연수구",3366,2575,1055,487,657,217,146,2,0,0,0,0,0,1,1,2566,9,791
"11284","송도3동","송도3동제4투","대통령선거","인천광역시","연수구",2837,2267,997,397,566,180,113,5,0,3,0,0,0,0,1,2262,5,570
"11285","송도3동","송도3동제5투","대통령선거","인천광역시","연수구",1106,874,374,161,190,88,55,0,0,4,0,0,0,0,0,872,2,232
"11286","송도3동","송도3동제6투","대통령선거","인천광역시","연수구",1868,1497,748,182,364,121,77,2,0,0,0,0,0,1,0,1495,2,371
"11287","송도3동","송도3동제7투","대통령선거","인천광역시","연수구",1707,1412,703,158,323,137,87,0,1,0,0,0,0,0,0,1409,3,295
"11288","잘못 투입·구분된 투표지","잘못 투입·구분된 투표지","대통령선거","인천광역시","연수구",0,0,0,0,0,0,0,0,0,0,0,0,0,0,0,0,0,0
"11289","거소·선상투표","거소·선상투표","대통령선거","인천광역시","남동구",1007,956,360,149,299,66,28,0,2,4,3,1,3,0,7,922,34,51
"11290","관외사전투표","관외사전투표","대통령선거","인천광역시","남동구",32933,32928,15183,4898,7444,2381,2627,42,5,19,16,28,12,6,61,32722,206,5
"11291","재외투표","재외투표","대통령선거","인천광역시","남동구",2236,1743,1047,127,240,80,232,8,0,0,1,0,0,1,0,1736,7,493
"11292","구월1동","관내사전투표","대통령선거","인천광역시","남동구",4593,4592,2291,699,903,298,367,7,1,2,1,5,2,2,3,4581,11,1
"11293","구월1동","구월1동제1투","대통령선거","인천광역시","남동구",3228,1990,776,433,493,127,150,5,0,0,1,0,0,0,1,1986,4,1238
"11294","구월1동","구월1동제2투","대통령선거","인천광역시","남동구",2607,1629,601,372,424,75,140,4,0,4,1,0,0,3,2,1626,3,978
"11295","구월1동","구월1동제3투","대통령선거","인천광역시","남동구",2679,1937,664,497,511,135,111,2,0,5,1,1,1,0,2,1930,7,742
"11296","구월1동","구월1동제4투","대통령선거","인천광역시","남동구",2970,2006,689,472,521,133,173,1,0,2,0,5,1,1,0,1998,8,964
"11297","구월1동","구월1동제5투","대통령선거","인천광역시","남동구",3319,2522,1122,400,608,213,169,0,0,1,1,1,0,0,2,2517,5,797
"11298","구월1동","구월1동제6투","대통령선거","인천광역시","남동구",5014,4034,1865,537,985,344,287,4,0,1,0,3,0,0,2,4028,6,980
"11299","구월2동","관내사전투표","대통령선거","인천광역시","남동구",6112,6112,3018,1041,1138,420,458,6,0,3,0,6,0,1,2,6093,19,0
"11300","구월2동","구월2동제1투","대통령선거","인천광역시","남동구",2860,2062,899,393,479,172,111,1,0,0,2,0,0,0,1,2058,4,798
"11301","구월2동","구월2동제2투","대통령선거","인천광역시","남동구",3300,2653,1109,536,594,210,194,1,0,0,0,1,0,0,1,2646,7,647
"11302","구월2동","구월2동제3투","대통령선거","인천광역시","남동구",2847,2153,894,409,524,171,142,1,0,0,2,0,1,0,2,2146,7,694
"11303","구월2동","구월2동제4투","대통령선거","인천광역시","남동구",2899,2321,974,494,529,179,127,7,0,1,0,1,0,0,1,2313,8,578
"11304","구월2동","구월2동제5투","대통령선거","인천광역시","남동구",3240,2555,1074,492,646,172,154,3,0,1,0,3,1,0,0,2546,9,685
"11305","구월2동","구월2동제6투","대통령선거","인천광역시","남동구",2373,1631,622,396,373,109,112,5,1,1,0,3,0,0,2,1624,7,742
"11306","구월2동","구월2동제7투","대통령선거","인천광역시","남동구",2687,1766,566,476,498,103,113,3,0,2,0,0,0,1,0,1762,4,921
"11307","구월2동","구월2동제8투","대통령선거","인천광역시","남동구",2492,1669,653,373,405,120,97,3,1,4,0,4,0,0,1,1661,8,823
"11308","구월3동","관내사전투표","대통령선거","인천광역시","남동구",2570,2570,1212,419,534,165,207,9,1,0,0,5,0,2,1,2555,15,0
"11309","구월3동","구월3동제1투","대통령선거","인천광역시","남동구",2180,1312,483,312,316,82,111,2,0,1,1,0,1,1,0,1310,2,868
"11310","구월3동","구월3동제2투","대통령선거","인천광역시","남동구",2133,1342,522,248,364,83,108,2,1,3,1,0,1,1,4,1338,4,791
"11311","구월3동","구월3동제3투","대통령선거","인천광역시","남동구",2480,1609,588,459,370,102,77,3,0,2,0,2,0,0,1,1604,5,871
"11312","구월3동","구월3동제4투","대통령선거","인천광역시","남동구",2292,1470,514,411,352,103,76,0,0,1,0,3,0,1,3,1464,6,822
"11313","구월3동","구월3동제5투","대통령선거","인천광역시","남동구",3842,2061,1027,205,430,171,210,1,1,0,0,4,1,0,4,2054,7,1781
"11314","구월3동","구월3동제6투","대통령선거","인천광역시","남동구",3084,1622,722,290,327,121,147,1,1,2,1,1,0,0,1,1614,8,1462
"11315","구월3동","구월3동제7투","대통령선거","인천광역시","남동구",2467,1440,569,293,358,86,122,2,0,0,0,5,0,0,1,1436,4,1027
"11316","구월4동","관내사전투표","대통령선거","인천광역시","남동구",2324,2324,1009,454,551,135,155,2,0,1,1,1,1,0,2,2312,12,0
"11317","구월4동","구월4동제1투","대통령선거","인천광역시","남동구",2352,1243,419,288,363,73,86,0,0,1,0,2,0,0,3,1235,8,1109
"11318","구월4동","구월4동제2투","대통령선거","인천광역시","남동구",2318,1242,421,350,328,57,77,1,0,2,0,0,0,0,1,1237,5,1076
"11319","구월4동","구월4동제3투","대통령선거","인천광역시","남동구",2412,1459,495,366,385,79,117,4,0,2,0,0,2,0,2,1452,7,953
"11320","구월4동","구월4동제4투","대통령선거","인천광역시","남동구",2612,1531,560,377,410,68,107,3,1,0,0,1,0,0,1,1528,3,1081
"11321","구월4동","구월4동제5투","대통령선거","인천광역시","남동구",2202,1317,450,339,369,73,70,0,1,2,1,1,1,0,1,1308,9,885
"11322","간석1동","관내사전투표","대통령선거","인천광역시","남동구",3211,3211,1492,595,667,187,239,2,0,2,2,4,4,1,3,3198,13,0
"11323","간석1동","간석1동제1투","대통령선거","인천광역시","남동구",3743,2399,907,538,611,151,172,1,1,1,1,0,0,0,3,2386,13,1344
"11324","간석1동","간석1동제2투","대통령선거","인천광역시","남동구",4004,2230,789,628,526,125,141,3,1,5,0,0,1,0,4,2223,7,1774
"11325","간석1동","간석1동제3투","대통령선거","인천광역시","남동구",3038,2083,808,422,543,141,148,1,0,3,0,2,2,1,0,2071,12,955
"11326","간석1동","간석1동제4투","대통령선거","인천광역시","남동구",3199,2502,949,607,595,171,159,2,0,6,0,0,0,2,3,2494,8,697
"11327","간석1동","간석1동제5투","대통령선거","인천광역시","남동구",2551,1771,702,425,421,102,105,3,0,1,0,4,1,1,2,1767,4,780
"11328","간석2동","관내사전투표","대통령선거","인천광역시","남동구",2415,2415,979,473,628,136,181,7,0,4,0,0,0,0,1,2409,6,0
"11329","간석2동","간석2동제1투","대통령선거","인천광역시","남동구",2692,1437,467,380,367,97,114,3,1,1,0,1,1,0,1,1433,4,1255
"11330","간석2동","간석2동제2투","대통령선거","인천광역시","남동구",3801,2226,745,640,568,108,144,5,1,2,1,1,2,1,2,2220,6,1575
"11331","간석2동","간석2동제3투","대통령선거","인천광역시","남동구",3291,2710,1061,607,655,196,181,1,1,0,1,1,0,0,0,2704,6,581
"11332","간석2동","간석2동제4투","대통령선거","인천광역시","남동구",2899,2404,939,511,600,179,169,3,0,1,0,0,0,0,0,2402,2,495
"11333","간석2동","간석2동제5투","대통령선거","인천광역시","남동구",1904,1562,623,354,384,107,84,3,0,2,0,1,0,0,0,1558,4,342
"11334","간석3동","관내사전투표","대통령선거","인천광역시","남동구",3148,3148,1387,651,704,148,227,4,0,3,0,3,1,3,11,3142,6,0
"11335","간석3동","간석3동제1투","대통령선거","인천광역시","남동구",3950,2164,772,541,571,117,146,1,0,3,1,1,3,0,4,2160,4,1786
"11336","간석3동","간석3동제2투","대통령선거","인천광역시","남동구",3666,2632,1042,568,625,195,178,1,1,1,3,1,1,1,4,2621,11,1034
"11337","간석3동","간석3동제3투","대통령선거","인천광역시","남동구",3199,1758,578,428,504,105,124,2,0,1,1,3,1,0,3,1750,8,1441
"11338","간석3동","간석3동제4투","대통령선거","인천광역시","남동구",2842,2047,801,478,516,113,128,1,0,1,0,1,1,0,1,2041,6,795
"11339","간석3동","간석3동제5투","대통령선거","인천광역시","남동구",3600,2289,856,522,608,119,154,1,0,5,0,1,1,1,5,2273,16,1311
"11340","간석3동","간석3동제6투","대통령선거","인천광역시","남동구",1729,1162,402,318,301,58,70,2,1,1,0,0,0,0,0,1153,9,567
"11341","간석4동","관내사전투표","대통령선거","인천광역시","남동구",2404,2404,1102,501,485,139,160,5,0,1,0,2,0,1,0,2396,8,0
"11342","간석4동","간석4동제1투","대통령선거","인천광역시","남동구",2719,1630,580,443,381,99,110,0,3,1,0,0,2,1,2,1622,8,1089
"11343","간석4동","간석4동제2투","대통령선거","인천광역시","남동구",4460,2573,1017,561,647,162,162,1,1,2,2,3,0,1,3,2562,11,1887
"11344","간석4동","간석4동제3투","대통령선거","인천광역시","남동구",3438,2485,896,652,601,159,158,4,1,3,0,1,0,1,2,2478,7,953
"11345","간석4동","간석4동제4투","대통령선거","인천광역시","남동구",2800,2192,865,471,524,159,149,6,0,1,0,2,2,3,1,2183,9,608
"11346","간석4동","간석4동제5투","대통령선거","인천광역시","남동구",2622,1729,704,365,408,107,136,2,0,1,0,1,0,0,1,1725,4,893
"11347","간석4동","간석4동제6투","대통령선거","인천광역시","남동구",2074,1565,646,347,353,103,107,0,0,1,0,0,0,0,1,1558,7,509
"11348","만수1동","관내사전투표","대통령선거","인천광역시","남동구",2498,2498,1090,506,530,130,212,5,1,3,0,4,1,0,1,2483,15,0
"11349","만수1동","만수1동제1투","대통령선거","인천광역시","남동구",2567,1709,678,347,449,99,125,2,0,2,1,1,0,0,1,1705,4,858
"11350","만수1동","만수1동제2투","대통령선거","인천광역시","남동구",2491,1409,508,341,360,72,96,12,1,6,0,0,0,0,5,1401,8,1082
"11351","만수1동","만수1동제3투","대통령선거","인천광역시","남동구",2892,1791,626,441,465,108,136,1,0,1,0,2,1,0,2,1783,8,1101
"11352","만수1동","만수1동제4투","대통령선거","인천광역시","남동구",2097,1329,379,437,378,55,55,6,0,4,0,1,1,2,2,1320,9,768
"11353","만수1동","만수1동제5투","대통령선거","인천광역시","남동구",2039,1404,522,303,367,92,109,0,0,2,0,1,0,0,1,1397,7,635
"11354","만수2동","관내사전투표","대통령선거","인천광역시","남동구",4136,4135,1921,739,873,248,327,6,1,0,0,5,0,0,3,4123,12,1
"11355","만수2동","만수2동제1투","대통령선거","인천광역시","남동구",2256,1382,540,291,375,78,85,2,0,2,0,3,0,1,1,1378,4,874
"11356","만수2동","만수2동제2투","대통령선거","인천광역시","남동구",2432,1563,636,311,372,107,122,3,0,2,0,3,1,0,2,1559,4,869
"11357","만수2동","만수2동제3투","대통령선거","인천광역시","남동구",3170,2186,836,471,562,143,153,5,1,1,0,2,1,1,3,2179,7,984
"11358","만수2동","만수2동제4투","대통령선거","인천광역시","남동구",2339,1522,578,344,402,83,97,3,0,0,1,1,1,0,5,1515,7,817
"11359","만수2동","만수2동제5투","대통령선거","인천광역시","남동구",2987,2389,1017,452,590,154,158,4,0,3,0,2,1,0,3,2384,5,598
"11360","만수2동","만수2동제6투","대통령선거","인천광역시","남동구",2659,2072,883,360,492,155,164,3,0,2,0,2,1,2,1,2065,7,587
"11361","만수3동","관내사전투표","대통령선거","인천광역시","남동구",2871,2871,1287,557,630,162,215,3,1,1,0,3,0,0,1,2860,11,0
"11362","만수3동","만수3동제1투","대통령선거","인천광역시","남동구",3313,2215,868,486,557,134,151,3,0,8,0,2,0,0,0,2209,6,1098
"11363","만수3동","만수3동제2투","대통령선거","인천광역시","남동구",2093,1200,462,288,290,67,74,1,0,4,0,2,0,1,2,1191,9,893
"11364","만수3동","만수3동제3투","대통령선거","인천광역시","남동구",2415,1436,524,357,384,61,91,3,0,3,2,2,0,1,1,1429,7,979
"11365","만수3동","만수3동제4투","대통령선거","인천광역시","남동구",4121,3272,1334,665,785,246,226,2,1,0,0,0,2,1,2,3264,8,849
"11366","만수4동","관내사전투표","대통령선거","인천광역시","남동구",3846,3846,1740,717,829,240,289,6,0,1,0,3,0,2,3,3830,16,0
"11367","만수4동","만수4동제1투","대통령선거","인천광역시","남동구",2273,1523,593,321,386,98,106,3,0,1,0,5,0,0,1,1514,9,750
"11368","만수4동","만수4동제2투","대통령선거","인천광역시","남동구",2177,1636,652,322,419,113,117,3,0,1,0,3,0,0,1,1631,5,541
"11369","만수4동","만수4동제3투","대통령선거","인천광역시","남동구",2719,1942,790,402,489,123,120,7,0,0,2,0,0,1,1,1935,7,777
"11370","만수4동","만수4동제4투","대통령선거","인천광역시","남동구",2576,1893,703,377,491,161,137,8,1,1,0,1,0,0,4,1884,9,683
"11371","만수4동","만수4동제5투","대통령선거","인천광역시","남동구",2230,1523,515,374,401,105,112,4,1,0,0,2,1,0,1,1516,7,707
"11372","만수4동","만수4동제6투","대통령선거","인천광역시","남동구",2040,1421,564,305,373,90,77,3,0,0,0,0,0,1,2,1415,6,619
"11373","만수5동","관내사전투표","대통령선거","인천광역시","남동구",2157,2157,902,459,488,124,157,2,1,4,2,3,4,0,1,2147,10,0
"11374","만수5동","만수5동제1투","대통령선거","인천광역시","남동구",2910,1699,593,427,455,95,117,0,1,2,1,0,0,1,1,1693,6,1211
"11375","만수5동","만수5동제2투","대통령선거","인천광역시","남동구",3227,2330,808,622,559,140,187,1,0,1,0,1,1,1,2,2323,7,897
"11376","만수5동","만수5동제3투","대통령선거","인천광역시","남동구",2843,1771,643,469,434,100,105,2,0,0,2,1,2,1,1,1760,11,1072
"11377","만수5동","만수5동제4투","대통령선거","인천광역시","남동구",2975,1657,596,396,450,85,109,4,1,1,3,3,1,0,3,1652,5,1318
"11378","만수6동","관내사전투표","대통령선거","인천광역시","남동구",5430,5430,2418,1045,1136,348,428,13,1,7,2,5,1,3,5,5412,18,0
"11379","만수6동","만수6동제1투","대통령선거","인천광역시","남동구",2570,1582,553,396,392,108,117,3,1,3,2,0,0,0,2,1577,5,988
"11380","만수6동","만수6동제2투","대통령선거","인천광역시","남동구",2503,1706,662,340,451,97,141,1,0,1,1,1,0,1,2,1698,8,797
"11381","만수6동","만수6동제3투","대통령선거","인천광역시","남동구",2865,1944,777,427,475,120,126,3,0,5,1,1,0,1,3,1939,5,921
"11382","만수6동","만수6동제4투","대통령선거","인천광역시","남동구",2603,1897,764,370,474,145,130,3,1,0,0,3,0,1,1,1892,5,706
"11383","만수6동","만수6동제5투","대통령선거","인천광역시","남동구",3022,2005,793,426,473,133,160,3,1,0,2,0,1,0,3,1995,10,1017
"11384","만수6동","만수6동제6투","대통령선거","인천광역시","남동구",2390,1801,650,499,400,132,109,2,0,0,0,1,0,0,1,1794,7,589
"11385","장수서창동","관내사전투표","대통령선거","인천광역시","남동구",4834,4834,2262,857,1003,311,365,4,0,4,0,4,3,2,5,4820,14,0
"11386","장수서창동","장수서창동제1투","대통령선거","인천광역시","남동구",3726,2694,994,663,654,171,192,4,0,0,0,1,2,0,4,2685,9,1032
"11387","장수서창동","장수서창동제2투","대통령선거","인천광역시","남동구",252,185,38,79,58,4,4,0,0,0,0,0,0,1,0,184,1,67
"11388","장수서창동","장수서창동제3투","대통령선거","인천광역시","남동구",4062,2866,1020,759,741,166,158,6,0,2,0,2,0,4,3,2861,5,1196
"11389","장수서창동","장수서창동제4투","대통령선거","인천광역시","남동구",2098,1668,712,323,400,99,124,1,0,0,0,1,1,0,0,1661,7,430
"11390","장수서창동","장수서창동제5투","대통령선거","인천광역시","남동구",2737,1862,756,383,455,118,133,0,1,3,0,1,2,0,2,1854,8,875
"11391","장수서창동","장수서창동제6투","대통령선거","인천광역시","남동구",3936,2891,1240,559,695,159,214,5,0,4,0,3,2,0,1,2882,9,1045
"11392","장수서창동","장수서창동제7투","대통령선거","인천광역시","남동구",3847,3074,1393,475,746,238,208,2,0,0,0,0,1,1,3,3067,7,773
"11393","장수서창동","장수서창동제8투","대통령선거","인천광역시","남동구",4811,3491,1482,645,903,207,220,10,1,2,1,1,0,1,5,3478,13,1320
"11394","남촌도림동","관내사전투표","대통령선거","인천광역시","남동구",2497,2497,1043,557,532,149,180,4,1,7,2,2,2,1,5,2485,12,0
"11395","남촌도림동","남촌도림동제1투","대통령선거","인천광역시","남동구",2268,1287,440,337,344,69,78,4,1,1,2,0,1,1,3,1281,6,981
"11396","남촌도림동","남촌도림동제2투","대통령선거","인천광역시","남동구",2696,1726,640,344,466,109,146,7,0,2,0,1,0,1,0,1716,10,970
"11397","남촌도림동","남촌도림동제3투","대통령선거","인천광역시","남동구",3338,2135,774,504,542,134,150,7,1,2,0,2,1,0,5,2122,13,1203
"11398","남촌도림동","남촌도림동제4투","대통령선거","인천광역시","남동구",3768,2561,1011,577,635,140,181,7,0,1,0,1,0,1,0,2554,7,1207
"11399","남촌도림동","남촌도림동제5투","대통령선거","인천광역시","남동구",2668,2027,808,475,472,118,141,2,1,1,0,4,0,1,2,2025,2,641
"11400","남촌도림동","남촌도림동제6투","대통령선거","인천광역시","남동구",394,274,70,105,72,15,10,0,1,0,0,0,0,0,0,273,1,120
"11401","논현1동","관내사전투표","대통령선거","인천광역시","남동구",4396,4396,2186,707,852,284,340,8,0,4,1,3,0,0,4,4389,7,0
"11402","논현1동","논현1동제1투","대통령선거","인천광역시","남동구",2425,1638,763,255,360,117,136,0,0,0,0,2,0,0,2,1635,3,787
"11403","논현1동","논현1동제2투","대통령선거","인천광역시","남동구",3331,1956,801,417,485,122,117,6,0,1,0,0,0,3,0,1952,4,1375
"11404","논현1동","논현1동제3투","대통령선거","인천광역시","남동구",2894,2333,946,448,576,176,175,2,0,4,0,1,0,0,0,2328,5,561
"11405","논현1동","논현1동제4투","대통령선거","인천광역시","남동구",2632,1626,623,377,431,88,83,7,0,3,0,7,0,0,2,1621,5,1006
"11406","논현1동","논현1동제5투","대통령선거","인천광역시","남동구",2316,1566,649,322,386,98,102,1,2,2,0,0,0,1,1,1564,2,750
"11407","논현1동","논현1동제6투","대통령선거","인천광역시","남동구",3104,2407,1070,406,595,170,156,1,1,1,0,0,1,0,1,2402,5,697
"11408","논현1동","논현1동제7투","대통령선거","인천광역시","남동구",2339,1776,752,367,405,129,113,1,0,0,0,2,0,2,2,1773,3,563
"11409","논현2동","관내사전투표","대통령선거","인천광역시","남동구",4602,4602,2239,819,912,280,319,5,1,6,0,5,1,2,1,4590,12,0
"11410","논현2동","논현2동제1투","대통령선거","인천광역시","남동구",2917,1723,699,415,401,87,110,4,1,0,0,0,1,1,2,1721,2,1194
"11411","논현2동","논현2동제2투","대통령선거","인천광역시","남동구",1890,1501,568,350,384,111,82,0,0,0,1,0,0,0,2,1498,3,389
"11412","논현2동","논현2동제3투","대통령선거","인천광역시","남동구",2240,1618,566,394,414,129,105,5,0,1,1,1,0,0,1,1617,1,622
"11413","논현2동","논현2동제4투","대통령선거","인천광역시","남동구",4022,2622,1128,475,663,162,172,2,0,4,0,4,0,0,2,2612,10,1400
"11414","논현2동","논현2동제5투","대통령선거","인천광역시","남동구",3925,2743,1135,524,720,163,178,5,0,5,0,2,1,0,2,2735,8,1182
"11415","논현2동","논현2동제6투","대통령선거","인천광역시","남동구",2268,1730,670,372,421,112,139,3,0,0,0,1,1,0,1,1720,10,538
"11416","논현2동","논현2동제7투","대통령선거","인천광역시","남동구",2081,1575,674,287,389,86,122,1,0,1,1,3,0,1,2,1567,8,506
"11417","논현2동","논현2동제8투","대통령선거","인천광역시","남동구",1303,812,301,191,197,60,58,0,0,1,0,2,0,0,1,811,1,491
"11418","논현고잔동","관내사전투표","대통령선거","인천광역시","남동구",6000,6000,2971,889,1229,429,450,7,1,1,0,1,2,1,4,5985,15,0
"11419","논현고잔동","논현고잔동제1투","대통령선거","인천광역시","남동구",2652,1940,884,343,423,162,113,2,0,2,0,2,1,1,3,1936,4,712
"11420","논현고잔동","논현고잔동제2투","대통령선거","인천광역시","남동구",3930,2369,936,523,564,152,177,4,2,3,1,1,1,0,1,2365,4,1561
"11421","논현고잔동","논현고잔동제3투","대통령선거","인천광역시","남동구",3023,2287,1032,379,553,175,139,0,0,0,0,1,1,0,0,2280,7,736
"11422","논현고잔동","논현고잔동제4투","대통령선거","인천광역시","남동구",3020,2451,1201,305,587,170,174,3,0,2,1,1,0,1,0,2445,6,569
"11423","논현고잔동","논현고잔동제5투","대통령선거","인천광역시","남동구",2966,2330,783,677,580,175,98,6,0,2,0,0,0,2,0,2323,7,636
"11424","논현고잔동","논현고잔동제6투","대통령선거","인천광역시","남동구",2917,2419,1071,373,616,176,175,1,0,1,0,0,0,0,0,2413,6,498
"11425","논현고잔동","논현고잔동제7투","대통령선거","인천광역시","남동구",2363,1910,782,366,454,159,138,1,1,2,0,0,0,0,3,1906,4,453
"11426","논현고잔동","논현고잔동제8투","대통령선거","인천광역시","남동구",655,347,107,133,78,16,7,0,0,0,1,0,0,0,1,343,4,308
"11427","잘못 투입·구분된 투표지","잘못 투입·구분된 투표지","대통령선거","인천광역시","남동구",0,1,0,1,0,0,0,0,0,0,0,0,0,0,0,1,0,-1
"11428","거소·선상투표","거소·선상투표","대통령선거","인천광역시","부평구",730,686,258,85,250,41,21,1,2,1,0,3,0,2,5,669,17,44
"11429","관외사전투표","관외사전투표","대통령선거","인천광역시","부평구",34221,34218,16054,4764,7655,2496,2771,48,12,15,10,35,14,8,54,33936,282,3
"11430","재외투표","재외투표","대통령선거","인천광역시","부평구",2588,2054,1301,133,283,77,238,4,0,4,0,0,1,1,1,2043,11,534
"11431","부평1동","관내사전투표","대통령선거","인천광역시","부평구",5882,5882,2773,1072,1182,383,434,6,0,6,0,3,1,4,4,5868,14,0
"11432","부평1동","부평1동제1투","대통령선거","인천광역시","부평구",2774,1821,699,385,460,120,149,2,0,1,0,1,0,0,1,1818,3,953
"11433","부평1동","부평1동제2투","대통령선거","인천광역시","부평구",4607,2595,1193,452,553,181,193,3,1,2,1,3,1,2,1,2586,9,2012
"11434","부평1동","부평1동제3투","대통령선거","인천광역시","부평구",2715,2234,863,559,495,175,134,4,0,0,0,1,0,0,1,2232,2,481
"11435","부평1동","부평1동제4투","대통령선거","인천광역시","부평구",2954,2220,836,493,580,164,132,3,0,2,0,0,2,0,2,2214,6,734
"11436","부평1동","부평1동제5투","대통령선거","인천광역시","부평구",3194,2402,966,510,637,136,137,0,1,2,0,0,1,1,4,2395,7,792
"11437","부평1동","부평1동제6투","대통령선거","인천광역시","부평구",2735,2214,898,475,538,146,146,1,0,2,1,0,0,0,1,2208,6,521
"11438","부평1동","부평1동제7투","대통령선거","인천광역시","부평구",3038,1967,799,383,510,111,144,3,1,3,0,1,1,1,3,1960,7,1071
"11439","부평2동","관내사전투표","대통령선거","인천광역시","부평구",2534,2534,1133,512,561,128,167,8,0,3,0,6,0,1,3,2522,12,0
"11440","부평2동","부평2동제1투","대통령선거","인천광역시","부평구",2840,1621,614,343,450,99,100,6,0,0,0,0,0,0,2,1614,7,1219
"11441","부평2동","부평2동제2투","대통령선거","인천광역시","부평구",2890,1918,775,349,525,100,158,4,1,0,1,0,0,1,1,1915,3,972
"11442","부평2동","부평2동제3투","대통령선거","인천광역시","부평구",3076,1947,799,365,506,122,140,4,0,4,1,0,1,1,1,1944,3,1129
"11443","부평2동","부평2동제4투","대통령선거","인천광역시","부평구",2691,1672,637,351,447,97,119,5,0,2,0,1,0,0,2,1661,11,1019
"11444","부평2동","부평2동제5투","대통령선거","인천광역시","부평구",2330,1504,568,364,410,73,74,1,1,3,2,1,1,0,1,1499,5,826
"11445","부평3동","관내사전투표","대통령선거","인천광역시","부평구",2438,2438,1007,540,524,149,198,7,0,4,0,2,1,2,0,2434,4,0
"11446","부평3동","부평3동제1투","대통령선거","인천광역시","부평구",3521,2019,747,488,504,116,151,3,0,0,1,0,2,0,2,2014,5,1502
"11447","부평3동","부평3동제2투","대통령선거","인천광역시","부평구",1432,929,309,264,246,40,61,0,0,0,0,1,0,1,1,923,6,503
"11448","부평3동","부평3동제3투","대통령선거","인천광역시","부평구",2868,1881,719,446,452,93,155,1,0,1,0,2,1,0,6,1876,5,987
"11449","부평3동","부평3동제4투","대통령선거","인천광역시","부평구",2287,1390,477,359,381,71,93,3,1,1,0,0,0,0,0,1386,4,897
"11450","부평4동","관내사전투표","대통령선거","인천광역시","부평구",5204,5204,2654,716,1034,312,457,6,1,3,0,2,1,0,3,5189,15,0
"11451","부평4동","부평4동제1투","대통령선거","인천광역시","부평구",3948,2357,996,505,553,123,161,5,0,0,1,0,2,1,4,2351,6,1591
"11452","부평4동","부평4동제2투","대통령선거","인천광역시","부평구",5125,3137,1343,589,783,146,255,4,0,1,0,1,0,0,4,3126,11,1988
"11453","부평4동","부평4동제3투","대통령선거","인천광역시","부평구",4020,2725,1101,521,711,175,193,4,0,2,0,1,1,0,5,2714,11,1295
"11454","부평4동","부평4동제4투","대통령선거","인천광역시","부평구",3931,2476,1067,430,619,167,174,5,1,0,0,0,1,2,2,2468,8,1455
"11455","부평4동","부평4동제5투","대통령선거","인천광역시","부평구",3181,2055,732,521,554,104,119,6,0,4,2,0,2,0,2,2046,9,1126
"11456","부평4동","부평4동제6투","대통령선거","인천광역시","부평구",4415,2705,1185,445,712,139,199,6,0,2,2,2,1,0,5,2698,7,1710
"11457","부평5동","관내사전투표","대통령선거","인천광역시","부평구",3569,3569,1799,532,727,197,288,5,1,1,0,3,0,2,2,3557,12,0
"11458","부평5동","부평5동제1투","대통령선거","인천광역시","부평구",4357,2309,1014,393,557,123,188,7,1,6,1,4,2,2,2,2300,9,2048
"11459","부평5동","부평5동제2투","대통령선거","인천광역시","부평구",5281,3207,1400,568,762,190,254,3,4,5,0,4,1,2,2,3195,12,2074
"11460","부평5동","부평5동제3투","대통령선거","인천광역시","부평구",4192,2677,1107,519,709,153,175,2,0,1,0,1,1,1,2,2671,6,1515
"11461","부평5동","부평5동제4투","대통령선거","인천광역시","부평구",4433,2831,1150,542,735,182,199,4,0,2,1,4,1,1,1,2822,9,1602
"11462","부평5동","부평5동제5투","대통령선거","인천광역시","부평구",4172,2467,999,496,617,134,198,5,0,1,0,2,2,0,1,2455,12,1705
"11463","부평6동","관내사전투표","대통령선거","인천광역시","부평구",2442,2442,1114,462,529,123,193,6,0,2,0,1,1,1,4,2436,6,0
"11464","부평6동","부평6동제1투","대통령선거","인천광역시","부평구",2528,1481,576,311,382,86,101,5,1,5,0,3,1,1,1,1473,8,1047
"11465","부평6동","부평6동제2투","대통령선거","인천광역시","부평구",2216,1413,568,249,388,72,111,3,0,1,2,0,2,1,0,1397,16,803
"11466","부평6동","부평6동제3투","대통령선거","인천광역시","부평구",2607,1584,716,329,324,76,120,3,2,1,0,2,1,0,2,1576,8,1023
"11467","부평6동","부평6동제4투","대통령선거","인천광역시","부평구",3358,2360,922,510,646,133,135,2,1,0,1,0,0,2,1,2353,7,998
"11468","산곡1동","관내사전투표","대통령선거","인천광역시","부평구",1983,1983,780,497,416,106,158,7,0,1,1,2,0,1,1,1970,13,0
"11469","산곡1동","산곡1동제1투","대통령선거","인천광역시","부평구",2100,1130,374,318,294,66,66,2,0,1,0,0,3,0,1,1125,5,970
"11470","산곡1동","산곡1동제2투","대통령선거","인천광역시","부평구",2178,1526,569,346,372,96,127,4,0,1,0,4,1,1,1,1522,4,652
"11471","산곡1동","산곡1동제3투","대통령선거","인천광역시","부평구",2215,1466,518,351,400,80,111,2,0,0,0,0,0,0,2,1464,2,749
"11472","산곡1동","산곡1동제4투","대통령선거","인천광역시","부평구",2618,1627,583,417,426,81,104,2,1,0,1,1,1,1,3,1621,6,991
"11473","산곡1동","산곡1동제5투","대통령선거","인천광역시","부평구",2582,1692,653,357,444,90,128,3,0,5,0,2,0,0,3,1685,7,890
"11474","산곡2동","관내사전투표","대통령선거","인천광역시","부평구",4953,4953,2444,741,993,348,399,8,0,4,0,3,1,2,1,4944,9,0
"11475","산곡2동","산곡2동제1투","대통령선거","인천광역시","부평구",3127,2277,1008,408,534,162,162,0,0,0,0,0,0,0,0,2274,3,850
"11476","산곡2동","산곡2동제2투","대통령선거","인천광역시","부평구",2534,1947,840,382,449,133,133,4,1,1,0,0,0,0,1,1944,3,587
"11477","산곡2동","산곡2동제3투","대통령선거","인천광역시","부평구",3880,2942,1289,580,655,192,206,4,1,0,0,3,0,1,2,2933,9,938
"11478","산곡2동","산곡2동제4투","대통령선거","인천광역시","부평구",3578,2748,1099,579,686,185,181,2,0,1,0,1,1,1,2,2738,10,830
"11479","산곡2동","산곡2동제5투","대통령선거","인천광역시","부평구",3496,2613,1044,523,639,192,195,0,0,3,0,2,0,0,3,2601,12,883
"11480","산곡2동","산곡2동제6투","대통령선거","인천광역시","부평구",3441,2565,1056,529,625,145,197,7,0,3,0,1,0,1,0,2564,1,876
"11481","산곡3동","관내사전투표","대통령선거","인천광역시","부평구",4124,4124,1713,906,938,267,267,5,3,2,1,4,1,0,2,4109,15,0
"11482","산곡3동","산곡3동제1투","대통령선거","인천광역시","부평구",3013,2299,878,537,557,174,142,0,2,0,1,0,1,1,2,2295,4,714
"11483","산곡3동","산곡3동제2투","대통령선거","인천광역시","부평구",2653,1839,694,442,426,145,120,2,0,4,0,1,0,1,1,1836,3,814
"11484","산곡3동","산곡3동제3투","대통령선거","인천광역시","부평구",2021,1505,585,341,365,105,101,4,0,0,0,2,0,0,0,1503,2,516
"11485","산곡3동","산곡3동제4투","대통령선거","인천광역시","부평구",2370,1537,539,363,428,94,102,3,0,1,0,1,2,1,0,1534,3,833
"11486","산곡3동","산곡3동제5투","대통령선거","인천광역시","부평구",2340,1834,613,513,411,172,116,2,0,0,3,0,0,2,1,1833,1,506
"11487","산곡3동","산곡3동제6투","대통령선거","인천광역시","부평구",2612,1734,580,488,446,90,106,2,0,7,1,0,2,1,1,1724,10,878
"11488","산곡4동","관내사전투표","대통령선거","인천광역시","부평구",3789,3789,1744,660,798,269,287,6,1,3,1,6,0,1,5,3781,8,0
"11489","산곡4동","산곡4동제1투","대통령선거","인천광역시","부평구",2966,2213,915,464,535,139,149,2,0,0,0,3,0,1,0,2208,5,753
"11490","산곡4동","산곡4동제2투","대통령선거","인천광역시","부평구",2579,1818,725,412,415,154,100,3,1,2,0,1,0,0,0,1813,5,761
"11491","산곡4동","산곡4동제3투","대통령선거","인천광역시","부평구",3062,2330,932,495,570,169,152,0,0,3,0,0,0,3,2,2326,4,732
"11492","산곡4동","산곡4동제4투","대통령선거","인천광역시","부평구",2797,2142,859,460,501,155,148,3,0,3,0,1,1,0,2,2133,9,655
"11493","청천1동","관내사전투표","대통령선거","인천광역시","부평구",1296,1296,534,303,333,49,72,0,0,0,0,0,1,0,1,1293,3,0
"11494","청천1동","청천1동제1투","대통령선거","인천광역시","부평구",2758,1378,437,371,401,67,92,3,0,0,0,0,0,1,3,1375,3,1380
"11495","청천1동","청천1동제2투","대통령선거","인천광역시","부평구",3699,2156,740,588,548,122,139,6,1,1,1,0,0,0,1,2147,9,1543
"11496","청천2동","관내사전투표","대통령선거","인천광역시","부평구",3312,3312,1522,606,718,195,248,2,1,2,1,0,0,0,4,3299,13,0
"11497","청천2동","청천2동제1투","대통령선거","인천광역시","부평구",3027,1589,536,362,488,77,109,1,1,3,1,1,0,0,4,1583,6,1438
"11498","청천2동","청천2동제2투","대통령선거","인천광역시","부평구",3575,2494,954,503,655,170,193,5,0,0,0,2,1,0,5,2488,6,1081
"11499","청천2동","청천2동제3투","대통령선거","인천광역시","부평구",2718,2135,858,426,540,129,173,0,1,2,0,0,0,0,1,2130,5,583
"11500","청천2동","청천2동제4투","대통령선거","인천광역시","부평구",2631,2055,947,318,471,144,161,2,0,0,2,0,0,0,2,2047,8,576
"11501","청천2동","청천2동제5투","대통령선거","인천광역시","부평구",2484,1964,915,339,409,146,144,1,0,1,0,0,0,2,1,1958,6,520
"11502","청천2동","청천2동제6투","대통령선거","인천광역시","부평구",2529,1914,792,323,515,125,137,4,1,1,0,2,0,0,4,1904,10,615
"11503","청천2동","청천2동제7투","대통령선거","인천광역시","부평구",2790,2051,873,385,491,121,163,3,1,3,1,3,0,1,0,2045,6,739
"11504","청천2동","청천2동제8투","대통령선거","인천광역시","부평구",2904,1850,648,449,500,119,126,1,1,2,0,0,0,0,0,1846,4,1054
"11505","갈산1동","관내사전투표","대통령선거","인천광역시","부평구",2545,2545,1204,407,557,150,213,1,0,2,0,0,1,1,5,2541,4,0
"11506","갈산1동","갈산1동제1투","대통령선거","인천광역시","부평구",2205,1271,460,281,344,68,110,0,0,1,0,0,0,0,0,1264,7,934
"11507","갈산1동","갈산1동제2투","대통령선거","인천광역시","부평구",3162,2095,823,453,546,118,140,4,0,1,0,2,0,0,4,2091,4,1067
"11508","갈산1동","갈산1동제3투","대통령선거","인천광역시","부평구",3042,2057,842,413,486,142,158,3,0,0,0,1,0,0,1,2046,11,985
"11509","갈산1동","갈산1동제4투","대통령선거","인천광역시","부평구",2851,1991,829,377,516,106,146,2,0,1,0,0,0,0,3,1980,11,860
"11510","갈산2동","관내사전투표","대통령선거","인천광역시","부평구",3660,3660,1675,683,812,202,266,8,1,1,1,0,0,0,1,3650,10,0
"11511","갈산2동","갈산2동제1투","대통령선거","인천광역시","부평구",2910,2176,913,440,518,167,128,1,0,1,0,1,0,0,0,2169,7,734
"11512","갈산2동","갈산2동제2투","대통령선거","인천광역시","부평구",2762,1868,845,329,446,114,121,1,0,2,0,0,2,0,2,1862,6,894
"11513","갈산2동","갈산2동제3투","대통령선거","인천광역시","부평구",2748,1910,710,430,500,133,116,5,0,5,1,0,1,1,2,1904,6,838
"11514","갈산2동","갈산2동제4투","대통령선거","인천광역시","부평구",3037,2269,906,493,532,177,146,2,1,0,0,0,0,1,1,2259,10,768
"11515","갈산2동","갈산2동제5투","대통령선거","인천광역시","부평구",1558,948,346,230,245,60,57,0,0,0,0,0,1,0,4,943,5,610
"11516","삼산1동","관내사전투표","대통령선거","인천광역시","부평구",4596,4596,2208,719,996,305,335,8,0,4,1,4,3,1,1,4585,11,0
"11517","삼산1동","삼산1동제1투","대통령선거","인천광역시","부평구",3130,1982,822,371,511,127,135,0,0,3,0,1,1,0,2,1973,9,1148
"11518","삼산1동","삼산1동제2투","대통령선거","인천광역시","부평구",3987,2827,1088,611,705,193,219,1,0,2,1,2,0,0,0,2822,5,1160
"11519","삼산1동","삼산1동제3투","대통령선거","인천광역시","부평구",2831,1897,766,351,532,106,122,1,0,4,2,1,1,1,1,1888,9,934
"11520","삼산1동","삼산1동제4투","대통령선거","인천광역시","부평구",2281,1540,696,249,364,117,97,2,0,1,0,2,1,1,1,1531,9,741
"11521","삼산1동","삼산1동제5투","대통령선거","인천광역시","부평구",2235,1414,446,411,384,75,55,4,1,6,2,2,4,4,4,1398,16,821
"11522","삼산1동","삼산1동제6투","대통령선거","인천광역시","부평구",4823,3537,1473,623,938,230,252,4,2,2,0,0,0,0,4,3528,9,1286
"11523","삼산1동","삼산1동제7투","대통령선거","인천광역시","부평구",4627,3660,1875,387,847,233,296,7,1,1,0,4,0,2,2,3655,5,967
"11524","삼산2동","관내사전투표","대통령선거","인천광역시","부평구",4596,4596,2386,623,879,308,376,7,0,0,1,4,0,2,4,4590,6,0
"11525","삼산2동","삼산2동제1투","대통령선거","인천광역시","부평구",3058,2356,1115,368,546,167,149,2,0,2,0,2,0,0,0,2351,5,702
"11526","삼산2동","삼산2동제2투","대통령선거","인천광역시","부평구",2772,2269,1133,249,570,145,163,0,1,0,0,3,0,1,2,2267,2,503
"11527","삼산2동","삼산2동제3투","대통령선거","인천광역시","부평구",2440,1838,736,386,459,115,136,2,0,1,0,0,1,1,0,1837,1,602
"11528","삼산2동","삼산2동제4투","대통령선거","인천광역시","부평구",2769,1889,729,415,481,135,101,11,1,1,1,2,2,1,5,1885,4,880
"11529","삼산2동","삼산2동제5투","대통령선거","인천광역시","부평구",2974,2486,1072,459,605,188,147,0,0,1,0,1,0,1,0,2474,12,488
"11530","삼산2동","삼산2동제6투","대통령선거","인천광역시","부평구",2906,2167,968,332,564,161,130,1,0,1,0,2,0,1,2,2162,5,739
"11531","부개1동","관내사전투표","대통령선거","인천광역시","부평구",2456,2456,1109,499,541,139,147,2,0,2,0,2,2,0,1,2444,12,0
"11532","부개1동","부개1동제1투","대통령선거","인천광역시","부평구",3133,2047,826,449,505,111,136,3,1,3,0,1,0,1,3,2039,8,1086
"11533","부개1동","부개1동제2투","대통령선거","인천광역시","부평구",1957,1215,454,301,324,66,60,1,0,1,0,0,0,0,2,1209,6,742
"11534","부개1동","부개1동제3투","대통령선거","인천광역시","부평구",2081,1609,636,350,395,115,100,1,0,0,1,1,0,0,2,1601,8,472
"11535","부개1동","부개1동제4투","대통령선거","인천광역시","부평구",2902,1664,587,431,428,92,109,2,1,2,0,2,1,1,4,1660,4,1238
"11536","부개1동","부개1동제5투","대통령선거","인천광역시","부평구",2154,1412,497,352,391,75,77,0,1,4,1,0,1,0,3,1402,10,742
"11537","부개2동","관내사전투표","대통령선거","인천광역시","부평구",3925,3925,1869,624,871,229,295,9,0,4,0,6,1,1,4,3913,12,0
"11538","부개2동","부개2동제1투","대통령선거","인천광역시","부평구",2784,1763,624,428,487,93,115,3,0,1,1,1,3,1,2,1759,4,1021
"11539","부개2동","부개2동제2투","대통령선거","인천광역시","부평구",2817,1809,687,408,470,111,115,1,0,2,0,1,1,1,0,1797,12,1008
"11540","부개2동","부개2동제3투","대통령선거","인천광역시","부평구",3741,2706,1152,476,681,183,195,6,0,3,0,1,1,1,2,2701,5,1035
"11541","부개2동","부개2동제4투","대통령선거","인천광역시","부평구",2216,1646,645,383,383,100,121,5,1,2,1,0,0,0,1,1642,4,570
"11542","부개2동","부개2동제5투","대통령선거","인천광역시","부평구",2303,1743,712,337,451,123,112,0,0,2,0,0,1,2,0,1740,3,560
"11543","부개3동","관내사전투표","대통령선거","인천광역시","부평구",5634,5634,2754,870,1137,391,440,4,0,3,0,9,1,1,2,5612,22,0
"11544","부개3동","부개3동제1투","대통령선거","인천광역시","부평구",2576,1786,765,343,435,122,108,2,0,2,0,0,0,1,1,1779,7,790
"11545","부개3동","부개3동제2투","대통령선거","인천광역시","부평구",2610,1586,699,271,405,88,110,6,1,1,0,0,0,0,0,1581,5,1024
"11546","부개3동","부개3동제3투","대통령선거","인천광역시","부평구",2982,2223,958,411,495,156,186,6,0,1,1,1,0,1,2,2218,5,759
"11547","부개3동","부개3동제4투","대통령선거","인천광역시","부평구",2845,2152,999,318,499,163,161,4,1,0,0,1,0,0,1,2147,5,693
"11548","부개3동","부개3동제5투","대통령선거","인천광역시","부평구",3390,2707,1108,547,685,184,170,1,0,2,0,0,0,0,2,2699,8,683
"11549","부개3동","부개3동제6투","대통령선거","인천광역시","부평구",3200,2575,1162,450,590,169,190,2,1,1,0,4,0,0,1,2570,5,625
"11550","부개3동","부개3동제7투","대통령선거","인천광역시","부평구",3269,2407,1060,449,560,132,184,3,0,4,0,0,1,0,2,2395,12,862
"11551","일신동","관내사전투표","대통령선거","인천광역시","부평구",2655,2655,1148,506,638,168,176,2,0,2,0,2,2,1,2,2647,8,0
"11552","일신동","일신동제1투","대통령선거","인천광역시","부평구",3051,2068,782,484,533,128,120,3,1,2,1,0,0,1,4,2059,9,983
"11553","일신동","일신동제2투","대통령선거","인천광역시","부평구",2797,2013,840,440,506,81,128,4,0,1,0,2,3,0,1,2006,7,784
"11554","일신동","일신동제3투","대통령선거","인천광역시","부평구",2371,1776,731,333,438,149,118,2,0,0,0,0,0,1,1,1773,3,595
"11555","십정1동","관내사전투표","대통령선거","인천광역시","부평구",2394,2394,1017,519,564,139,132,4,1,4,0,0,1,0,2,2383,11,0
"11556","십정1동","십정1동제1투","대통령선거","인천광역시","부평구",2718,1506,540,390,410,54,98,1,1,1,0,0,0,0,2,1497,9,1212
"11557","십정1동","십정1동제2투","대통령선거","인천광역시","부평구",2328,1410,506,350,385,83,73,3,1,1,0,2,0,0,3,1407,3,918
"11558","십정1동","십정1동제3투","대통령선거","인천광역시","부평구",3233,2119,813,504,501,122,150,9,1,0,1,3,1,1,3,2109,10,1114
"11559","십정1동","십정1동제4투","대통령선거","인천광역시","부평구",1536,955,306,257,271,54,56,3,0,0,0,1,0,0,1,949,6,581
"11560","십정1동","십정1동제5투","대통령선거","인천광역시","부평구",2774,2000,842,397,497,125,124,2,2,2,0,1,0,2,1,1995,5,774
"11561","십정2동","관내사전투표","대통령선거","인천광역시","부평구",2189,2189,973,451,448,118,167,3,0,2,2,3,1,0,2,2170,19,0
"11562","십정2동","십정2동제1투","대통령선거","인천광역시","부평구",3447,2000,705,512,499,132,115,7,0,3,1,3,2,0,4,1983,17,1447
"11563","십정2동","십정2동제2투","대통령선거","인천광역시","부평구",3105,1990,725,530,507,82,124,3,0,4,0,0,1,1,3,1980,10,1115
"11564","십정2동","십정2동제3투","대통령선거","인천광역시","부평구",2452,1550,550,377,417,82,99,7,1,0,0,2,0,2,3,1540,10,902
"11565","십정2동","십정2동제4투","대통령선거","인천광역시","부평구",2595,1540,539,377,428,88,88,4,0,3,0,1,0,0,1,1529,11,1055
"11566","십정2동","십정2동제5투","대통령선거","인천광역시","부평구",2899,1627,614,376,433,79,105,1,0,2,1,0,1,0,3,1615,12,1272
"11567","십정2동","십정2동제6투","대통령선거","인천광역시","부평구",3368,2725,1201,558,616,175,163,2,0,0,1,2,1,0,2,2721,4,643
"11568","잘못 투입·구분된 투표지","잘못 투입·구분된 투표지","대통령선거","인천광역시","부평구",0,0,0,0,0,0,0,0,0,0,0,0,0,0,0,0,0,0
"11569","거소·선상투표","거소·선상투표","대통령선거","인천광역시","계양구",483,462,183,58,154,31,18,1,0,2,0,0,3,0,3,453,9,21
"11570","관외사전투표","관외사전투표","대통령선거","인천광역시","계양구",20965,20964,9808,2796,4647,1572,1850,39,7,12,6,15,5,9,38,20804,160,1
"11571","재외투표","재외투표","대통령선거","인천광역시","계양구",1547,1213,762,68,177,40,155,1,0,0,0,1,0,1,2,1207,6,334
"11572","효성1동","관내사전투표","대통령선거","인천광역시","계양구",4586,4586,2103,807,983,267,389,5,1,6,0,5,5,0,2,4573,13,0
"11573","효성1동","효성1동제1투","대통령선거","인천광역시","계양구",3346,2123,783,488,524,152,163,4,0,2,1,0,1,0,2,2120,3,1223
"11574","효성1동","효성1동제2투","대통령선거","인천광역시","계양구",2228,1440,541,337,362,89,96,0,0,3,0,0,1,0,2,1431,9,788
"11575","효성1동","효성1동제3투","대통령선거","인천광역시","계양구",3237,2168,845,462,569,116,153,3,0,0,1,1,0,2,1,2153,15,1069
"11576","효성1동","효성1동제4투","대통령선거","인천광역시","계양구",2919,1945,790,410,474,118,135,4,0,2,0,0,0,1,2,1936,9,974
"11577","효성1동","효성1동제5투","대통령선거","인천광역시","계양구",2291,1495,570,318,400,82,101,3,1,3,0,3,0,4,5,1490,5,796
"11578","효성1동","효성1동제6투","대통령선거","인천광역시","계양구",2485,1784,698,400,432,119,119,2,1,1,0,0,1,0,0,1773,11,701
"11579","효성1동","효성1동제7투","대통령선거","인천광역시","계양구",2710,2038,861,335,528,151,144,6,1,1,1,2,0,0,2,2032,6,672
"11580","효성2동","관내사전투표","대통령선거","인천광역시","계양구",3492,3492,1558,635,784,207,280,6,1,2,0,2,3,0,6,3484,8,0
"11581","효성2동","효성2동제1투","대통령선거","인천광역시","계양구",3210,1982,732,491,481,121,136,1,1,5,1,3,0,1,3,1976,6,1228
"11582","효성2동","효성2동제2투","대통령선거","인천광역시","계양구",3530,2138,851,429,539,147,149,4,1,3,0,1,2,0,3,2129,9,1392
"11583","효성2동","효성2동제3투","대통령선거","인천광역시","계양구",3713,2856,1214,558,683,188,195,5,0,2,0,1,0,0,1,2847,9,857
"11584","효성2동","효성2동제4투","대통령선거","인천광역시","계양구",3624,2723,1071,552,720,189,176,1,0,2,0,1,1,0,2,2715,8,901
"11585","효성2동","효성2동제5투","대통령선거","인천광역시","계양구",3129,2007,790,430,482,123,162,2,0,4,0,2,0,1,5,2001,6,1122
"11586","효성2동","효성2동제6투","대통령선거","인천광역시","계양구",3753,2772,1169,505,672,182,221,2,1,2,0,1,1,0,3,2759,13,981
"11587","계산1동","관내사전투표","대통령선거","인천광역시","계양구",2456,2456,1133,414,546,134,194,8,2,1,0,5,1,1,7,2446,10,0
"11588","계산1동","계산1동제1투","대통령선거","인천광역시","계양구",3284,1943,714,466,474,134,138,1,3,2,0,2,0,1,4,1939,4,1341
"11589","계산1동","계산1동제2투","대통령선거","인천광역시","계양구",3410,2173,814,466,539,159,169,4,1,2,0,6,2,2,1,2165,8,1237
"11590","계산1동","계산1동제3투","대통령선거","인천광역시","계양구",2581,1555,604,352,398,85,99,6,0,1,0,1,2,1,3,1552,3,1026
"11591","계산1동","계산1동제4투","대통령선거","인천광역시","계양구",3080,2038,859,444,464,110,147,2,0,2,0,1,0,2,1,2032,6,1042
"11592","계산1동","계산1동제5투","대통령선거","인천광역시","계양구",2375,1448,539,346,365,91,85,2,0,4,0,2,0,0,2,1436,12,927
"11593","계산2동","관내사전투표","대통령선거","인천광역시","계양구",4065,4065,1986,624,836,241,337,7,0,3,0,8,0,1,2,4045,20,0
"11594","계산2동","계산2동제1투","대통령선거","인천광역시","계양구",2937,1753,689,414,419,107,106,7,0,0,1,1,1,0,3,1748,5,1184
"11595","계산2동","계산2동제2투","대통령선거","인천광역시","계양구",3013,1898,713,411,518,115,123,3,0,0,0,3,2,0,2,1890,8,1115
"11596","계산2동","계산2동제3투","대통령선거","인천광역시","계양구",2849,2093,797,422,545,149,157,5,0,3,1,4,0,0,4,2087,6,756
"11597","계산2동","계산2동제4투","대통령선거","인천광역시","계양구",2647,1653,607,353,450,112,114,4,0,2,0,1,0,1,2,1646,7,994
"11598","계산3동","관내사전투표","대통령선거","인천광역시","계양구",2982,2982,1422,439,644,213,242,2,2,3,1,6,2,0,1,2977,5,0
"11599","계산3동","계산3동제1투","대통령선거","인천광역시","계양구",3274,2299,938,414,593,162,178,3,0,1,0,2,0,0,0,2291,8,975
"11600","계산3동","계산3동제2투","대통령선거","인천광역시","계양구",2659,1923,843,280,511,114,161,1,0,0,0,2,0,1,0,1913,10,736
"11601","계산3동","계산3동제3투","대통령선거","인천광역시","계양구",2489,1754,764,296,443,102,137,2,0,1,1,3,1,0,1,1751,3,735
"11602","계산3동","계산3동제4투","대통령선거","인천광역시","계양구",2930,2049,888,358,501,133,155,2,0,2,0,4,1,0,1,2045,4,881
"11603","계산3동","계산3동제5투","대통령선거","인천광역시","계양구",2871,1888,804,325,460,111,166,3,2,4,2,4,1,0,2,1884,4,983
"11604","계산4동","관내사전투표","대통령선거","인천광역시","계양구",4260,4260,2132,580,852,301,366,2,0,6,2,3,1,1,3,4249,11,0
"11605","계산4동","계산4동제1투","대통령선거","인천광역시","계양구",3077,1981,857,317,471,175,150,1,0,2,1,2,0,0,0,1976,5,1096
"11606","계산4동","계산4동제2투","대통령선거","인천광역시","계양구",3434,2610,1100,482,614,190,198,6,0,1,0,4,0,1,1,2597,13,824
"11607","계산4동","계산4동제3투","대통령선거","인천광역시","계양구",3239,2363,936,474,610,179,146,3,0,3,0,3,0,1,3,2358,5,876
"11608","계산4동","계산4동제4투","대통령선거","인천광역시","계양구",3435,2686,1161,451,679,153,227,3,0,2,0,2,0,0,2,2680,6,749
"11609","작전1동","관내사전투표","대통령선거","인천광역시","계양구",3760,3760,1806,574,790,258,306,1,1,5,1,2,3,0,2,3749,11,0
"11610","작전1동","작전1동제1투","대통령선거","인천광역시","계양구",3890,2703,1132,502,683,178,182,5,2,4,0,0,1,1,0,2690,13,1187
"11611","작전1동","작전1동제2투","대통령선거","인천광역시","계양구",3453,2301,950,391,601,146,203,0,0,1,0,1,0,1,4,2298,3,1152
"11612","작전1동","작전1동제3투","대통령선거","인천광역시","계양구",3399,2503,1033,512,613,166,164,1,0,4,1,0,0,2,2,2498,5,896
"11613","작전1동","작전1동제4투","대통령선거","인천광역시","계양구",2289,1473,580,320,366,87,105,2,0,2,0,1,1,0,4,1468,5,816
"11614","작전1동","작전1동제5투","대통령선거","인천광역시","계양구",3553,2444,1007,466,619,152,189,1,0,2,0,0,0,0,1,2437,7,1109
"11615","작전1동","작전1동제6투","대통령선거","인천광역시","계양구",2676,1980,876,362,430,154,151,1,0,0,0,0,1,1,0,1976,4,696
"11616","작전2동","관내사전투표","대통령선거","인천광역시","계양구",3598,3598,1701,610,767,210,283,2,1,1,0,7,1,1,3,3587,11,0
"11617","작전2동","작전2동제1투","대통령선거","인천광역시","계양구",2796,1663,674,335,419,105,111,4,0,2,1,0,1,0,1,1653,10,1133
"11618","작전2동","작전2동제2투","대통령선거","인천광역시","계양구",2710,1901,766,386,485,95,155,1,0,1,2,4,1,1,1,1898,3,809
"11619","작전2동","작전2동제3투","대통령선거","인천광역시","계양구",2608,1732,716,324,427,137,118,1,0,1,0,0,0,0,3,1727,5,876
"11620","작전2동","작전2동제4투","대통령선거","인천광역시","계양구",2093,1500,602,300,394,94,97,3,0,0,1,2,1,0,3,1497,3,593
"11621","작전2동","작전2동제5투","대통령선거","인천광역시","계양구",2120,1367,552,293,329,90,82,2,0,1,2,1,1,1,2,1356,11,753
"11622","작전2동","작전2동제6투","대통령선거","인천광역시","계양구",2414,1501,547,356,394,83,104,3,0,0,0,1,2,1,2,1493,8,913
"11623","작전2동","작전2동제7투","대통령선거","인천광역시","계양구",2123,1392,525,301,360,89,105,0,0,4,1,1,1,0,0,1387,5,731
"11624","작전서운동","관내사전투표","대통령선거","인천광역시","계양구",3249,3249,1576,496,683,217,248,2,0,2,0,5,1,0,2,3232,17,0
"11625","작전서운동","작전서운동제1투","대통령선거","인천광역시","계양구",2755,1544,623,298,386,97,118,2,0,3,1,1,1,1,2,1533,11,1211
"11626","작전서운동","작전서운동제2투","대통령선거","인천광역시","계양구",3358,2605,1152,420,617,181,217,3,0,5,1,2,1,0,1,2600,5,753
"11627","작전서운동","작전서운동제3투","대통령선거","인천광역시","계양구",2836,2085,771,414,552,190,142,2,1,1,1,0,0,0,3,2077,8,751
"11628","작전서운동","작전서운동제4투","대통령선거","인천광역시","계양구",1877,1302,512,319,277,93,88,4,0,1,0,2,2,0,1,1299,3,575
"11629","작전서운동","작전서운동제5투","대통령선거","인천광역시","계양구",3137,2378,1137,319,539,176,191,2,2,0,0,2,0,0,2,2370,8,759
"11630","작전서운동","작전서운동제6투","대통령선거","인천광역시","계양구",3016,2277,1094,331,508,148,182,1,0,1,1,2,1,1,2,2272,5,739
"11631","작전서운동","작전서운동제7투","대통령선거","인천광역시","계양구",1907,1298,526,274,311,70,105,1,0,3,0,2,1,0,0,1293,5,609
"11632","작전서운동","작전서운동제8투","대통령선거","인천광역시","계양구",1514,1106,508,187,263,77,66,0,0,1,0,1,1,1,0,1105,1,408
"11633","계양1동","관내사전투표","대통령선거","인천광역시","계양구",2306,2306,1036,430,467,165,188,3,0,2,1,1,0,0,0,2293,13,0
"11634","계양1동","계양1동제1투","대통령선거","인천광역시","계양구",3473,2255,820,596,530,153,140,3,1,1,0,2,1,1,1,2249,6,1218
"11635","계양1동","계양1동제2투","대통령선거","인천광역시","계양구",4379,2861,1138,607,711,162,213,2,1,1,0,4,0,1,3,2843,18,1518
"11636","계양1동","계양1동제3투","대통령선거","인천광역시","계양구",3702,2889,1269,504,697,175,221,3,1,2,0,5,1,3,2,2883,6,813
"11637","계양1동","계양1동제4투","대통령선거","인천광역시","계양구",2751,2132,930,389,489,144,163,2,0,1,0,4,0,0,2,2124,8,619
"11638","계양2동","관내사전투표","대통령선거","인천광역시","계양구",4974,4973,2353,778,1078,310,386,6,3,12,0,13,5,2,3,4949,24,1
"11639","계양2동","계양2동제1투","대통령선거","인천광역시","계양구",3718,2087,802,448,541,125,154,5,1,5,0,0,1,0,0,2082,5,1631
"11640","계양2동","계양2동제2투","대통령선거","인천광역시","계양구",2881,1834,717,391,466,94,142,2,0,1,1,1,1,1,3,1820,14,1047
"11641","계양2동","계양2동제3투","대통령선거","인천광역시","계양구",2206,1455,590,298,356,92,102,5,0,2,0,1,1,0,0,1447,8,751
"11642","계양2동","계양2동제4투","대통령선거","인천광역시","계양구",2348,1343,493,326,353,78,75,3,0,2,1,1,0,0,3,1335,8,1005
"11643","계양2동","계양2동제5투","대통령선거","인천광역시","계양구",2997,2024,774,452,521,120,136,1,0,0,2,3,0,1,4,2014,10,973
"11644","계양2동","계양2동제6투","대통령선거","인천광역시","계양구",3989,2452,1014,507,595,115,197,6,0,3,0,2,1,0,1,2441,11,1537
"11645","계양2동","계양2동제7투","대통령선거","인천광역시","계양구",3763,2851,1382,406,640,190,215,2,0,2,0,3,0,0,1,2841,10,912
"11646","계양2동","계양2동제8투","대통령선거","인천광역시","계양구",3133,2242,1015,373,492,145,206,2,0,0,0,1,0,1,0,2235,7,891
"11647","계양3동","관내사전투표","대통령선거","인천광역시","계양구",2912,2912,1446,432,580,166,270,2,0,1,0,4,0,0,3,2904,8,0
"11648","계양3동","계양3동제1투","대통령선거","인천광역시","계양구",2668,1764,755,335,457,98,109,0,0,4,1,1,1,0,1,1762,2,904
"11649","계양3동","계양3동제2투","대통령선거","인천광역시","계양구",374,277,71,123,58,16,8,0,0,0,0,0,0,1,0,277,0,97
"11650","계양3동","계양3동제3투","대통령선거","인천광역시","계양구",3302,2478,1146,363,573,180,200,4,0,2,1,1,1,1,0,2472,6,824
"11651","계양3동","계양3동제4투","대통령선거","인천광역시","계양구",3150,2184,955,416,495,140,165,1,0,3,1,0,1,1,3,2181,3,966
"11652","계양3동","계양3동제5투","대통령선거","인천광역시","계양구",3756,2505,1171,365,619,143,196,2,0,1,1,1,0,0,2,2501,4,1251
"11653","계양3동","계양3동제6투","대통령선거","인천광역시","계양구",2754,2279,1017,398,548,150,155,6,0,1,0,1,0,0,3,2279,0,475
"11654","잘못 투입·구분된 투표지","잘못 투입·구분된 투표지","대통령선거","인천광역시","계양구",0,1,1,0,0,0,0,0,0,0,0,0,0,0,0,1,0,-1
"11655","거소·선상투표","거소·선상투표","대통령선거","인천광역시","서구",780,736,255,94,273,46,27,3,1,0,4,1,4,1,4,713,23,44
"11656","관외사전투표","관외사전투표","대통령선거","인천광역시","서구",30899,30895,14363,4448,6777,2326,2566,40,12,18,6,18,12,11,63,30660,235,4
"11657","재외투표","재외투표","대통령선거","인천광역시","서구",2171,1640,1014,96,270,84,169,4,0,0,0,0,0,0,0,1637,3,531
"11658","검암경서동","관내사전투표","대통령선거","인천광역시","서구",5678,5678,3069,664,1084,360,472,5,0,5,0,4,0,2,1,5666,12,0
"11659","검암경서동","검암경서동제1투","대통령선거","인천광역시","서구",3227,2304,1006,403,535,168,177,6,0,1,1,1,0,0,0,2298,6,923
"11660","검암경서동","검암경서동제2투","대통령선거","인천광역시","서구",622,365,103,163,58,25,13,0,0,1,0,0,0,0,0,363,2,257
"11661","검암경서동","검암경서동제3투","대통령선거","인천광역시","서구",3452,2033,838,381,511,137,143,6,0,1,1,4,1,1,2,2026,7,1419
"11662","검암경서동","검암경서동제4투","대통령선거","인천광역시","서구",2820,2142,1046,329,484,122,149,3,0,0,0,2,0,0,1,2136,6,678
"11663","검암경서동","검암경서동제5투","대통령선거","인천광역시","서구",3312,2269,1014,367,538,151,185,5,0,2,0,0,1,0,2,2265,4,1043
"11664","검암경서동","검암경서동제6투","대통령선거","인천광역시","서구",2334,1825,824,318,408,124,138,3,0,1,0,2,0,1,0,1819,6,509
"11665","검암경서동","검암경서동제7투","대통령선거","인천광역시","서구",2144,1459,711,194,322,96,130,0,0,0,0,1,0,0,1,1455,4,685
"11666","검암경서동","검암경서동제8투","대통령선거","인천광역시","서구",2700,2025,841,356,509,166,142,0,0,0,1,1,0,0,3,2019,6,675
"11667","검암경서동","검암경서동제9투","대통령선거","인천광역시","서구",2648,1803,883,275,366,127,143,1,0,2,0,1,0,0,2,1800,3,845
"11668","검암경서동","검암경서동제10투","대통령선거","인천광역시","서구",3253,2118,1027,282,493,124,174,2,1,0,0,5,0,0,2,2110,8,1135
"11669","연희동","관내사전투표","대통령선거","인천광역시","서구",6469,6469,3038,1027,1353,423,536,6,1,8,3,1,2,2,10,6410,59,0
"11670","연희동","연희동제1투","대통령선거","인천광역시","서구",3527,2067,780,420,554,135,158,1,0,6,0,0,1,1,3,2059,8,1460
"11671","연희동","연희동제2투","대통령선거","인천광역시","서구",3396,2214,845,493,543,148,156,2,1,1,0,0,2,4,4,2199,15,1182
"11672","연희동","연희동제3투","대통령선거","인천광역시","서구",3307,1932,680,497,491,128,120,1,1,3,2,0,0,0,3,1926,6,1375
"11673","연희동","연희동제4투","대통령선거","인천광역시","서구",3180,2150,773,489,556,153,162,2,0,1,2,2,1,0,2,2143,7,1030
"11674","연희동","연희동제5투","대통령선거","인천광역시","서구",3253,2177,798,423,624,161,153,2,0,2,0,2,1,0,3,2169,8,1076
"11675","연희동","연희동제6투","대통령선거","인천광역시","서구",2970,1986,804,395,463,147,157,1,0,4,0,1,2,0,1,1975,11,984
"11676","연희동","연희동제7투","대통령선거","인천광역시","서구",3197,1935,795,395,475,97,154,5,3,2,0,1,2,1,2,1932,3,1262
"11677","연희동","연희동제8투","대통령선거","인천광역시","서구",2702,1864,754,327,478,130,160,2,1,1,0,1,1,0,1,1856,8,838
"11678","연희동","연희동제9투","대통령선거","인천광역시","서구",3259,1992,780,391,518,127,164,2,2,3,0,1,0,0,1,1989,3,1267
"11679","청라1동","관내사전투표","대통령선거","인천광역시","서구",5353,5353,2830,589,1052,397,451,7,0,3,0,3,0,2,0,5334,19,0
"11680","청라1동","청라1동제1투","대통령선거","인천광역시","서구",2918,2334,1184,252,551,175,159,2,0,0,0,1,1,1,1,2327,7,584
"11681","청라1동","청라1동제2투","대통령선거","인천광역시","서구",2809,2162,1024,285,537,159,151,0,0,2,0,0,0,0,1,2159,3,647
"11682","청라1동","청라1동제3투","대통령선거","인천광역시","서구",2987,2114,933,323,502,199,148,3,0,1,0,1,0,0,0,2110,4,873
"11683","청라1동","청라1동제4투","대통령선거","인천광역시","서구",3416,2444,1228,303,532,192,182,0,0,0,0,1,0,0,1,2439,5,972
"11684","청라1동","청라1동제5투","대통령선거","인천광역시","서구",3773,2943,1387,423,697,228,195,4,0,1,0,2,0,1,1,2939,4,830
"11685","가정1동","관내사전투표","대통령선거","인천광역시","서구",1217,1217,495,268,285,70,82,7,1,2,0,1,0,0,0,1211,6,0
"11686","가정1동","가정1동제1투","대통령선거","인천광역시","서구",3605,1837,632,484,469,121,110,4,0,5,0,2,1,2,5,1835,2,1768
"11687","가정1동","가정1동제2투","대통령선거","인천광역시","서구",3077,1928,659,473,539,112,131,1,0,0,0,1,1,0,3,1920,8,1149
"11688","가정1동","가정1동제3투","대통령선거","인천광역시","서구",4245,3067,1330,554,714,219,232,3,0,0,1,1,0,0,4,3058,9,1178
"11689","가정2동","관내사전투표","대통령선거","인천광역시","서구",1038,1038,455,180,226,60,109,0,0,1,0,0,0,0,1,1032,6,0
"11690","가정2동","가정2동제1투","대통령선거","인천광역시","서구",2511,1502,528,332,421,102,103,3,1,1,1,1,0,2,3,1498,4,1009
"11691","가정2동","가정2동제2투","대통령선거","인천광역시","서구",2175,1436,576,255,337,99,157,1,0,1,0,2,1,0,1,1430,6,739
"11692","가정3동","관내사전투표","대통령선거","인천광역시","서구",1492,1492,660,275,341,86,109,5,0,6,1,2,1,1,0,1487,5,0
"11693","가정3동","가정3동제1투","대통령선거","인천광역시","서구",3124,2079,782,443,537,145,161,1,0,0,1,2,0,0,1,2073,6,1045
"11694","가정3동","가정3동제2투","대통령선거","인천광역시","서구",1987,1117,407,263,293,50,90,3,1,0,1,1,1,0,2,1112,5,870
"11695","가정3동","가정3동제3투","대통령선거","인천광역시","서구",1966,1529,615,349,333,119,99,2,0,3,0,1,0,0,0,1521,8,437
"11696","신현원창동","관내사전투표","대통령선거","인천광역시","서구",3180,3180,1345,599,766,189,256,8,2,4,0,0,0,0,2,3171,9,0
"11697","신현원창동","신현원창동제1투","대통령선거","인천광역시","서구",2814,1619,530,396,461,111,103,0,0,3,1,1,1,1,0,1608,11,1195
"11698","신현원창동","신현원창동제2투","대통령선거","인천광역시","서구",2878,1785,639,389,503,112,124,3,1,3,1,1,0,0,2,1778,7,1093
"11699","신현원창동","신현원창동제3투","대통령선거","인천광역시","서구",2672,1657,609,339,444,102,149,2,0,1,0,1,1,2,0,1650,7,1015
"11700","신현원창동","신현원창동제4투","대통령선거","인천광역시","서구",2275,1499,571,341,364,105,106,5,2,0,0,0,0,0,1,1495,4,776
"11701","신현원창동","신현원창동제5투","대통령선거","인천광역시","서구",17,17,2,10,5,0,0,0,0,0,0,0,0,0,0,17,0,0
"11702","신현원창동","신현원창동제6투","대통령선거","인천광역시","서구",3844,2928,1122,636,742,216,193,5,1,1,0,0,0,1,2,2919,9,916
"11703","신현원창동","신현원창동제7투","대통령선거","인천광역시","서구",3133,2456,935,548,636,152,169,6,1,0,1,3,0,0,0,2451,5,677
"11704","석남1동","관내사전투표","대통령선거","인천광역시","서구",2599,2599,1111,558,586,152,172,2,1,1,1,4,0,0,1,2589,10,0
"11705","석남1동","석남1동제1투","대통령선거","인천광역시","서구",3477,2238,838,464,618,129,165,1,1,3,1,2,2,2,2,2228,10,1239
"11706","석남1동","석남1동제2투","대통령선거","인천광역시","서구",3209,2220,821,552,552,131,145,2,2,3,2,0,2,1,0,2213,7,989
"11707","석남1동","석남1동제3투","대통령선거","인천광역시","서구",3431,2026,736,442,546,146,137,1,0,2,0,0,0,2,1,2013,13,1405
"11708","석남1동","석남1동제4투","대통령선거","인천광역시","서구",2654,1564,511,434,423,90,93,1,0,2,1,1,0,4,1,1561,3,1090
"11709","석남1동","석남1동제5투","대통령선거","인천광역시","서구",3376,1988,721,478,501,99,170,2,0,4,1,0,0,0,4,1980,8,1388
"11710","석남2동","관내사전투표","대통령선거","인천광역시","서구",2275,2275,931,523,532,125,138,4,0,4,1,2,1,0,0,2261,14,0
"11711","석남2동","석남2동제1투","대통령선거","인천광역시","서구",1522,898,273,303,210,50,51,1,0,2,0,1,0,0,2,893,5,624
"11712","석남2동","석남2동제2투","대통령선거","인천광역시","서구",3179,2262,835,509,606,144,151,2,0,2,1,1,1,2,2,2256,6,917
"11713","석남2동","석남2동제3투","대통령선거","인천광역시","서구",3372,2253,816,542,583,143,154,3,1,3,0,2,0,0,0,2247,6,1119
"11714","석남2동","석남2동제4투","대통령선거","인천광역시","서구",2166,1228,396,349,315,82,72,2,0,1,1,1,1,1,2,1223,5,938
"11715","석남3동","관내사전투표","대통령선거","인천광역시","서구",2005,2005,867,375,469,116,154,5,0,3,0,3,0,1,4,1997,8,0
"11716","석남3동","석남3동제1투","대통령선거","인천광역시","서구",3538,2151,793,454,561,147,176,0,1,3,1,2,0,0,2,2140,11,1387
"11717","석남3동","석남3동제2투","대통령선거","인천광역시","서구",3644,2267,866,454,600,128,188,6,2,5,0,2,2,1,1,2255,12,1377
"11718","석남3동","석남3동제3투","대통령선거","인천광역시","서구",3660,2122,728,550,588,120,117,7,0,3,0,0,1,0,3,2117,5,1538
"11719","가좌1동","관내사전투표","대통령선거","인천광역시","서구",1595,1595,699,342,363,72,101,3,1,4,0,0,1,0,0,1586,9,0
"11720","가좌1동","가좌1동제1투","대통령선거","인천광역시","서구",2938,1641,559,430,448,89,98,2,0,1,1,3,2,1,0,1634,7,1297
"11721","가좌1동","가좌1동제2투","대통령선거","인천광역시","서구",2626,1628,563,435,408,105,98,2,0,2,0,0,1,1,4,1619,9,998
"11722","가좌1동","가좌1동제3투","대통령선거","인천광역시","서구",2913,1768,655,408,460,109,113,4,0,4,4,0,1,1,1,1760,8,1145
"11723","가좌2동","관내사전투표","대통령선거","인천광역시","서구",3579,3579,1685,676,722,224,245,2,2,1,0,9,2,1,2,3571,8,0
"11724","가좌2동","가좌2동제1투","대통령선거","인천광역시","서구",3100,2180,821,493,535,161,148,3,0,4,0,3,1,1,2,2172,8,920
"11725","가좌2동","가좌2동제2투","대통령선거","인천광역시","서구",2892,2001,792,453,484,122,138,1,0,3,1,3,0,0,0,1997,4,891
"11726","가좌2동","가좌2동제3투","대통령선거","인천광역시","서구",3060,2224,774,574,536,162,155,7,0,1,1,2,0,2,2,2216,8,836
"11727","가좌2동","가좌2동제4투","대통령선거","인천광역시","서구",4208,3294,1383,619,808,249,214,6,0,2,0,1,0,0,0,3282,12,914
"11728","가좌3동","관내사전투표","대통령선거","인천광역시","서구",2782,2782,1181,557,655,154,212,2,0,1,2,2,2,1,3,2772,10,0
"11729","가좌3동","가좌3동제1투","대통령선거","인천광역시","서구",2642,1825,556,472,588,95,96,6,0,2,0,2,0,0,1,1818,7,817
"11730","가좌3동","가좌3동제2투","대통령선거","인천광역시","서구",3073,1931,666,439,523,151,135,0,0,2,2,2,1,1,1,1923,8,1142
"11731","가좌3동","가좌3동제3투","대통령선거","인천광역시","서구",2940,1948,688,483,480,132,154,3,1,0,0,1,0,1,3,1946,2,992
"11732","가좌3동","가좌3동제4투","대통령선거","인천광역시","서구",3230,2195,765,538,579,124,168,5,1,0,0,1,0,1,2,2184,11,1035
"11733","가좌4동","관내사전투표","대통령선거","인천광역시","서구",1107,1107,446,230,292,66,63,1,1,0,0,0,2,0,0,1101,6,0
"11734","가좌4동","가좌4동제1투","대통령선거","인천광역시","서구",1425,829,297,215,205,38,67,2,0,2,2,0,0,0,1,829,0,596
"11735","가좌4동","가좌4동제2투","대통령선거","인천광역시","서구",2479,1580,523,356,436,121,127,2,0,4,1,0,1,1,3,1575,5,899
"11736","가좌4동","가좌4동제3투","대통령선거","인천광역시","서구",1820,1154,378,316,298,80,69,2,0,3,0,0,0,0,4,1150,4,666
"11737","검단1동","관내사전투표","대통령선거","인천광역시","서구",4403,4403,2002,821,917,267,356,8,1,7,0,5,0,1,4,4389,14,0
"11738","검단1동","검단1동제1투","대통령선거","인천광역시","서구",3742,2557,1146,434,614,198,153,1,1,0,1,1,0,1,2,2552,5,1185
"11739","검단1동","검단1동제2투","대통령선거","인천광역시","서구",2338,1333,502,279,338,94,108,5,0,2,0,1,1,0,2,1332,1,1005
"11740","검단1동","검단1동제3투","대통령선거","인천광역시","서구",2387,1578,526,401,423,96,116,4,0,0,1,1,0,0,2,1570,8,809
"11741","검단1동","검단1동제4투","대통령선거","인천광역시","서구",3921,2475,1020,519,607,143,172,2,2,1,0,1,0,0,2,2469,6,1446
"11742","검단1동","검단1동제5투","대통령선거","인천광역시","서구",2778,1973,871,366,462,117,149,1,0,1,0,2,0,1,1,1971,2,805
"11743","검단1동","검단1동제6투","대통령선거","인천광역시","서구",2534,1375,554,268,362,88,81,3,1,6,2,0,1,1,1,1368,7,1159
"11744","검단2동","관내사전투표","대통령선거","인천광역시","서구",3651,3651,1762,679,688,222,271,9,0,0,1,0,3,0,3,3638,13,0
"11745","검단2동","검단2동제1투","대통령선거","인천광역시","서구",2767,1870,735,434,473,97,120,2,0,2,0,1,0,0,2,1866,4,897
"11746","검단2동","검단2동제2투","대통령선거","인천광역시","서구",2887,2051,923,376,436,155,151,2,0,2,0,2,0,0,1,2048,3,836
"11747","검단2동","검단2동제3투","대통령선거","인천광역시","서구",3656,2562,1106,501,565,183,189,4,0,0,1,0,1,0,2,2552,10,1094
"11748","검단2동","검단2동제4투","대통령선거","인천광역시","서구",3529,2166,881,463,509,145,156,0,1,3,2,1,0,0,1,2162,4,1363
"11749","검단3동","관내사전투표","대통령선거","인천광역시","서구",3455,3455,1838,438,678,227,263,4,0,1,1,2,0,0,0,3452,3,0
"11750","검단3동","검단3동제1투","대통령선거","인천광역시","서구",2174,1523,709,217,333,133,122,0,0,1,0,3,0,0,1,1519,4,651
"11751","검단3동","검단3동제2투","대통령선거","인천광역시","서구",3550,2587,1201,393,606,175,205,2,0,0,0,1,0,0,1,2584,3,963
"11752","검단3동","검단3동제3투","대통령선거","인천광역시","서구",4311,3175,1535,445,733,220,229,4,0,0,0,0,0,0,2,3168,7,1136
"11753","검단3동","검단3동제4투","대통령선거","인천광역시","서구",3067,1984,900,364,450,126,138,4,0,0,0,0,0,0,1,1983,1,1083
"11754","검단4동","관내사전투표","대통령선거","인천광역시","서구",7083,7083,3697,938,1387,462,558,13,1,5,1,2,2,1,5,7072,11,0
"11755","검단4동","검단4동제1투","대통령선거","인천광역시","서구",4376,3092,1353,599,705,173,242,8,3,0,1,0,0,0,2,3086,6,1284
"11756","검단4동","검단4동제2투","대통령선거","인천광역시","서구",3152,2360,1022,436,576,156,156,0,0,2,0,4,2,0,0,2354,6,792
"11757","검단4동","검단4동제3투","대통령선거","인천광역시","서구",3164,2349,1050,371,557,179,178,4,0,1,1,2,1,0,2,2346,3,815
"11758","검단4동","검단4동제4투","대통령선거","인천광역시","서구",3142,2334,1014,378,533,172,215,6,0,4,0,2,0,1,0,2325,9,808
"11759","검단4동","검단4동제5투","대통령선거","인천광역시","서구",4231,2897,1373,442,665,214,185,2,0,1,1,1,2,0,2,2888,9,1334
"11760","검단4동","검단4동제6투","대통령선거","인천광역시","서구",4326,3088,1437,489,690,207,250,3,1,2,0,0,0,0,2,3081,7,1238
"11761","검단4동","검단4동제7투","대통령선거","인천광역시","서구",1414,1096,465,184,277,83,81,4,0,0,0,0,0,0,0,1094,2,318
"11762","검단4동","검단4동제8투","대통령선거","인천광역시","서구",3607,2445,1089,413,574,154,193,2,0,5,3,0,1,1,3,2438,7,1162
"11763","청라2동","관내사전투표","대통령선거","인천광역시","서구",4756,4756,2375,717,970,345,313,12,0,2,0,3,1,1,7,4746,10,0
"11764","청라2동","청라2동제1투","대통령선거","인천광역시","서구",3953,3194,1401,548,788,272,177,1,0,1,0,0,2,1,0,3191,3,759
"11765","청라2동","청라2동제2투","대통령선거","인천광역시","서구",1925,1529,691,249,377,110,95,3,0,0,1,1,0,0,0,1527,2,396
"11766","청라2동","청라2동제3투","대통령선거","인천광역시","서구",2256,1656,737,262,408,134,106,1,0,1,1,0,0,0,0,1650,6,600
"11767","청라2동","청라2동제4투","대통령선거","인천광역시","서구",3958,2910,1145,622,716,252,169,2,1,0,0,1,1,0,0,2909,1,1048
"11768","청라2동","청라2동제5투","대통령선거","인천광역시","서구",3623,2859,1482,339,608,223,191,4,0,2,1,2,0,2,1,2855,4,764
"11769","청라2동","청라2동제6투","대통령선거","인천광역시","서구",3011,2149,957,387,514,136,143,5,0,1,0,0,0,0,2,2145,4,862
"11770","검단5동","관내사전투표","대통령선거","인천광역시","서구",2792,2792,1239,531,637,196,161,5,3,5,2,0,1,0,2,2782,10,0
"11771","검단5동","검단5동제1투","대통령선거","인천광역시","서구",3548,2200,948,416,542,129,143,3,0,0,1,1,0,1,6,2190,10,1348
"11772","검단5동","검단5동제2투","대통령선거","인천광역시","서구",3461,2405,1003,497,576,169,149,1,0,1,1,0,0,1,1,2399,6,1056
"11773","검단5동","검단5동제3투","대통령선거","인천광역시","서구",3349,2195,837,513,540,137,149,5,1,0,0,1,2,0,2,2187,8,1154
"11774","검단5동","검단5동제4투","대통령선거","인천광역시","서구",3663,2676,1087,497,707,176,180,7,1,2,1,6,0,1,0,2665,11,987
"11775","청라3동","관내사전투표","대통령선거","인천광역시","서구",2910,2910,1542,369,555,254,187,0,0,0,0,0,1,1,1,2910,0,0
"11776","청라3동","청라3동제1투","대통령선거","인천광역시","서구",2839,2212,1015,358,507,172,152,1,0,0,0,0,0,2,1,2208,4,627
"11777","청라3동","청라3동제2투","대통령선거","인천광역시","서구",3346,2633,1156,448,644,226,148,4,0,0,0,2,0,0,1,2629,4,713
"11778","청라3동","청라3동제3투","대통령선거","인천광역시","서구",2677,1966,880,276,521,162,117,3,0,0,0,1,2,0,0,1962,4,711
"11779","잘못 투입·구분된 투표지","잘못 투입·구분된 투표지","대통령선거","인천광역시","서구",0,0,0,0,0,0,0,0,0,0,0,0,0,0,0,0,0,0
"11780","거소·선상투표","거소·선상투표","대통령선거","인천광역시","강화군",293,280,81,46,77,11,8,2,4,2,2,4,2,1,3,243,37,13
"11781","관외사전투표","관외사전투표","대통령선거","인천광역시","강화군",5676,5650,2140,1385,1188,422,452,10,1,4,3,2,0,1,3,5611,39,26
"11782","재외투표","재외투표","대통령선거","인천광역시","강화군",324,270,166,19,38,10,30,5,0,0,0,0,0,0,0,268,2,54
"11783","강화읍","관내사전투표","대통령선거","인천광역시","강화군",3690,3690,1386,1047,769,188,254,7,0,6,1,1,3,4,1,3667,23,0
"11784","강화읍","강화읍제1투","대통령선거","인천광역시","강화군",1640,1014,237,462,198,48,61,1,0,0,0,0,1,0,1,1009,5,626
"11785","강화읍","강화읍제2투","대통령선거","인천광역시","강화군",2746,1697,429,719,368,81,75,3,0,2,2,0,1,1,2,1683,14,1049
"11786","강화읍","강화읍제3투","대통령선거","인천광역시","강화군",1441,825,218,346,180,38,34,2,0,0,0,1,1,1,0,821,4,616
"11787","강화읍","강화읍제4투","대통령선거","인천광역시","강화군",1669,1001,232,473,205,45,37,1,0,2,0,1,0,2,1,999,2,668
"11788","강화읍","강화읍제5투","대통령선거","인천광역시","강화군",2830,1831,566,627,404,105,110,7,0,3,0,0,2,1,2,1827,4,999
"11789","강화읍","강화읍제6투","대통령선거","인천광역시","강화군",1677,1000,239,431,200,68,51,5,1,0,1,0,1,0,1,998,2,677
"11790","강화읍","강화읍제7투","대통령선거","인천광역시","강화군",1882,1162,324,416,302,38,61,6,0,2,0,0,0,0,3,1152,10,720
"11791","선원면","관내사전투표","대통령선거","인천광역시","강화군",1138,1138,379,402,199,62,80,6,0,1,0,1,0,0,3,1133,5,0
"11792","선원면","선원면제1투","대통령선거","인천광역시","강화군",1776,1083,248,490,226,55,51,1,0,0,0,2,0,1,1,1075,8,693
"11793","선원면","선원면제2투","대통령선거","인천광역시","강화군",2628,1731,537,567,413,96,100,0,0,1,0,1,0,0,4,1719,12,897
"11794","불은면","관내사전투표","대통령선거","인천광역시","강화군",709,709,217,268,162,24,27,2,0,0,1,0,1,2,2,706,3,0
"11795","불은면","불은면제1투","대통령선거","인천광역시","강화군",1946,1176,246,511,302,63,41,1,1,3,0,2,1,0,2,1173,3,770
"11796","불은면","불은면제2투","대통령선거","인천광역시","강화군",1097,720,178,314,167,30,20,3,0,1,0,0,1,0,0,714,6,377
"11797","길상면","관내사전투표","대통령선거","인천광역시","강화군",1011,1011,317,336,187,56,59,3,0,9,2,4,1,3,4,981,30,0
"11798","길상면","길상면제1투","대통령선거","인천광역시","강화군",1663,1049,230,474,239,57,42,1,0,0,0,0,0,0,1,1044,5,614
"11799","길상면","길상면제2투","대통령선거","인천광역시","강화군",1140,703,141,342,143,37,29,1,1,2,1,1,0,0,1,699,4,437
"11800","길상면","길상면제3투","대통령선거","인천광역시","강화군",978,599,131,250,156,34,22,1,0,0,0,0,0,0,0,594,5,379
"11801","길상면","길상면제4투","대통령선거","인천광역시","강화군",585,391,68,193,94,19,11,1,0,0,0,0,1,1,0,388,3,194
"11802","화도면","관내사전투표","대통령선거","인천광역시","강화군",434,434,131,161,93,15,30,0,0,0,0,0,0,1,0,431,3,0
"11803","화도면","화도면제1투","대통령선거","인천광역시","강화군",1186,803,185,387,175,28,21,0,0,0,1,0,1,3,0,801,2,383
"11804","화도면","화도면제2투","대통령선거","인천광역시","강화군",784,524,117,248,109,33,11,1,0,0,1,0,0,3,0,523,1,260
"11805","화도면","화도면제3투","대통령선거","인천광역시","강화군",641,427,89,194,103,25,10,0,0,0,0,1,1,1,0,424,3,214
"11806","화도면","화도면제4투","대통령선거","인천광역시","강화군",437,284,64,132,61,14,9,1,0,1,2,0,0,0,0,284,0,153
"11807","양도면","관내사전투표","대통령선거","인천광역시","강화군",629,629,177,222,167,24,30,0,1,1,0,0,0,1,0,623,6,0
"11808","양도면","양도면제1투","대통령선거","인천광역시","강화군",1238,739,183,298,161,42,42,0,0,6,0,1,1,0,0,734,5,499
"11809","양도면","양도면제2투","대통령선거","인천광역시","강화군",1230,791,145,362,196,36,37,1,0,5,0,0,0,1,2,785,6,439
"11810","내가면","관내사전투표","대통령선거","인천광역시","강화군",448,448,144,160,93,23,24,0,0,1,0,1,1,0,1,448,0,0
"11811","내가면","내가면제1투","대통령선거","인천광역시","강화군",1040,708,138,348,166,20,31,0,0,0,0,0,0,1,0,704,4,332
"11812","내가면","내가면제2투","대통령선거","인천광역시","강화군",528,392,86,198,79,12,10,1,0,0,0,0,0,1,2,389,3,136
"11813","내가면","내가면제3투","대통령선거","인천광역시","강화군",539,372,49,232,66,12,10,1,0,0,0,0,0,0,0,370,2,167
"11814","하점면","관내사전투표","대통령선거","인천광역시","강화군",631,631,163,272,124,23,38,1,0,3,0,0,0,1,1,626,5,0
"11815","하점면","하점면제1투","대통령선거","인천광역시","강화군",1288,806,200,382,151,30,31,6,0,1,0,0,1,0,0,802,4,482
"11816","하점면","하점면제2투","대통령선거","인천광역시","강화군",728,481,98,237,95,17,28,0,0,0,0,0,0,0,3,478,3,247
"11817","하점면","하점면제3투","대통령선거","인천광역시","강화군",668,401,74,206,89,16,9,0,0,0,1,1,0,3,1,400,1,267
"11818","양사면","관내사전투표","대통령선거","인천광역시","강화군",253,253,72,104,50,12,13,0,1,0,0,0,0,0,0,252,1,0
"11819","양사면","양사면제1투","대통령선거","인천광역시","강화군",401,273,64,141,48,5,10,0,0,0,0,0,1,1,1,271,2,128
"11820","양사면","양사면제2투","대통령선거","인천광역시","강화군",512,325,67,158,68,17,9,0,0,0,0,0,0,3,1,323,2,187
"11821","양사면","양사면제3투","대통령선거","인천광역시","강화군",306,219,24,132,49,4,5,0,0,0,1,0,1,0,1,217,2,87
"11822","송해면","관내사전투표","대통령선거","인천광역시","강화군",609,609,142,241,155,33,26,3,0,1,0,0,0,2,0,603,6,0
"11823","송해면","송해면투표소","대통령선거","인천광역시","강화군",1952,1235,255,596,265,56,40,6,0,0,1,1,1,1,3,1225,10,717
"11824","교동면","관내사전투표","대통령선거","인천광역시","강화군",291,291,100,93,51,21,21,0,0,0,0,0,1,1,2,290,1,0
"11825","교동면","교동면제1투","대통령선거","인천광역시","강화군",980,635,134,282,159,23,24,1,0,0,0,1,2,1,0,627,8,345
"11826","교동면","교동면제2투","대통령선거","인천광역시","강화군",625,416,83,189,92,24,21,0,1,0,0,0,2,2,0,414,2,209
"11827","교동면","교동면제3투","대통령선거","인천광역시","강화군",578,383,94,171,82,16,12,0,0,0,0,1,0,1,1,378,5,195
"11828","삼산면","관내사전투표","대통령선거","인천광역시","강화군",268,268,74,112,57,10,13,1,0,0,0,0,0,1,0,268,0,0
"11829","삼산면","삼산면제1투","대통령선거","인천광역시","강화군",508,303,74,133,69,16,8,0,0,0,0,0,0,0,1,301,2,205
"11830","삼산면","삼산면제2투","대통령선거","인천광역시","강화군",273,179,41,62,56,6,7,0,0,0,1,0,1,2,1,177,2,94
"11831","삼산면","삼산면제3투","대통령선거","인천광역시","강화군",727,460,93,235,96,17,9,1,0,1,0,0,2,1,1,456,4,267
"11832","삼산면","삼산면제4투","대통령선거","인천광역시","강화군",62,46,11,25,5,3,0,0,0,0,0,0,1,0,0,45,1,16
"11833","서도면","관내사전투표","대통령선거","인천광역시","강화군",93,93,21,34,26,3,7,2,0,0,0,0,0,0,0,93,0,0
"11834","서도면","서도면제1투","대통령선거","인천광역시","강화군",251,172,21,104,34,4,6,0,0,0,0,0,0,1,0,170,2,79
"11835","서도면","서도면제2투","대통령선거","인천광역시","강화군",198,152,17,67,48,4,8,2,0,0,1,0,0,2,0,149,3,46
"11836","잘못 투입·구분된 투표지","잘못 투입·구분된 투표지","대통령선거","인천광역시","강화군",0,26,13,5,4,2,2,0,0,0,0,0,0,0,0,26,0,-26
"11837","거소·선상투표","거소·선상투표","대통령선거","인천광역시","옹진군",185,183,52,38,54,18,6,0,0,0,0,0,0,0,4,172,11,2
"11838","관외사전투표","관외사전투표","대통령선거","인천광역시","옹진군",3174,3174,1113,823,679,248,241,4,0,4,1,5,6,2,11,3137,37,0
"11839","재외투표","재외투표","대통령선거","인천광역시","옹진군",54,45,28,3,7,1,6,0,0,0,0,0,0,0,0,45,0,9
"11840","북도면","관내사전투표","대통령선거","인천광역시","옹진군",287,287,71,134,55,14,11,1,0,0,0,1,0,0,0,287,0,0
"11841","북도면","북도면제1투","대통령선거","인천광역시","옹진군",325,219,41,135,29,6,5,0,0,0,1,0,1,0,0,218,1,106
"11842","북도면","북도면제2투","대통령선거","인천광역시","옹진군",229,138,22,74,26,11,3,0,0,1,0,0,0,0,1,138,0,91
"11843","북도면","북도면제3투","대통령선거","인천광역시","옹진군",742,529,86,278,107,15,13,0,1,1,2,1,2,3,2,511,18,213
"11844","연평면","관내사전투표","대통령선거","인천광역시","옹진군",617,616,145,216,152,52,26,3,0,4,2,1,2,2,2,607,9,1
"11845","연평면","연평면제1투","대통령선거","인천광역시","옹진군",849,461,122,197,101,28,9,0,0,0,0,3,0,0,0,460,1,388
"11846","연평면","연평면제2투","대통령선거","인천광역시","옹진군",79,46,10,20,11,1,3,0,0,0,0,0,0,0,0,45,1,33
"11847","백령면","관내사전투표","대통령선거","인천광역시","옹진군",1000,1000,305,282,201,116,51,0,1,0,2,0,0,5,4,967,33,0
"11848","백령면","백령면제1투","대통령선거","인천광역시","옹진군",1171,694,178,331,127,34,18,0,0,1,0,0,0,2,0,691,3,477
"11849","백령면","백령면제2투","대통령선거","인천광역시","옹진군",1201,798,187,347,165,60,25,1,0,1,1,1,1,1,3,793,5,403
"11850","백령면","백령면제3투","대통령선거","인천광역시","옹진군",421,319,53,214,35,6,7,1,1,0,0,0,0,1,0,318,1,102
"11851","백령면","백령면제4투","대통령선거","인천광역시","옹진군",311,203,29,124,40,7,3,0,0,0,0,0,0,0,0,203,0,108
"11852","대청면","관내사전투표","대통령선거","인천광역시","옹진군",311,311,86,122,62,23,7,2,0,0,0,0,2,0,1,305,6,0
"11853","대청면","대청면제1투","대통령선거","인천광역시","옹진군",375,270,51,166,30,10,9,0,0,0,0,0,0,0,3,269,1,105
"11854","대청면","대청면제2투","대통령선거","인천광역시","옹진군",304,228,47,138,33,5,3,0,0,0,0,0,0,0,0,226,2,76
"11855","대청면","대청면제3투","대통령선거","인천광역시","옹진군",166,149,11,110,18,7,1,0,0,0,0,0,0,1,1,149,0,17
"11856","덕적면","관내사전투표","대통령선거","인천광역시","옹진군",388,388,110,140,96,14,16,2,1,0,0,1,1,2,1,384,4,0
"11857","덕적면","덕적면제1투","대통령선거","인천광역시","옹진군",399,225,54,88,60,14,6,0,0,0,0,0,0,1,1,224,1,174
"11858","덕적면","덕적면제2투","대통령선거","인천광역시","옹진군",283,185,38,88,50,5,2,0,0,0,0,0,0,0,1,184,1,98
"11859","덕적면","덕적면제3투","대통령선거","인천광역시","옹진군",204,150,37,81,23,2,4,0,0,0,0,0,1,1,1,150,0,54
"11860","덕적면","덕적면제4투","대통령선거","인천광역시","옹진군",73,59,11,42,3,1,1,0,1,0,0,0,0,0,0,59,0,14
"11861","덕적면","덕적면제5투","대통령선거","인천광역시","옹진군",54,33,8,13,4,2,2,1,0,2,0,0,1,0,0,33,0,21
"11862","덕적면","덕적면제6투","대통령선거","인천광역시","옹진군",51,42,15,20,3,1,2,0,0,0,0,0,0,0,0,41,1,9
"11863","자월면","관내사전투표","대통령선거","인천광역시","옹진군",225,225,60,99,44,14,7,0,0,0,0,0,1,0,0,225,0,0
"11864","자월면","자월면제1투","대통령선거","인천광역시","옹진군",305,183,39,89,39,7,3,0,0,0,0,2,1,1,0,181,2,122
"11865","자월면","자월면제2투","대통령선거","인천광역시","옹진군",190,141,13,66,51,5,4,0,0,0,0,0,0,0,0,139,2,49
"11866","자월면","자월면제3투","대통령선거","인천광역시","옹진군",217,165,27,81,40,4,9,0,0,0,1,0,0,0,0,162,3,52
"11867","자월면","자월면제4투","대통령선거","인천광역시","옹진군",79,61,8,31,16,2,3,0,0,0,0,0,0,0,0,60,1,18
"11868","영흥면","관내사전투표","대통령선거","인천광역시","옹진군",907,907,310,287,185,37,41,1,0,1,0,1,3,3,5,874,33,0
"11869","영흥면","영흥면제1투","대통령선거","인천광역시","옹진군",1551,928,257,357,205,49,53,1,0,0,0,1,0,0,1,924,4,623
"11870","영흥면","영흥면제2투","대통령선거","인천광역시","옹진군",1348,828,190,332,219,36,40,5,0,1,1,0,0,1,2,827,1,520
"11871","영흥면","영흥면제3투","대통령선거","인천광역시","옹진군",797,556,120,268,122,20,16,1,0,2,0,0,1,2,1,553,3,241
"11872","잘못 투입·구분된 투표지","잘못 투입·구분된 투표지","대통령선거","인천광역시","옹진군",0,1,1,0,0,0,0,0,0,0,0,0,0,0,0,1,0,-1
"11873","거소·선상투표","거소·선상투표","대통령선거","제주특별자치도","제주시",1182,1116,474,152,277,65,54,4,5,5,3,5,8,6,6,1064,52,66
"11874","관외사전투표","관외사전투표","대통령선거","제주특별자치도","제주시",22492,22491,10799,2512,4218,2146,2501,15,7,15,3,19,11,8,52,22306,185,1
"11875","재외투표","재외투표","대통령선거","제주특별자치도","제주시",4418,2259,1178,130,628,62,246,5,0,0,0,3,1,0,0,2253,6,2159
"11876","한림읍","관내사전투표","대통령선거","제주특별자치도","제주시",2271,2271,1146,363,424,106,204,2,0,3,0,3,0,3,4,2258,13,0
"11877","한림읍","한림읍제1투","대통령선거","제주특별자치도","제주시",1301,863,331,245,166,53,58,1,0,1,0,1,0,2,2,860,3,438
"11878","한림읍","한림읍제2투","대통령선거","제주특별자치도","제주시",1205,722,275,201,158,29,48,0,0,2,0,0,3,0,5,721,1,483
"11879","한림읍","한림읍제3투","대통령선거","제주특별자치도","제주시",2002,1135,420,306,296,47,54,0,0,1,0,0,0,0,3,1127,8,867
"11880","한림읍","한림읍제4투","대통령선거","제주특별자치도","제주시",717,506,283,95,91,10,22,0,0,0,0,0,1,0,2,504,2,211
"11881","한림읍","한림읍제5투","대통령선거","제주특별자치도","제주시",1004,639,212,202,159,30,24,3,0,1,0,0,0,1,1,633,6,365
"11882","한림읍","한림읍제6투","대통령선거","제주특별자치도","제주시",976,587,248,173,113,15,28,0,0,1,0,0,1,1,3,583,4,389
"11883","한림읍","한림읍제7투","대통령선거","제주특별자치도","제주시",1396,897,352,221,194,51,61,0,2,1,0,2,0,0,4,888,9,499
"11884","한림읍","한림읍제8투","대통령선거","제주특별자치도","제주시",1063,711,289,197,132,34,38,1,1,1,0,0,0,2,5,700,11,352
"11885","한림읍","한림읍제9투","대통령선거","제주특별자치도","제주시",1286,757,273,160,186,35,90,1,0,0,0,1,0,3,1,750,7,529
"11886","한림읍","한림읍제10투","대통령선거","제주특별자치도","제주시",1605,854,325,227,199,46,46,0,0,0,1,0,2,1,3,850,4,751
"11887","한림읍","한림읍제11투","대통령선거","제주특별자치도","제주시",115,76,5,45,21,3,0,0,1,0,0,0,0,0,0,75,1,39
"11888","한림읍","한림읍제12투","대통령선거","제주특별자치도","제주시",488,307,142,72,70,5,11,0,0,2,1,0,2,0,1,306,1,181
"11889","한림읍","한림읍제13투","대통령선거","제주특별자치도","제주시",566,371,130,121,80,12,16,0,0,1,0,0,1,3,2,366,5,195
"11890","애월읍","관내사전투표","대통령선거","제주특별자치도","제주시",1832,1832,980,235,332,89,165,1,1,3,1,3,0,2,3,1815,17,0
"11891","애월읍","애월읍제1투","대통령선거","제주특별자치도","제주시",2088,1160,452,293,256,61,78,0,0,5,1,1,1,1,2,1151,9,928
"11892","애월읍","애월읍제2투","대통령선거","제주특별자치도","제주시",1085,723,287,145,180,28,71,2,1,1,1,0,2,1,1,720,3,362
"11893","애월읍","애월읍제3투","대통령선거","제주특별자치도","제주시",2231,1401,548,324,339,78,84,3,0,0,0,1,4,5,4,1390,11,830
"11894","애월읍","애월읍제4투","대통령선거","제주특별자치도","제주시",2874,1878,777,401,439,87,153,3,0,0,1,2,2,3,3,1871,7,996
"11895","애월읍","애월읍제5투","대통령선거","제주특별자치도","제주시",896,625,252,125,155,33,50,0,0,1,0,0,1,2,2,621,4,271
"11896","애월읍","애월읍제6투","대통령선거","제주특별자치도","제주시",2733,1799,782,369,381,82,170,3,0,0,0,1,1,0,2,1791,8,934
"11897","애월읍","애월읍제7투","대통령선거","제주특별자치도","제주시",907,641,265,154,138,24,43,0,0,0,0,4,1,1,2,632,9,266
"11898","애월읍","애월읍제8투","대통령선거","제주특별자치도","제주시",1077,735,334,148,151,48,39,0,0,0,0,0,0,5,4,729,6,342
"11899","애월읍","애월읍제9투","대통령선거","제주특별자치도","제주시",902,617,270,143,127,28,41,0,0,0,1,0,1,1,0,612,5,285
"11900","애월읍","애월읍제10투","대통령선거","제주특별자치도","제주시",838,607,232,129,153,33,48,0,1,0,0,0,0,0,1,597,10,231
"11901","애월읍","애월읍제11투","대통령선거","제주특별자치도","제주시",3045,2110,992,371,453,122,161,0,0,0,0,0,2,1,1,2103,7,935
"11902","애월읍","애월읍제12투","대통령선거","제주특별자치도","제주시",986,687,311,145,135,26,57,0,0,0,0,3,1,0,3,681,6,299
"11903","애월읍","애월읍제13투","대통령선거","제주특별자치도","제주시",1144,701,300,155,141,38,57,0,2,0,1,0,1,0,1,696,5,443
"11904","구좌읍","관내사전투표","대통령선거","제주특별자치도","제주시",1334,1334,668,216,231,75,127,1,0,1,0,2,0,2,4,1327,7,0
"11905","구좌읍","구좌읍제1투","대통령선거","제주특별자치도","제주시",2012,1360,498,372,301,71,90,2,0,3,0,0,3,5,3,1348,12,652
"11906","구좌읍","구좌읍제2투","대통령선거","제주특별자치도","제주시",1224,716,236,227,152,38,42,2,1,1,1,3,4,0,3,710,6,508
"11907","구좌읍","구좌읍제3투","대통령선거","제주특별자치도","제주시",964,559,247,139,108,25,32,0,0,0,0,1,1,0,1,554,5,405
"11908","구좌읍","구좌읍제4투","대통령선거","제주특별자치도","제주시",839,554,230,122,118,13,48,0,1,0,0,3,0,2,5,542,12,285
"11909","구좌읍","구좌읍제5투","대통령선거","제주특별자치도","제주시",1680,908,324,248,216,35,67,2,0,1,0,1,3,2,0,899,9,772
"11910","구좌읍","구좌읍제6투","대통령선거","제주특별자치도","제주시",1240,742,253,217,173,37,49,1,0,3,0,0,1,2,0,736,6,498
"11911","구좌읍","구좌읍제7투","대통령선거","제주특별자치도","제주시",858,598,219,125,179,26,35,1,0,0,0,1,2,0,0,588,10,260
"11912","구좌읍","구좌읍제8투","대통령선거","제주특별자치도","제주시",538,379,115,127,85,23,23,1,0,0,0,0,0,0,1,375,4,159
"11913","구좌읍","구좌읍제9투","대통령선거","제주특별자치도","제주시",867,541,188,194,101,17,34,1,1,0,0,0,1,0,1,538,3,326
"11914","조천읍","관내사전투표","대통령선거","제주특별자치도","제주시",2335,2335,1165,395,393,122,216,8,1,1,0,4,2,1,4,2312,23,0
"11915","조천읍","조천읍제1투","대통령선거","제주특별자치도","제주시",2818,1915,733,424,442,119,174,0,1,3,2,2,0,3,2,1905,10,903
"11916","조천읍","조천읍제2투","대통령선거","제주특별자치도","제주시",1704,973,342,275,229,53,62,0,0,1,0,1,1,3,2,969,4,731
"11917","조천읍","조천읍제3투","대통령선거","제주특별자치도","제주시",1701,1114,431,260,281,54,76,1,0,0,0,0,2,1,3,1109,5,587
"11918","조천읍","조천읍제4투","대통령선거","제주특별자치도","제주시",889,621,226,168,146,31,43,1,1,1,0,0,1,0,1,619,2,268
"11919","조천읍","조천읍제5투","대통령선거","제주특별자치도","제주시",922,619,281,152,107,17,44,0,0,8,0,0,0,2,2,613,6,303
"11920","조천읍","조천읍제6투","대통령선거","제주특별자치도","제주시",1919,1237,457,293,301,81,86,2,1,2,1,0,1,2,3,1230,7,682
"11921","조천읍","조천읍제7투","대통령선거","제주특별자치도","제주시",1875,1205,477,280,276,65,91,2,0,0,1,2,1,0,1,1196,9,670
"11922","조천읍","조천읍제8투","대통령선거","제주특별자치도","제주시",2635,1706,692,422,358,92,128,0,2,1,0,0,1,1,2,1699,7,929
"11923","한경면","관내사전투표","대통령선거","제주특별자치도","제주시",839,839,383,178,158,40,59,1,1,1,0,1,2,3,3,830,9,0
"11924","한경면","한경면제1투","대통령선거","제주특별자치도","제주시",557,377,148,92,78,19,32,0,0,0,0,1,0,1,1,372,5,180
"11925","한경면","한경면제2투","대통령선거","제주특별자치도","제주시",814,546,219,153,102,29,23,1,0,0,0,1,0,3,6,537,9,268
"11926","한경면","한경면제3투","대통령선거","제주특별자치도","제주시",1588,934,407,230,176,29,71,3,0,2,0,0,2,2,6,928,6,654
"11927","한경면","한경면제4투","대통령선거","제주특별자치도","제주시",1356,845,322,238,179,36,54,1,0,0,0,2,1,4,1,838,7,511
"11928","한경면","한경면제5투","대통령선거","제주특별자치도","제주시",1493,999,437,233,217,33,62,0,0,0,0,0,1,2,7,992,7,494
"11929","추자면","관내사전투표","대통령선거","제주특별자치도","제주시",321,321,140,62,82,17,15,0,0,0,1,1,0,1,0,319,2,0
"11930","추자면","추자면제1투","대통령선거","제주특별자치도","제주시",739,332,102,85,122,3,10,0,0,1,0,0,2,1,3,329,3,407
"11931","추자면","추자면제2투","대통령선거","제주특별자치도","제주시",482,277,131,62,66,7,3,1,0,0,0,1,0,0,2,273,4,205
"11932","우도면","관내사전투표","대통령선거","제주특별자치도","제주시",358,358,185,65,67,19,18,0,0,1,0,0,0,0,0,355,3,0
"11933","우도면","우도면투표소","대통령선거","제주특별자치도","제주시",1099,592,266,137,111,30,38,1,0,0,0,1,0,2,2,588,4,507
"11934","일도1동","관내사전투표","대통령선거","제주특별자치도","제주시",828,828,416,133,137,40,95,2,0,1,0,0,0,0,3,827,1,0
"11935","일도1동","일도1동투표소","대통령선거","제주특별자치도","제주시",2200,1126,391,274,319,51,79,1,0,3,0,0,0,2,1,1121,5,1074
"11936","일도2동","관내사전투표","대통령선거","제주특별자치도","제주시",3576,3576,1840,557,613,224,302,5,0,5,2,8,0,5,1,3562,14,0
"11937","일도2동","일도2동제1투","대통령선거","제주특별자치도","제주시",2173,1379,567,305,320,74,100,1,1,0,1,4,1,0,1,1375,4,794
"11938","일도2동","일도2동제2투","대통령선거","제주특별자치도","제주시",2480,1480,576,358,336,74,106,2,0,3,2,3,1,1,2,1464,16,1000
"11939","일도2동","일도2동제3투","대통령선거","제주특별자치도","제주시",2222,1550,616,365,338,87,125,3,0,1,1,5,0,0,0,1541,9,672
"11940","일도2동","일도2동제4투","대통령선거","제주특별자치도","제주시",2453,1526,597,356,348,88,127,1,1,1,1,0,0,1,1,1522,4,927
"11941","일도2동","일도2동제5투","대통령선거","제주특별자치도","제주시",1792,1232,519,230,287,78,105,2,0,1,2,0,1,0,0,1225,7,560
"11942","일도2동","일도2동제6투","대통령선거","제주특별자치도","제주시",2513,1662,695,349,388,104,113,3,0,0,3,0,0,1,0,1656,6,851
"11943","일도2동","일도2동제7투","대통령선거","제주특별자치도","제주시",2984,2185,1015,364,428,145,217,1,1,2,0,0,0,0,3,2176,9,799
"11944","일도2동","일도2동제8투","대통령선거","제주특별자치도","제주시",2867,2071,910,385,464,114,187,2,0,2,0,2,0,0,2,2068,3,796
"11945","일도2동","일도2동제9투","대통령선거","제주특별자치도","제주시",2246,1726,750,336,369,121,139,4,0,1,0,1,0,0,2,1723,3,520
"11946","이도1동","관내사전투표","대통령선거","제주특별자치도","제주시",1674,1674,834,285,305,105,131,4,2,2,0,2,1,0,0,1671,3,0
"11947","이도1동","이도1동제1투","대통령선거","제주특별자치도","제주시",1582,896,348,210,197,56,75,0,0,0,1,1,1,0,0,889,7,686
"11948","이도1동","이도1동제2투","대통령선거","제주특별자치도","제주시",1844,1167,485,238,258,84,96,0,0,0,0,1,0,0,0,1162,5,677
"11949","이도1동","이도1동제3투","대통령선거","제주특별자치도","제주시",1653,1083,403,234,283,79,78,2,0,0,0,1,0,0,0,1080,3,570
"11950","이도2동","관내사전투표","대통령선거","제주특별자치도","제주시",6369,6369,3363,802,939,421,795,3,1,3,2,3,1,1,5,6339,30,0
"11951","이도2동","이도2동제1투","대통령선거","제주특별자치도","제주시",2849,1859,791,358,397,118,166,3,0,3,0,1,4,1,3,1845,14,990
"11952","이도2동","이도2동제2투","대통령선거","제주특별자치도","제주시",4301,3119,1617,397,628,189,266,2,1,0,0,5,1,1,1,3108,11,1182
"11953","이도2동","이도2동제3투","대통령선거","제주특별자치도","제주시",3243,1909,800,397,397,113,178,2,1,2,3,3,1,1,3,1901,8,1334
"11954","이도2동","이도2동제4투","대통령선거","제주특별자치도","제주시",3591,2535,1196,411,493,186,231,2,1,0,0,0,1,1,2,2524,11,1056
"11955","이도2동","이도2동제5투","대통령선거","제주특별자치도","제주시",2154,1531,843,164,286,103,128,0,0,0,1,0,1,0,1,1527,4,623
"11956","이도2동","이도2동제6투","대통령선거","제주특별자치도","제주시",2687,1669,667,428,353,80,130,0,2,0,0,1,0,0,1,1662,7,1018
"11957","이도2동","이도2동제7투","대통령선거","제주특별자치도","제주시",3323,2197,968,416,434,145,210,4,2,2,0,1,2,0,3,2187,10,1126
"11958","이도2동","이도2동제8투","대통령선거","제주특별자치도","제주시",2075,1567,644,321,361,102,123,5,0,1,0,1,1,1,1,1561,6,508
"11959","이도2동","이도2동제9투","대통령선거","제주특별자치도","제주시",2136,1471,705,251,278,101,123,0,0,1,0,4,0,0,0,1463,8,665
"11960","이도2동","이도2동제10투","대통령선거","제주특별자치도","제주시",3677,2637,1271,425,487,188,242,0,1,1,1,1,0,0,0,2617,20,1040
"11961","삼도1동","관내사전투표","대통령선거","제주특별자치도","제주시",1890,1890,937,339,305,86,201,6,0,1,1,2,0,0,2,1880,10,0
"11962","삼도1동","삼도1동제1투","대통령선거","제주특별자치도","제주시",2462,1625,667,382,338,100,130,0,1,1,0,2,0,0,1,1622,3,837
"11963","삼도1동","삼도1동제2투","대통령선거","제주특별자치도","제주시",1803,1139,425,256,287,69,88,5,1,2,0,1,1,0,1,1136,3,664
"11964","삼도1동","삼도1동제3투","대통령선거","제주특별자치도","제주시",2605,1575,651,385,335,80,116,0,0,0,1,1,0,0,2,1571,4,1030
"11965","삼도1동","삼도1동제4투","대통령선거","제주특별자치도","제주시",2316,1531,566,382,361,91,119,0,0,1,0,2,0,1,1,1524,7,785
"11966","삼도2동","관내사전투표","대통령선거","제주특별자치도","제주시",1018,1018,523,163,169,65,92,0,0,2,0,0,0,1,1,1016,2,0
"11967","삼도2동","삼도2동제1투","대통령선거","제주특별자치도","제주시",2078,1274,515,245,335,72,96,2,1,0,0,0,3,0,2,1271,3,804
"11968","삼도2동","삼도2동제2투","대통령선거","제주특별자치도","제주시",1763,1012,352,278,253,55,69,1,0,1,0,0,0,0,0,1009,3,751
"11969","삼도2동","삼도2동제3투","대통령선거","제주특별자치도","제주시",2055,1294,487,322,308,82,81,2,2,2,1,0,0,0,1,1288,6,761
"11970","용담1동","관내사전투표","대통령선거","제주특별자치도","제주시",921,921,445,166,165,55,83,3,0,0,0,2,0,0,0,919,2,0
"11971","용담1동","용담1동제1투","대통령선거","제주특별자치도","제주시",2010,1153,477,276,248,62,80,1,0,1,1,0,0,1,0,1147,6,857
"11972","용담1동","용담1동제2투","대통령선거","제주특별자치도","제주시",1644,958,402,212,229,52,53,0,0,1,1,2,2,0,0,954,4,686
"11973","용담1동","용담1동제3투","대통령선거","제주특별자치도","제주시",1520,1001,378,245,230,61,79,0,1,0,0,1,0,1,1,997,4,519
"11974","용담2동","관내사전투표","대통령선거","제주특별자치도","제주시",1756,1756,883,307,300,107,148,1,0,0,0,1,1,1,1,1750,6,0
"11975","용담2동","용담2동제1투","대통령선거","제주특별자치도","제주시",2129,1315,529,299,287,80,112,0,0,0,0,2,0,2,3,1314,1,814
"11976","용담2동","용담2동제2투","대통령선거","제주특별자치도","제주시",2345,1369,549,301,319,81,108,3,0,0,1,1,0,0,2,1365,4,976
"11977","용담2동","용담2동제3투","대통령선거","제주특별자치도","제주시",1826,1197,496,259,257,63,102,2,2,1,0,1,2,4,2,1191,6,629
"11978","용담2동","용담2동제4투","대통령선거","제주특별자치도","제주시",1955,1205,478,260,259,74,122,0,0,1,1,0,1,1,2,1199,6,750
"11979","용담2동","용담2동제5투","대통령선거","제주특별자치도","제주시",2104,1430,571,302,351,84,112,2,0,0,0,0,1,0,2,1425,5,674
"11980","건입동","관내사전투표","대통령선거","제주특별자치도","제주시",1570,1570,769,285,307,81,114,1,2,0,0,2,2,0,0,1563,7,0
"11981","건입동","건입동제1투","대통령선거","제주특별자치도","제주시",714,315,112,96,73,14,16,0,0,0,0,0,0,0,1,312,3,399
"11982","건입동","건입동제2투","대통령선거","제주특별자치도","제주시",1818,1091,437,244,256,69,73,0,0,3,1,2,0,1,2,1088,3,727
"11983","건입동","건입동제3투","대통령선거","제주특별자치도","제주시",2094,1386,554,306,318,71,120,1,2,1,2,1,1,1,3,1381,5,708
"11984","건입동","건입동제4투","대통령선거","제주특별자치도","제주시",1778,1117,457,246,259,53,90,1,1,2,0,4,1,0,0,1114,3,661
"11985","화북동","관내사전투표","대통령선거","제주특별자치도","제주시",2580,2580,1383,336,429,162,256,3,0,2,1,1,0,2,0,2575,5,0
"11986","화북동","화북동제1투","대통령선거","제주특별자치도","제주시",1884,1250,456,239,367,74,99,3,0,1,1,1,1,1,2,1245,5,634
"11987","화북동","화북동제2투","대통령선거","제주특별자치도","제주시",2049,1309,584,246,285,63,117,1,0,2,0,2,0,0,5,1305,4,740
"11988","화북동","화북동제3투","대통령선거","제주특별자치도","제주시",1443,925,347,192,238,58,72,2,2,2,0,1,2,2,1,919,6,518
"11989","화북동","화북동제4투","대통령선거","제주특별자치도","제주시",2183,1349,581,247,303,89,116,1,2,2,0,1,1,1,2,1346,3,834
"11990","화북동","화북동제5투","대통령선거","제주특별자치도","제주시",1938,1464,714,207,303,92,132,1,0,2,1,2,1,0,1,1456,8,474
"11991","화북동","화북동제6투","대통령선거","제주특별자치도","제주시",2202,1523,742,201,325,95,147,5,1,0,0,2,0,0,0,1518,5,679
"11992","화북동","화북동제7투","대통령선거","제주특별자치도","제주시",3335,2319,1147,308,501,140,204,0,1,1,1,2,0,1,4,2310,9,1016
"11993","삼양동","관내사전투표","대통령선거","제주특별자치도","제주시",2987,2987,1729,342,488,157,253,0,1,1,0,5,0,2,1,2979,8,0
"11994","삼양동","삼양동제1투","대통령선거","제주특별자치도","제주시",1838,1184,469,258,277,63,102,3,2,1,0,1,0,1,3,1180,4,654
"11995","삼양동","삼양동제2투","대통령선거","제주특별자치도","제주시",2735,1722,716,313,407,123,150,3,0,1,1,0,0,2,3,1719,3,1013
"11996","삼양동","삼양동제3투","대통령선거","제주특별자치도","제주시",1773,1119,511,204,249,52,96,2,0,0,0,0,0,0,0,1114,5,654
"11997","삼양동","삼양동제4투","대통령선거","제주특별자치도","제주시",551,380,153,84,90,18,25,2,0,0,0,1,0,0,3,376,4,171
"11998","삼양동","삼양동제5투","대통령선거","제주특별자치도","제주시",2115,1602,896,134,314,93,153,8,0,0,0,0,0,0,0,1598,4,513
"11999","삼양동","삼양동제6투","대통령선거","제주특별자치도","제주시",3127,2214,1159,271,447,128,196,1,1,0,0,1,0,1,4,2209,5,913
"12000","봉개동","관내사전투표","대통령선거","제주특별자치도","제주시",966,966,474,152,197,51,79,1,0,2,0,0,0,1,1,958,8,0
"12001","봉개동","봉개동제1투","대통령선거","제주특별자치도","제주시",1613,1037,439,217,233,49,84,0,1,0,1,1,0,2,4,1031,6,576
"12002","봉개동","봉개동제2투","대통령선거","제주특별자치도","제주시",385,268,127,56,55,9,17,0,0,0,0,0,1,0,0,265,3,117
"12003","봉개동","봉개동제3투","대통령선거","제주특별자치도","제주시",308,230,80,61,63,6,16,0,0,0,0,0,0,2,1,229,1,78
"12004","아라동","관내사전투표","대통령선거","제주특별자치도","제주시",5566,5566,3160,539,848,377,570,9,3,8,0,9,6,3,5,5537,29,0
"12005","아라동","아라동제1투","대통령선거","제주특별자치도","제주시",4317,2744,1292,380,632,181,230,2,1,3,1,4,1,0,4,2731,13,1573
"12006","아라동","아라동제2투","대통령선거","제주특별자치도","제주시",2865,1925,962,264,371,133,183,0,0,0,0,6,1,0,0,1920,5,940
"12007","아라동","아라동제3투","대통령선거","제주특별자치도","제주시",2140,1379,644,207,331,79,104,3,1,1,0,0,0,1,4,1375,4,761
"12008","아라동","아라동제4투","대통령선거","제주특별자치도","제주시",1388,943,434,134,215,63,86,1,0,1,1,1,1,0,1,938,5,445
"12009","아라동","아라동제5투","대통령선거","제주특별자치도","제주시",4125,2831,1392,403,567,205,250,0,1,1,0,2,1,1,2,2825,6,1294
"12010","오라동","관내사전투표","대통령선거","제주특별자치도","제주시",2642,2642,1486,305,391,164,272,4,1,1,0,8,0,0,3,2635,7,0
"12011","오라동","오라동제1투","대통령선거","제주특별자치도","제주시",2943,1989,868,434,425,96,157,1,3,0,0,0,0,1,1,1986,3,954
"12012","오라동","오라동제2투","대통령선거","제주특별자치도","제주시",4172,2882,1450,354,572,192,293,2,0,1,0,3,0,3,1,2871,11,1290
"12013","연동","관내사전투표","대통령선거","제주특별자치도","제주시",5728,5728,3025,815,910,395,552,2,1,1,1,2,2,5,1,5712,16,0
"12014","연동","연동제1투","대통령선거","제주특별자치도","제주시",2913,1640,691,384,331,113,113,4,0,0,0,0,0,0,1,1637,3,1273
"12015","연동","연동제2투","대통령선거","제주특별자치도","제주시",3551,2218,961,438,451,170,185,2,0,4,0,0,0,0,1,2212,6,1333
"12016","연동","연동제3투","대통령선거","제주특별자치도","제주시",3241,2011,855,434,415,127,168,0,0,1,1,0,1,1,1,2004,7,1230
"12017","연동","연동제4투","대통령선거","제주특별자치도","제주시",3383,1697,697,330,402,105,147,1,3,0,0,1,0,0,2,1688,9,1686
"12018","연동","연동제5투","대통령선거","제주특별자치도","제주시",3535,2381,1103,396,506,133,223,3,1,0,1,0,0,0,3,2369,12,1154
"12019","연동","연동제6투","대통령선거","제주특별자치도","제주시",2893,1915,893,313,410,134,158,1,1,3,0,0,0,0,1,1914,1,978
"12020","연동","연동제7투","대통령선거","제주특별자치도","제주시",2565,1475,598,344,309,97,117,3,0,0,1,1,0,0,0,1470,5,1090
"12021","연동","연동제8투","대통령선거","제주특별자치도","제주시",3981,2584,1163,442,560,187,217,2,0,0,0,1,2,0,2,2576,8,1397
"12022","노형동","관내사전투표","대통령선거","제주특별자치도","제주시",7369,7369,4166,720,1191,470,754,5,2,5,1,15,2,3,5,7339,30,0
"12023","노형동","노형동제1투","대통령선거","제주특별자치도","제주시",2093,1452,658,243,304,97,134,1,2,0,1,2,1,1,1,1445,7,641
"12024","노형동","노형동제2투","대통령선거","제주특별자치도","제주시",2643,1803,843,329,360,103,154,1,0,1,0,0,0,0,5,1796,7,840
"12025","노형동","노형동제3투","대통령선거","제주특별자치도","제주시",3467,2041,885,412,435,128,166,1,0,0,0,0,2,1,0,2030,11,1426
"12026","노형동","노형동제4투","대통령선거","제주특별자치도","제주시",3596,2727,1342,441,559,178,195,0,0,0,1,2,0,0,2,2720,7,869
"12027","노형동","노형동제5투","대통령선거","제주특별자치도","제주시",3174,2036,937,349,445,131,160,4,1,0,1,0,0,0,1,2029,7,1138
"12028","노형동","노형동제6투","대통령선거","제주특별자치도","제주시",4513,2829,1345,446,573,183,259,2,1,0,2,3,0,2,3,2819,10,1684
"12029","노형동","노형동제7투","대통령선거","제주특별자치도","제주시",968,672,322,127,141,32,44,0,1,0,1,1,0,0,0,669,3,296
"12030","노형동","노형동제8투","대통령선거","제주특별자치도","제주시",2986,1998,924,348,397,147,167,1,0,0,0,2,0,1,2,1989,9,988
"12031","노형동","노형동제9투","대통령선거","제주특별자치도","제주시",2830,1842,890,292,395,111,133,1,0,3,1,2,2,0,2,1832,10,988
"12032","노형동","노형동제10투","대통령선거","제주특별자치도","제주시",3588,2631,1275,386,560,201,194,0,1,0,0,1,1,1,2,2622,9,957
"12033","외도동","관내사전투표","대통령선거","제주특별자치도","제주시",3193,3193,1792,399,517,191,267,2,1,2,1,1,4,1,2,3180,13,0
"12034","외도동","외도동제1투","대통령선거","제주특별자치도","제주시",3304,2128,903,383,489,134,192,5,0,2,1,3,2,3,3,2120,8,1176
"12035","외도동","외도동제2투","대통령선거","제주특별자치도","제주시",1337,876,438,100,190,55,78,2,0,2,0,2,0,1,2,870,6,461
"12036","외도동","외도동제3투","대통령선거","제주특별자치도","제주시",3731,2485,1171,370,556,154,215,2,0,0,0,1,3,0,1,2473,12,1246
"12037","외도동","외도동제4투","대통령선거","제주특별자치도","제주시",2620,1959,1004,231,413,117,180,2,0,1,0,7,1,0,2,1958,1,661
"12038","이호동","관내사전투표","대통령선거","제주특별자치도","제주시",571,571,287,92,112,31,45,0,1,0,0,1,0,0,1,570,1,0
"12039","이호동","이호동제1투","대통령선거","제주특별자치도","제주시",927,593,202,154,141,33,53,0,0,1,0,0,2,0,0,586,7,334
"12040","이호동","이호동제2투","대통령선거","제주특별자치도","제주시",1620,1091,500,221,204,58,93,1,0,3,0,0,0,2,3,1085,6,529
"12041","도두동","관내사전투표","대통령선거","제주특별자치도","제주시",533,533,248,92,122,30,36,0,0,1,0,1,0,1,2,533,0,0
"12042","도두동","도두동제1투","대통령선거","제주특별자치도","제주시",1257,821,323,161,205,53,65,2,1,0,1,1,1,1,2,816,5,436
"12043","도두동","도두동제2투","대통령선거","제주특별자치도","제주시",621,455,208,92,106,16,28,0,0,0,0,1,0,0,1,452,3,166
"12044","잘못 투입·구분된 투표지","잘못 투입·구분된 투표지","대통령선거","제주특별자치도","제주시",0,0,0,0,0,0,0,0,0,0,0,0,0,0,0,0,0,0
"12045","거소·선상투표","거소·선상투표","대통령선거","제주특별자치도","서귀포시",588,562,195,88,145,57,17,6,2,0,1,1,8,1,2,523,39,26
"12046","관외사전투표","관외사전투표","대통령선거","제주특별자치도","서귀포시",12687,12687,6111,1658,2276,1048,1437,9,5,7,5,10,3,3,30,12602,85,0
"12047","재외투표","재외투표","대통령선거","제주특별자치도","서귀포시",1610,834,439,52,210,27,98,0,0,0,0,0,0,1,1,828,6,776
"12048","대정읍","관내사전투표","대통령선거","제주특별자치도","서귀포시",1897,1897,891,325,367,115,177,4,2,0,0,3,2,2,2,1890,7,0
"12049","대정읍","대정읍제1투","대통령선거","제주특별자치도","서귀포시",2365,1368,514,342,326,63,102,2,1,2,0,2,1,1,2,1358,10,997
"12050","대정읍","대정읍제2투","대통령선거","제주특별자치도","서귀포시",1827,1044,420,264,237,42,68,1,0,1,0,1,0,0,1,1035,9,783
"12051","대정읍","대정읍제3투","대통령선거","제주특별자치도","서귀포시",1135,741,348,141,150,39,52,0,0,0,0,0,1,1,3,735,6,394
"12052","대정읍","대정읍제4투","대통령선거","제주특별자치도","서귀포시",491,334,123,91,71,22,23,0,1,0,0,0,0,0,0,331,3,157
"12053","대정읍","대정읍제5투","대통령선거","제주특별자치도","서귀포시",1753,1107,429,231,299,59,73,6,0,0,0,1,1,0,3,1102,5,646
"12054","대정읍","대정읍제6투","대통령선거","제주특별자치도","서귀포시",183,114,60,28,13,0,8,0,0,0,0,0,0,0,1,110,4,69
"12055","대정읍","대정읍제7투","대통령선거","제주특별자치도","서귀포시",611,405,153,109,95,16,24,1,0,0,0,1,0,0,3,402,3,206
"12056","대정읍","대정읍제8투","대통령선거","제주특별자치도","서귀포시",2203,1186,464,310,262,50,86,1,0,0,0,2,1,1,2,1179,7,1017
"12057","대정읍","대정읍제9투","대통령선거","제주특별자치도","서귀포시",378,244,87,82,49,6,15,0,1,0,0,0,1,0,0,241,3,134
"12058","대정읍","대정읍제10투","대통령선거","제주특별자치도","서귀포시",474,328,136,69,68,23,26,0,0,2,0,0,0,0,0,324,4,146
"12059","대정읍","대정읍제11투","대통령선거","제주특별자치도","서귀포시",340,256,111,38,70,10,19,1,0,0,0,0,1,3,0,253,3,84
"12060","대정읍","대정읍제12투","대통령선거","제주특별자치도","서귀포시",555,394,159,68,96,27,40,0,0,1,0,0,1,0,0,392,2,161
"12061","남원읍","관내사전투표","대통령선거","제주특별자치도","서귀포시",1392,1392,672,209,295,87,120,1,0,0,0,1,3,2,0,1390,2,0
"12062","남원읍","남원읍제1투","대통령선거","제주특별자치도","서귀포시",602,405,150,106,92,14,30,0,1,1,2,0,1,3,4,404,1,197
"12063","남원읍","남원읍제2투","대통령선거","제주특별자치도","서귀포시",1082,730,287,163,174,42,44,0,0,1,0,2,1,1,3,718,12,352
"12064","남원읍","남원읍제3투","대통령선거","제주특별자치도","서귀포시",783,545,208,121,139,35,29,0,1,2,0,0,2,1,2,540,5,238
"12065","남원읍","남원읍제4투","대통령선거","제주특별자치도","서귀포시",2681,1621,678,337,362,82,140,1,0,4,0,0,0,1,3,1608,13,1060
"12066","남원읍","남원읍제5투","대통령선거","제주특별자치도","서귀포시",1232,808,298,215,178,39,62,0,3,1,0,1,0,4,2,803,5,424
"12067","남원읍","남원읍제6투","대통령선거","제주특별자치도","서귀포시",1357,839,361,161,200,35,66,0,1,0,1,1,2,2,3,833,6,518
"12068","남원읍","남원읍제7투","대통령선거","제주특별자치도","서귀포시",744,509,214,146,87,18,34,0,1,0,0,1,1,2,1,505,4,235
"12069","남원읍","남원읍제8투","대통령선거","제주특별자치도","서귀포시",1861,1162,475,273,227,75,100,3,1,0,0,0,0,0,3,1157,5,699
"12070","남원읍","남원읍제9투","대통령선거","제주특별자치도","서귀포시",369,249,115,66,33,6,21,0,0,1,0,0,0,1,3,246,3,120
"12071","남원읍","남원읍제10투","대통령선거","제주특별자치도","서귀포시",508,351,142,90,78,11,21,0,0,0,1,2,1,1,2,349,2,157
"12072","남원읍","남원읍제11투","대통령선거","제주특별자치도","서귀포시",278,198,73,50,40,14,18,0,0,1,0,0,0,1,0,197,1,80
"12073","남원읍","남원읍제12투","대통령선거","제주특별자치도","서귀포시",408,275,121,60,52,10,22,0,2,1,0,0,1,1,1,271,4,133
"12074","남원읍","남원읍제13투","대통령선거","제주특별자치도","서귀포시",401,271,113,50,69,11,22,0,3,0,0,0,0,1,0,269,2,130
"12075","남원읍","남원읍제14투","대통령선거","제주특별자치도","서귀포시",325,230,100,41,58,10,14,0,2,2,1,0,1,0,0,229,1,95
"12076","성산읍","관내사전투표","대통령선거","제주특별자치도","서귀포시",1338,1338,596,282,252,74,119,1,3,0,0,1,0,0,3,1331,7,0
"12077","성산읍","성산읍제1투","대통령선거","제주특별자치도","서귀포시",1176,719,255,202,166,37,49,3,0,1,0,0,1,1,2,717,2,457
"12078","성산읍","성산읍제2투","대통령선거","제주특별자치도","서귀포시",784,479,157,148,118,19,26,0,0,3,0,0,1,0,0,472,7,305
"12079","성산읍","성산읍제3투","대통령선거","제주특별자치도","서귀포시",2217,1138,423,265,278,75,81,0,0,1,0,2,0,1,2,1128,10,1079
"12080","성산읍","성산읍제4투","대통령선거","제주특별자치도","서귀포시",932,591,181,170,152,15,64,1,0,0,0,0,0,0,2,585,6,341
"12081","성산읍","성산읍제5투","대통령선거","제주특별자치도","서귀포시",998,610,189,163,154,24,63,0,1,2,0,0,2,0,5,603,7,388
"12082","성산읍","성산읍제6투","대통령선거","제주특별자치도","서귀포시",781,501,180,124,112,19,56,0,0,0,0,0,0,0,2,493,8,280
"12083","성산읍","성산읍제7투","대통령선거","제주특별자치도","서귀포시",456,313,119,82,73,14,14,1,1,1,1,0,1,2,0,309,4,143
"12084","성산읍","성산읍제8투","대통령선거","제주특별자치도","서귀포시",376,253,71,78,67,16,16,0,1,0,0,0,2,0,2,253,0,123
"12085","성산읍","성산읍제9투","대통령선거","제주특별자치도","서귀포시",627,400,120,116,113,15,18,0,2,1,1,0,1,2,3,392,8,227
"12086","성산읍","성산읍제10투","대통령선거","제주특별자치도","서귀포시",444,298,124,69,76,9,17,0,0,0,0,0,0,1,0,296,2,146
"12087","성산읍","성산읍제11투","대통령선거","제주특별자치도","서귀포시",734,448,143,133,113,18,29,0,1,1,0,0,1,4,0,443,5,286
"12088","성산읍","성산읍제12투","대통령선거","제주특별자치도","서귀포시",433,315,133,66,75,17,18,0,1,0,0,1,1,0,1,313,2,118
"12089","안덕면","관내사전투표","대통령선거","제주특별자치도","서귀포시",847,847,414,144,157,43,79,1,0,0,4,0,0,1,1,844,3,0
"12090","안덕면","안덕면제1투","대통령선거","제주특별자치도","서귀포시",1631,1058,412,261,229,49,87,1,0,1,0,2,0,4,2,1048,10,573
"12091","안덕면","안덕면제2투","대통령선거","제주특별자치도","서귀포시",1547,989,389,240,234,38,74,2,0,0,0,0,1,2,1,981,8,558
"12092","안덕면","안덕면제3투","대통령선거","제주특별자치도","서귀포시",721,502,196,118,115,24,39,0,3,1,0,0,0,3,0,499,3,219
"12093","안덕면","안덕면제4투","대통령선거","제주특별자치도","서귀포시",871,555,211,129,112,44,41,0,1,1,9,2,1,1,0,552,3,316
"12094","안덕면","안덕면제5투","대통령선거","제주특별자치도","서귀포시",651,433,210,60,90,31,33,0,0,1,0,0,0,1,4,430,3,218
"12095","안덕면","안덕면제6투","대통령선거","제주특별자치도","서귀포시",418,286,119,69,54,13,29,0,0,0,1,1,0,0,0,286,0,132
"12096","안덕면","안덕면제7투","대통령선거","제주특별자치도","서귀포시",587,408,173,72,93,20,36,2,2,0,1,0,0,1,1,401,7,179
"12097","안덕면","안덕면제8투","대통령선거","제주특별자치도","서귀포시",455,351,139,68,68,14,54,1,0,1,0,0,0,0,1,346,5,104
"12098","표선면","관내사전투표","대통령선거","제주특별자치도","서귀포시",1576,1576,664,376,325,78,112,6,4,1,0,1,0,0,1,1568,8,0
"12099","표선면","표선면제1투","대통령선거","제주특별자치도","서귀포시",3010,1593,589,392,400,92,96,4,1,1,0,0,1,5,2,1583,10,1417
"12100","표선면","표선면제2투","대통령선거","제주특별자치도","서귀포시",695,459,159,133,99,26,30,0,0,2,0,0,1,2,1,453,6,236
"12101","표선면","표선면제3투","대통령선거","제주특별자치도","서귀포시",945,612,188,212,142,33,28,2,2,0,0,0,0,2,0,609,3,333
"12102","표선면","표선면제4투","대통령선거","제주특별자치도","서귀포시",553,379,143,102,92,16,18,2,0,1,0,0,1,2,0,377,2,174
"12103","표선면","표선면제5투","대통령선거","제주특별자치도","서귀포시",826,573,266,104,127,24,31,0,1,0,0,0,3,5,6,567,6,253
"12104","표선면","표선면제6투","대통령선거","제주특별자치도","서귀포시",306,233,104,37,61,7,21,0,0,0,0,0,1,1,1,233,0,73
"12105","표선면","표선면제7투","대통령선거","제주특별자치도","서귀포시",474,313,116,65,84,16,27,0,0,1,0,0,0,0,2,311,2,161
"12106","표선면","표선면제8투","대통령선거","제주특별자치도","서귀포시",420,279,89,58,92,21,16,0,0,0,0,0,0,0,1,277,2,141
"12107","표선면","표선면제9투","대통령선거","제주특별자치도","서귀포시",184,139,74,28,27,4,5,0,0,0,0,1,0,0,0,139,0,45
"12108","송산동","관내사전투표","대통령선거","제주특별자치도","서귀포시",537,537,250,92,108,30,55,1,0,0,0,0,0,1,0,537,0,0
"12109","송산동","송산동제1투","대통령선거","제주특별자치도","서귀포시",1549,838,316,230,212,31,41,1,0,0,0,1,0,2,1,835,3,711
"12110","송산동","송산동제2투","대통령선거","제주특별자치도","서귀포시",1599,982,388,239,186,68,89,1,0,1,0,0,1,1,3,977,5,617
"12111","정방동","관내사전투표","대통령선거","제주특별자치도","서귀포시",575,575,276,99,109,26,61,0,1,2,1,0,0,0,0,575,0,0
"12112","정방동","정방동투표소","대통령선거","제주특별자치도","서귀포시",1794,902,331,258,193,49,59,4,1,2,0,0,0,0,1,898,4,892
"12113","중앙동","관내사전투표","대통령선거","제주특별자치도","서귀포시",623,623,275,125,138,31,49,0,1,0,0,0,0,0,1,620,3,0
"12114","중앙동","중앙동투표소","대통령선거","제주특별자치도","서귀포시",2825,1472,528,388,388,68,83,1,0,2,0,0,0,1,2,1461,11,1353
"12115","천지동","관내사전투표","대통령선거","제주특별자치도","서귀포시",686,686,320,130,141,31,57,0,0,4,0,0,1,0,0,684,2,0
"12116","천지동","천지동제1투","대통령선거","제주특별자치도","서귀포시",2372,1344,452,377,362,64,70,3,2,3,0,3,0,0,1,1337,7,1028
"12117","천지동","천지동제2투","대통령선거","제주특별자치도","서귀포시",191,130,51,29,36,7,6,0,0,0,0,0,0,0,0,129,1,61
"12118","효돈동","관내사전투표","대통령선거","제주특별자치도","서귀포시",849,849,428,127,170,40,62,1,12,0,0,1,1,0,2,844,5,0
"12119","효돈동","효돈동제1투","대통령선거","제주특별자치도","서귀포시",1390,904,370,217,188,51,62,0,8,3,0,0,1,2,0,902,2,486
"12120","효돈동","효돈동제2투","대통령선거","제주특별자치도","서귀포시",1987,1285,477,343,266,57,71,2,56,2,1,1,0,2,2,1280,5,702
"12121","영천동","관내사전투표","대통령선거","제주특별자치도","서귀포시",579,579,260,98,123,38,57,0,0,0,1,0,0,0,0,577,2,0
"12122","영천동","영천동제1투","대통령선거","제주특별자치도","서귀포시",2403,1468,621,316,327,72,106,2,1,1,1,3,6,3,1,1460,8,935
"12123","영천동","영천동제2투","대통령선거","제주특별자치도","서귀포시",523,339,131,94,77,14,19,0,0,0,0,0,0,1,0,336,3,184
"12124","영천동","영천동제3투","대통령선거","제주특별자치도","서귀포시",452,286,96,87,71,9,17,0,0,0,0,0,1,0,2,283,3,166
"12125","동홍동","관내사전투표","대통령선거","제주특별자치도","서귀포시",2524,2524,1320,355,436,149,230,5,2,5,0,5,0,1,1,2509,15,0
"12126","동홍동","동홍동제1투","대통령선거","제주특별자치도","서귀포시",2968,1674,750,283,413,80,126,2,3,1,0,3,0,1,4,1666,8,1294
"12127","동홍동","동홍동제2투","대통령선거","제주특별자치도","서귀포시",3592,2154,959,385,475,136,181,2,2,1,0,1,1,2,0,2145,9,1438
"12128","동홍동","동홍동제3투","대통령선거","제주특별자치도","서귀포시",3501,2247,1037,379,495,132,180,3,5,3,0,2,0,1,3,2240,7,1254
"12129","동홍동","동홍동제4투","대통령선거","제주특별자치도","서귀포시",2680,1737,750,355,395,99,101,1,2,8,2,1,1,5,5,1725,12,943
"12130","서홍동","관내사전투표","대통령선거","제주특별자치도","서귀포시",1450,1450,719,218,293,82,125,0,0,0,0,2,1,0,1,1441,9,0
"12131","서홍동","서홍동제1투","대통령선거","제주특별자치도","서귀포시",3705,2309,1096,359,522,129,183,3,1,1,0,0,0,0,1,2295,14,1396
"12132","서홍동","서홍동제2투","대통령선거","제주특별자치도","서귀포시",2231,1355,582,278,272,96,113,1,4,2,0,0,0,0,0,1348,7,876
"12133","대륜동","관내사전투표","대통령선거","제주특별자치도","서귀포시",2574,2574,1396,343,413,194,205,2,4,3,1,0,0,0,4,2565,9,0
"12134","대륜동","대륜동제1투","대통령선거","제주특별자치도","서귀포시",1738,1112,391,290,258,68,87,2,3,1,0,0,2,1,3,1106,6,626
"12135","대륜동","대륜동제2투","대통령선거","제주특별자치도","서귀포시",2717,1829,834,312,418,128,127,2,0,3,1,0,1,1,1,1828,1,888
"12136","대륜동","대륜동제3투","대통령선거","제주특별자치도","서귀포시",1338,877,338,188,229,46,50,1,4,2,0,0,3,0,1,862,15,461
"12137","대륜동","대륜동제4투","대통령선거","제주특별자치도","서귀포시",1945,1272,531,266,296,81,86,2,2,0,0,1,0,0,1,1266,6,673
"12138","대천동","관내사전투표","대통령선거","제주특별자치도","서귀포시",701,701,364,102,139,52,42,0,0,1,0,0,0,0,0,700,1,0
"12139","대천동","대천동제1투","대통령선거","제주특별자치도","서귀포시",1337,865,382,196,185,32,61,1,0,1,0,0,1,0,2,861,4,472
"12140","대천동","대천동제2투","대통령선거","제주특별자치도","서귀포시",2184,1381,620,215,349,91,91,2,0,3,0,1,0,3,1,1376,5,803
"12141","대천동","대천동제3투","대통령선거","제주특별자치도","서귀포시",662,420,139,99,112,26,36,0,0,0,0,0,1,1,0,414,6,242
"12142","대천동","대천동제4투","대통령선거","제주특별자치도","서귀포시",412,284,149,41,53,12,25,1,0,0,0,0,1,0,1,283,1,128
"12143","대천동","대천동제5투","대통령선거","제주특별자치도","서귀포시",1694,1086,464,230,229,74,82,1,3,0,0,1,1,0,0,1085,1,608
"12144","중문동","관내사전투표","대통령선거","제주특별자치도","서귀포시",1473,1473,790,172,254,95,142,1,0,3,0,3,1,0,3,1464,9,0
"12145","중문동","중문동제1투","대통령선거","제주특별자치도","서귀포시",3755,2376,1052,414,550,152,176,1,0,7,1,3,2,2,3,2363,13,1379
"12146","중문동","중문동제2투","대통령선거","제주특별자치도","서귀포시",1144,761,300,164,161,49,60,0,1,1,0,0,2,1,8,747,14,383
"12147","중문동","중문동제3투","대통령선거","제주특별자치도","서귀포시",982,680,304,110,163,36,58,1,1,2,0,0,1,0,1,677,3,302
"12148","중문동","중문동제4투","대통령선거","제주특별자치도","서귀포시",467,319,121,80,72,20,22,0,0,0,0,1,1,0,0,317,2,148
"12149","예래동","관내사전투표","대통령선거","제주특별자치도","서귀포시",359,359,161,63,83,18,27,0,2,1,0,1,0,1,1,358,1,0
"12150","예래동","예래동제1투","대통령선거","제주특별자치도","서귀포시",693,446,182,95,96,24,41,1,1,1,0,0,0,0,3,444,2,247
"12151","예래동","예래동제2투","대통령선거","제주특별자치도","서귀포시",1452,899,375,193,199,55,59,1,0,1,0,4,0,3,1,891,8,553
"12152","예래동","예래동제3투","대통령선거","제주특별자치도","서귀포시",363,259,107,52,67,19,10,0,0,0,3,0,0,0,0,258,1,104
"12153","잘못 투입·구분된 투표지","잘못 투입·구분된 투표지","대통령선거","제주특별자치도","서귀포시",0,0,0,0,0,0,0,0,0,0,0,0,0,0,0,0,0,0
"12154","거소·선상투표","거소·선상투표","대통령선거","전라북도","전주시완산구",935,879,466,46,258,24,23,4,2,3,2,5,0,2,4,839,40,56
"12155","관외사전투표","관외사전투표","대통령선거","전라북도","전주시완산구",29336,29321,19738,811,5245,1275,2032,12,3,17,4,23,4,14,34,29212,109,15
"12156","재외투표","재외투표","대통령선거","전라북도","전주시완산구",1560,1263,945,27,144,17,122,3,0,0,0,0,0,0,0,1258,5,297
"12157","중앙동","관내사전투표","대통령선거","전라북도","전주시완산구",1952,1952,1247,73,480,53,94,0,0,0,0,1,1,0,1,1950,2,0
"12158","중앙동","중앙동제1투","대통령선거","전라북도","전주시완산구",1770,1079,644,56,309,26,42,0,0,0,0,0,0,0,1,1078,1,691
"12159","중앙동","중앙동제2투","대통령선거","전라북도","전주시완산구",2331,1667,909,105,522,58,63,0,1,0,1,0,0,0,1,1660,7,664
"12160","중앙동","중앙동제3투","대통령선거","전라북도","전주시완산구",1587,1024,600,31,330,22,39,0,0,0,0,0,0,0,0,1022,2,563
"12161","풍남동","관내사전투표","대통령선거","전라북도","전주시완산구",1244,1244,824,36,244,44,84,2,1,0,1,1,1,0,1,1239,5,0
"12162","풍남동","풍남동제1투","대통령선거","전라북도","전주시완산구",1669,1101,666,56,303,19,49,1,0,3,0,0,0,1,1,1099,2,568
"12163","풍남동","풍남동제2투","대통령선거","전라북도","전주시완산구",1834,1206,754,46,343,15,38,1,0,1,1,1,0,2,2,1204,2,628
"12164","노송동","관내사전투표","대통령선거","전라북도","전주시완산구",1418,1418,902,39,364,34,60,0,0,4,1,2,1,1,5,1413,5,0
"12165","노송동","노송동제1투","대통령선거","전라북도","전주시완산구",2137,1494,930,51,403,30,73,0,0,2,0,1,0,1,0,1491,3,643
"12166","노송동","노송동제2투","대통령선거","전라북도","전주시완산구",1353,945,572,45,262,18,42,0,1,0,1,0,1,1,0,943,2,408
"12167","노송동","노송동제3투","대통령선거","전라북도","전주시완산구",1189,781,490,25,222,11,27,1,0,1,0,0,0,0,0,777,4,408
"12168","노송동","노송동제4투","대통령선거","전라북도","전주시완산구",1805,1269,782,53,324,36,59,1,0,2,1,1,2,2,1,1264,5,536
"12169","노송동","노송동제5투","대통령선거","전라북도","전주시완산구",1433,893,503,40,293,12,40,0,0,2,0,0,0,0,0,890,3,540
"12170","완산동","관내사전투표","대통령선거","전라북도","전주시완산구",1126,1126,728,25,264,41,57,0,0,6,1,0,0,0,0,1122,4,0
"12171","완산동","완산동제1투","대통령선거","전라북도","전주시완산구",1903,1281,811,61,340,21,39,1,0,2,0,1,0,1,2,1279,2,622
"12172","완산동","완산동제2투","대통령선거","전라북도","전주시완산구",1698,1071,646,49,288,22,54,1,0,3,0,1,0,0,0,1064,7,627
"12173","동서학동","관내사전투표","대통령선거","전라북도","전주시완산구",1368,1368,900,45,303,36,75,2,0,0,0,0,0,0,0,1361,7,0
"12174","동서학동","동서학동제1투","대통령선거","전라북도","전주시완산구",1966,1365,864,56,340,29,67,0,0,1,1,0,1,0,1,1360,5,601
"12175","동서학동","동서학동제2투","대통령선거","전라북도","전주시완산구",1010,636,372,22,194,9,33,0,0,2,0,1,0,0,2,635,1,374
"12176","동서학동","동서학동제3투","대통령선거","전라북도","전주시완산구",1506,1031,659,34,272,14,43,0,0,0,0,2,0,1,3,1028,3,475
"12177","서서학동","관내사전투표","대통령선거","전라북도","전주시완산구",1748,1748,1144,52,435,33,74,0,1,4,0,0,1,0,0,1744,4,0
"12178","서서학동","서서학동제1투","대통령선거","전라북도","전주시완산구",1950,1295,806,48,346,33,54,1,0,1,0,1,0,0,2,1292,3,655
"12179","서서학동","서서학동제2투","대통령선거","전라북도","전주시완산구",2208,1554,1025,46,382,24,66,1,0,1,1,1,0,1,2,1550,4,654
"12180","서서학동","서서학동제3투","대통령선거","전라북도","전주시완산구",1966,1383,905,37,316,31,82,0,2,3,0,1,0,0,1,1378,5,583
"12181","중화산1동","관내사전투표","대통령선거","전라북도","전주시완산구",3480,3480,2397,101,710,91,170,0,0,1,2,2,0,1,0,3475,5,0
"12182","중화산1동","중화산1동제1투","대통령선거","전라북도","전주시완산구",2973,2152,1426,84,491,37,101,0,1,2,0,3,0,0,2,2147,5,821
"12183","중화산1동","중화산1동제2투","대통령선거","전라북도","전주시완산구",2851,2096,1367,85,455,70,104,3,0,2,0,0,1,2,0,2089,7,755
"12184","중화산1동","중화산1동제3투","대통령선거","전라북도","전주시완산구",2747,2051,1232,124,531,53,96,0,0,2,1,1,1,0,1,2042,9,696
"12185","중화산2동","관내사전투표","대통령선거","전라북도","전주시완산구",3252,3252,2297,79,597,102,167,0,1,1,0,2,0,2,1,3249,3,0
"12186","중화산2동","중화산2동제1투","대통령선거","전라북도","전주시완산구",2646,2174,1418,75,513,62,93,2,0,2,0,3,0,1,2,2171,3,472
"12187","중화산2동","중화산2동제2투","대통령선거","전라북도","전주시완산구",3035,1789,1131,64,419,51,106,1,0,2,0,2,1,2,0,1779,10,1246
"12188","중화산2동","중화산2동제3투","대통령선거","전라북도","전주시완산구",2550,1746,1145,52,384,45,115,0,0,2,0,0,0,0,2,1745,1,804
"12189","중화산2동","중화산2동제4투","대통령선거","전라북도","전주시완산구",2206,1643,1114,48,350,46,81,0,0,1,0,0,0,0,0,1640,3,563
"12190","평화1동","관내사전투표","대통령선거","전라북도","전주시완산구",3221,3221,2117,101,735,71,140,2,2,5,3,2,3,3,9,3193,28,0
"12191","평화1동","평화1동제1투","대통령선거","전라북도","전주시완산구",2877,1857,1178,66,499,43,60,0,0,2,0,0,1,0,2,1851,6,1020
"12192","평화1동","평화1동제2투","대통령선거","전라북도","전주시완산구",2441,1460,944,54,369,25,48,0,0,3,0,0,2,2,5,1452,8,981
"12193","평화1동","평화1동제3투","대통령선거","전라북도","전주시완산구",2832,2024,1359,60,412,63,109,5,0,6,0,2,0,1,3,2020,4,808
"12194","평화2동","관내사전투표","대통령선거","전라북도","전주시완산구",7264,7264,4934,171,1565,191,361,0,2,10,0,3,1,1,3,7242,22,0
"12195","평화2동","평화2동제1투","대통령선거","전라북도","전주시완산구",2517,1820,1149,57,471,50,75,3,0,3,1,3,0,0,0,1812,8,697
"12196","평화2동","평화2동제2투","대통령선거","전라북도","전주시완산구",2842,2059,1431,61,404,45,103,0,0,4,0,2,2,1,4,2057,2,783
"12197","평화2동","평화2동제3투","대통령선거","전라북도","전주시완산구",2146,1440,910,42,396,32,46,0,0,0,3,1,0,0,1,1431,9,706
"12198","평화2동","평화2동제4투","대통령선거","전라북도","전주시완산구",3119,2533,1794,66,471,65,129,1,0,2,0,1,0,1,1,2531,2,586
"12199","평화2동","평화2동제5투","대통령선거","전라북도","전주시완산구",1254,862,572,17,216,16,35,0,0,1,0,0,0,0,2,859,3,392
"12200","평화2동","평화2동제6투","대통령선거","전라북도","전주시완산구",2977,2378,1628,61,483,59,131,0,1,2,0,0,1,1,2,2369,9,599
"12201","평화2동","평화2동제7투","대통령선거","전라북도","전주시완산구",2425,1880,1247,43,432,47,103,0,0,1,0,1,0,0,1,1875,5,545
"12202","평화2동","평화2동제8투","대통령선거","전라북도","전주시완산구",3310,2608,1807,69,543,61,118,0,0,4,0,0,0,1,0,2603,5,702
"12203","평화2동","평화2동제9투","대통령선거","전라북도","전주시완산구",3031,2430,1711,47,490,66,109,0,0,1,1,0,1,0,2,2428,2,601
"12204","서신동","관내사전투표","대통령선거","전라북도","전주시완산구",7983,7983,5608,170,1448,246,478,2,3,9,0,0,1,0,4,7969,14,0
"12205","서신동","서신동제1투","대통령선거","전라북도","전주시완산구",2021,1479,1008,42,309,51,65,0,0,1,1,0,0,0,0,1477,2,542
"12206","서신동","서신동제2투","대통령선거","전라북도","전주시완산구",2395,1573,1033,56,353,38,89,0,0,2,0,0,0,0,1,1572,1,822
"12207","서신동","서신동제3투","대통령선거","전라북도","전주시완산구",1610,1213,728,65,308,39,66,2,0,0,0,2,0,1,1,1212,1,397
"12208","서신동","서신동제4투","대통령선거","전라북도","전주시완산구",1470,1089,679,50,263,29,58,0,0,2,0,3,0,1,0,1085,4,381
"12209","서신동","서신동제5투","대통령선거","전라북도","전주시완산구",2459,1734,1181,35,379,42,87,0,0,0,0,3,0,1,0,1728,6,725
"12210","서신동","서신동제6투","대통령선거","전라북도","전주시완산구",1682,1376,976,40,251,36,68,0,0,0,0,0,1,0,1,1373,3,306
"12211","서신동","서신동제7투","대통령선거","전라북도","전주시완산구",1961,1518,1106,34,256,36,78,0,0,2,0,1,1,0,0,1514,4,443
"12212","서신동","서신동제8투","대통령선거","전라북도","전주시완산구",2640,2191,1488,68,422,73,130,0,0,2,0,2,0,1,3,2189,2,449
"12213","서신동","서신동제9투","대통령선거","전라북도","전주시완산구",2449,2048,1450,35,358,64,133,2,0,2,0,2,0,1,0,2047,1,401
"12214","서신동","서신동제10투","대통령선거","전라북도","전주시완산구",3402,2392,1574,64,528,78,139,0,0,0,0,0,0,0,3,2386,6,1010
"12215","삼천1동","관내사전투표","대통령선거","전라북도","전주시완산구",2646,2646,1797,64,541,79,144,0,0,2,0,2,0,0,2,2631,15,0
"12216","삼천1동","삼천1동제1투","대통령선거","전라북도","전주시완산구",2131,1431,951,49,311,32,73,0,0,7,0,0,0,0,0,1423,8,700
"12217","삼천1동","삼천1동제2투","대통령선거","전라북도","전주시완산구",3179,2480,1651,81,535,83,114,0,0,4,0,1,0,0,0,2469,11,699
"12218","삼천1동","삼천1동제3투","대통령선거","전라북도","전주시완산구",2641,1814,1158,61,425,49,99,0,0,9,0,0,1,0,2,1804,10,827
"12219","삼천2동","관내사전투표","대통령선거","전라북도","전주시완산구",2828,2828,1957,70,582,77,128,0,3,2,0,0,0,1,0,2820,8,0
"12220","삼천2동","삼천2동제1투","대통령선거","전라북도","전주시완산구",2301,1504,1000,35,343,34,83,1,0,0,0,1,0,1,0,1498,6,797
"12221","삼천2동","삼천2동제2투","대통령선거","전라북도","전주시완산구",1648,1201,816,20,258,26,73,1,0,2,0,1,0,1,0,1198,3,447
"12222","삼천2동","삼천2동제3투","대통령선거","전라북도","전주시완산구",2634,2061,1341,93,431,73,110,0,0,4,0,0,0,0,2,2054,7,573
"12223","삼천2동","삼천2동제4투","대통령선거","전라북도","전주시완산구",2594,1698,1103,58,396,40,88,0,0,6,0,1,0,0,0,1692,6,896
"12224","삼천3동","관내사전투표","대통령선거","전라북도","전주시완산구",4331,4331,3142,81,745,99,224,2,1,1,2,5,2,2,1,4307,24,0
"12225","삼천3동","삼천3동제1투","대통령선거","전라북도","전주시완산구",2222,1686,1181,46,313,45,95,0,0,1,0,1,0,0,0,1682,4,536
"12226","삼천3동","삼천3동제2투","대통령선거","전라북도","전주시완산구",950,631,379,33,164,18,27,0,0,4,0,0,0,2,2,629,2,319
"12227","삼천3동","삼천3동제3투","대통령선거","전라북도","전주시완산구",2565,2033,1392,42,409,48,127,0,0,2,0,1,1,0,0,2022,11,532
"12228","삼천3동","삼천3동제4투","대통령선거","전라북도","전주시완산구",2303,1878,1356,40,332,46,98,0,0,4,0,0,0,0,1,1877,1,425
"12229","삼천3동","삼천3동제5투","대통령선거","전라북도","전주시완산구",2378,1668,1061,56,424,46,68,1,1,0,0,0,2,0,2,1661,7,710
"12230","삼천3동","삼천3동제6투","대통령선거","전라북도","전주시완산구",2525,2063,1414,41,389,74,129,0,1,1,1,1,1,1,4,2057,6,462
"12231","효자1동","관내사전투표","대통령선거","전라북도","전주시완산구",3145,3145,2074,94,694,89,172,0,1,0,0,3,0,0,1,3128,17,0
"12232","효자1동","효자1동제1투","대통령선거","전라북도","전주시완산구",2670,1976,1256,102,444,69,92,1,0,3,0,0,0,0,1,1968,8,694
"12233","효자1동","효자1동제2투","대통령선거","전라북도","전주시완산구",2534,1739,1088,75,437,44,78,0,0,7,0,1,0,3,2,1735,4,795
"12234","효자1동","효자1동제3투","대통령선거","전라북도","전주시완산구",2219,1615,970,79,427,48,80,0,0,0,0,1,1,0,2,1608,7,604
"12235","효자2동","관내사전투표","대통령선거","전라북도","전주시완산구",2762,2762,1812,93,628,79,137,1,2,3,0,0,0,0,2,2757,5,0
"12236","효자2동","효자2동제1투","대통령선거","전라북도","전주시완산구",2222,1580,1027,47,380,39,69,1,3,5,0,1,0,0,1,1573,7,642
"12237","효자2동","효자2동제2투","대통령선거","전라북도","전주시완산구",1623,1140,689,53,311,28,43,0,1,4,1,2,0,2,3,1137,3,483
"12238","효자2동","효자2동제3투","대통령선거","전라북도","전주시완산구",2643,1903,1236,69,439,49,93,1,0,6,1,1,0,0,1,1896,7,740
"12239","효자3동","관내사전투표","대통령선거","전라북도","전주시완산구",4252,4252,2904,90,873,127,235,1,1,7,0,1,1,0,0,4240,12,0
"12240","효자3동","효자3동제1투","대통령선거","전라북도","전주시완산구",1864,1396,822,67,397,38,66,0,0,2,1,0,0,0,0,1393,3,468
"12241","효자3동","효자3동제2투","대통령선거","전라북도","전주시완산구",2607,2026,1290,75,480,61,109,0,1,4,0,1,1,0,0,2022,4,581
"12242","효자3동","효자3동제3투","대통령선거","전라북도","전주시완산구",2257,1742,1156,63,387,48,78,0,4,0,0,0,0,1,0,1737,5,515
"12243","효자3동","효자3동제4투","대통령선거","전라북도","전주시완산구",2090,1664,1144,48,357,29,75,0,0,4,0,1,0,0,0,1658,6,426
"12244","효자4동","관내사전투표","대통령선거","전라북도","전주시완산구",8996,8995,6407,162,1498,338,562,2,0,5,0,3,0,4,1,8982,13,1
"12245","효자4동","효자4동제1투","대통령선거","전라북도","전주시완산구",1827,1460,881,48,373,42,65,0,0,45,0,0,0,0,1,1455,5,367
"12246","효자4동","효자4동제2투","대통령선거","전라북도","전주시완산구",2782,2300,1469,68,559,80,117,1,0,0,0,2,0,1,0,2297,3,482
"12247","효자4동","효자4동제3투","대통령선거","전라북도","전주시완산구",3528,2417,1640,53,489,80,146,0,0,4,0,0,1,0,3,2416,1,1111
"12248","효자4동","효자4동제4투","대통령선거","전라북도","전주시완산구",1863,1367,944,29,280,25,81,0,0,2,0,0,0,0,0,1361,6,496
"12249","효자4동","효자4동제5투","대통령선거","전라북도","전주시완산구",3075,2347,1577,70,505,83,104,0,0,0,0,1,0,1,1,2342,5,728
"12250","효자4동","효자4동제6투","대통령선거","전라북도","전주시완산구",3302,2331,1598,64,428,84,140,1,0,1,2,2,1,1,2,2324,7,971
"12251","효자4동","효자4동제7투","대통령선거","전라북도","전주시완산구",3140,1909,1262,45,384,85,129,1,0,1,0,1,0,0,0,1908,1,1231
"12252","효자4동","효자4동제8투","대통령선거","전라북도","전주시완산구",3201,2181,1516,62,380,61,147,1,0,5,1,1,1,1,0,2176,5,1020
"12253","효자4동","효자4동제9투","대통령선거","전라북도","전주시완산구",3379,2594,1728,73,568,98,119,0,0,1,0,1,1,0,2,2591,3,785
"12254","효자4동","효자4동제10투","대통령선거","전라북도","전주시완산구",2561,2192,1593,38,357,55,139,3,0,0,0,3,1,0,0,2189,3,369
"12255","효자4동","효자4동제11투","대통령선거","전라북도","전주시완산구",1853,1495,1015,45,315,42,74,0,0,1,0,1,0,0,0,1493,2,358
"12256","효자4동","효자4동제12투","대통령선거","전라북도","전주시완산구",2076,1502,987,30,342,34,100,0,0,1,0,1,0,0,1,1496,6,574
"12257","효자4동","효자4동제13투","대통령선거","전라북도","전주시완산구",2104,1671,1121,36,369,51,87,1,0,1,0,2,0,0,0,1668,3,433
"12258","효자4동","효자4동제14투","대통령선거","전라북도","전주시완산구",2931,2516,1759,54,469,91,139,0,0,2,0,0,0,0,0,2514,2,415
"12259","잘못 투입·구분된 투표지","잘못 투입·구분된 투표지","대통령선거","전라북도","전주시완산구",0,4,2,0,1,1,0,0,0,0,0,0,0,0,0,4,0,-4
"12260","거소·선상투표","거소·선상투표","대통령선거","전라북도","전주시덕진구",626,587,321,34,169,20,13,1,1,3,1,1,1,2,9,576,11,39
"12261","관외사전투표","관외사전투표","대통령선거","전라북도","전주시덕진구",23965,23958,16043,634,4406,978,1706,9,7,12,4,21,3,1,32,23856,102,7
"12262","재외투표","재외투표","대통령선거","전라북도","전주시덕진구",1036,816,591,28,100,16,81,0,0,0,0,0,0,0,0,816,0,220
"12263","진북동","관내사전투표","대통령선거","전라북도","전주시덕진구",3161,3161,2084,90,702,96,180,2,1,0,1,0,0,0,1,3157,4,0
"12264","진북동","진북동제1투","대통령선거","전라북도","전주시덕진구",2064,1310,803,49,381,18,47,2,0,2,1,0,0,0,2,1305,5,754
"12265","진북동","진북동제2투","대통령선거","전라북도","전주시덕진구",3132,2202,1275,102,667,48,99,0,0,1,0,4,1,0,2,2199,3,930
"12266","진북동","진북동제3투","대통령선거","전라북도","전주시덕진구",2427,1831,1140,71,491,43,78,0,0,1,0,0,0,2,1,1827,4,596
"12267","진북동","진북동제4투","대통령선거","전라북도","전주시덕진구",2100,1654,999,80,465,45,59,0,0,0,0,0,0,0,1,1649,5,446
"12268","인후1동","관내사전투표","대통령선거","전라북도","전주시덕진구",4704,4704,3200,123,993,114,260,2,1,3,0,1,0,1,1,4699,5,0
"12269","인후1동","인후1동제1투","대통령선거","전라북도","전주시덕진구",2946,1972,1268,48,495,49,101,0,0,3,0,2,0,0,0,1966,6,974
"12270","인후1동","인후1동제2투","대통령선거","전라북도","전주시덕진구",2017,1481,1006,40,321,36,68,0,0,3,0,0,0,1,1,1476,5,536
"12271","인후1동","인후1동제3투","대통령선거","전라북도","전주시덕진구",2383,1875,1221,71,414,51,111,0,0,2,0,2,0,0,0,1872,3,508
"12272","인후1동","인후1동제4투","대통령선거","전라북도","전주시덕진구",2523,2019,1350,49,450,54,110,0,0,2,0,0,0,0,1,2016,3,504
"12273","인후2동","관내사전투표","대통령선거","전라북도","전주시덕진구",1822,1822,1203,38,450,45,82,0,0,1,0,1,0,0,0,1820,2,0
"12274","인후2동","인후2동제1투","대통령선거","전라북도","전주시덕진구",1893,1336,834,54,348,31,57,1,0,3,0,1,1,0,1,1331,5,557
"12275","인후2동","인후2동제2투","대통령선거","전라북도","전주시덕진구",1526,948,582,38,268,19,35,0,0,2,0,1,0,1,0,946,2,578
"12276","인후2동","인후2동제3투","대통령선거","전라북도","전주시덕진구",2239,1504,956,48,411,25,52,2,1,2,0,0,0,0,2,1499,5,735
"12277","인후2동","인후2동제4투","대통령선거","전라북도","전주시덕진구",2289,1699,1101,68,400,47,76,1,0,1,0,0,0,0,2,1696,3,590
"12278","인후3동","관내사전투표","대통령선거","전라북도","전주시덕진구",4689,4689,3324,90,838,122,287,0,0,6,1,7,2,2,3,4682,7,0
"12279","인후3동","인후3동제1투","대통령선거","전라북도","전주시덕진구",2882,1666,1063,59,376,47,111,1,0,1,1,1,0,2,1,1663,3,1216
"12280","인후3동","인후3동제2투","대통령선거","전라북도","전주시덕진구",2566,1776,1202,43,371,53,92,0,0,3,1,2,0,1,3,1771,5,790
"12281","인후3동","인후3동제3투","대통령선거","전라북도","전주시덕진구",2308,1662,1163,37,337,45,75,0,0,2,0,0,0,0,1,1660,2,646
"12282","인후3동","인후3동제4투","대통령선거","전라북도","전주시덕진구",2313,1914,1284,68,421,43,93,0,0,0,0,0,0,0,1,1910,4,399
"12283","인후3동","인후3동제5투","대통령선거","전라북도","전주시덕진구",2946,2321,1588,35,447,68,169,0,0,2,0,1,0,3,3,2316,5,625
"12284","인후3동","인후3동제6투","대통령선거","전라북도","전주시덕진구",2832,2167,1523,64,396,51,125,1,1,1,0,1,0,0,1,2164,3,665
"12285","인후3동","인후3동제7투","대통령선거","전라북도","전주시덕진구",2214,1322,858,37,283,35,95,2,0,4,0,2,0,0,1,1317,5,892
"12286","덕진동","관내사전투표","대통령선거","전라북도","전주시덕진구",2485,2484,1703,48,486,83,147,1,0,2,0,4,0,2,2,2478,6,1
"12287","덕진동","덕진동제1투","대통령선거","전라북도","전주시덕진구",1992,1232,734,55,342,38,56,0,0,1,0,0,1,2,1,1230,2,760
"12288","덕진동","덕진동제2투","대통령선거","전라북도","전주시덕진구",2270,1576,975,74,385,43,92,1,0,0,1,0,0,0,2,1573,3,694
"12289","덕진동","덕진동제3투","대통령선거","전라북도","전주시덕진구",2409,1759,1131,49,426,40,105,0,0,3,0,2,0,1,0,1757,2,650
"12290","덕진동","덕진동제4투","대통령선거","전라북도","전주시덕진구",2700,1948,1325,42,426,42,100,0,0,4,0,2,0,1,2,1944,4,752
"12291","덕진동","덕진동제5투","대통령선거","전라북도","전주시덕진구",2961,2454,1756,34,458,78,124,0,0,0,1,0,1,0,0,2452,2,507
"12292","금암1동","관내사전투표","대통령선거","전라북도","전주시덕진구",2580,2580,1688,50,433,123,261,0,0,3,2,2,0,0,0,2562,18,0
"12293","금암1동","금암1동제1투","대통령선거","전라북도","전주시덕진구",2297,1480,885,68,406,33,78,1,0,1,1,0,0,0,1,1474,6,817
"12294","금암1동","금암1동제2투","대통령선거","전라북도","전주시덕진구",2345,1615,983,70,434,57,61,0,2,0,1,0,1,0,1,1610,5,730
"12295","금암2동","관내사전투표","대통령선거","전라북도","전주시덕진구",2295,2295,1490,54,560,52,125,2,0,3,0,2,0,0,4,2292,3,0
"12296","금암2동","금암2동제1투","대통령선거","전라북도","전주시덕진구",2023,1327,812,56,352,37,59,0,0,4,1,1,0,0,2,1324,3,696
"12297","금암2동","금암2동제2투","대통령선거","전라북도","전주시덕진구",2207,1623,1042,48,389,48,83,0,0,5,0,1,0,0,2,1618,5,584
"12298","금암2동","금암2동제3투","대통령선거","전라북도","전주시덕진구",2030,1482,899,57,410,50,57,0,0,2,0,0,0,1,2,1478,4,548
"12299","팔복동","관내사전투표","대통령선거","전라북도","전주시덕진구",1871,1871,1256,55,409,33,104,0,0,2,1,1,0,0,1,1862,9,0
"12300","팔복동","팔복동제1투","대통령선거","전라북도","전주시덕진구",2157,1291,811,42,346,25,55,0,0,0,0,0,1,0,6,1286,5,866
"12301","팔복동","팔복동제2투","대통령선거","전라북도","전주시덕진구",2590,1713,1142,45,395,39,81,3,0,2,0,0,0,1,0,1708,5,877
"12302","팔복동","팔복동제3투","대통령선거","전라북도","전주시덕진구",990,653,416,25,159,17,30,1,0,1,1,0,0,0,2,652,1,337
"12303","우아1동","관내사전투표","대통령선거","전라북도","전주시덕진구",1794,1794,1180,68,399,52,85,0,1,0,0,0,0,0,3,1788,6,0
"12304","우아1동","우아1동제1투","대통령선거","전라북도","전주시덕진구",2187,1414,827,80,396,42,61,0,0,4,0,1,0,2,0,1413,1,773
"12305","우아1동","우아1동제2투","대통령선거","전라북도","전주시덕진구",1399,926,622,35,194,18,54,0,0,0,0,0,0,0,0,923,3,473
"12306","우아1동","우아1동제3투","대통령선거","전라북도","전주시덕진구",2223,1373,839,47,392,27,62,0,0,0,0,0,1,0,1,1369,4,850
"12307","우아2동","관내사전투표","대통령선거","전라북도","전주시덕진구",2854,2854,2010,71,535,86,146,0,0,0,0,0,0,0,0,2848,6,0
"12308","우아2동","우아2동제1투","대통령선거","전라북도","전주시덕진구",2066,1520,1009,47,344,30,78,1,0,3,0,0,1,1,1,1515,5,546
"12309","우아2동","우아2동제2투","대통령선거","전라북도","전주시덕진구",2857,1786,1151,55,403,57,108,0,0,2,1,0,0,0,1,1778,8,1071
"12310","우아2동","우아2동제3투","대통령선거","전라북도","전주시덕진구",653,460,290,16,121,4,20,0,0,0,0,0,0,0,7,458,2,193
"12311","우아2동","우아2동제4투","대통령선거","전라북도","전주시덕진구",3446,2055,1378,61,455,47,98,0,0,3,0,2,0,0,2,2046,9,1391
"12312","호성동","관내사전투표","대통령선거","전라북도","전주시덕진구",3865,3865,2757,80,691,98,222,0,0,1,0,5,0,1,3,3858,7,0
"12313","호성동","호성동제1투","대통령선거","전라북도","전주시덕진구",1026,751,425,35,221,16,34,1,1,1,1,2,2,1,6,746,5,275
"12314","호성동","호성동제2투","대통령선거","전라북도","전주시덕진구",2745,2139,1453,85,443,41,106,0,0,0,2,1,0,0,4,2135,4,606
"12315","호성동","호성동제3투","대통령선거","전라북도","전주시덕진구",2273,1812,1283,41,341,56,84,1,1,0,0,2,0,0,0,1809,3,461
"12316","호성동","호성동제4투","대통령선거","전라북도","전주시덕진구",2764,2212,1514,50,473,55,109,1,0,1,0,2,2,0,2,2209,3,552
"12317","호성동","호성동제5투","대통령선거","전라북도","전주시덕진구",3050,2488,1653,88,512,73,145,3,0,3,0,2,1,0,1,2481,7,562
"12318","송천1동","관내사전투표","대통령선거","전라북도","전주시덕진구",4863,4863,3319,98,967,139,320,0,1,2,3,7,0,0,2,4858,5,0
"12319","송천1동","송천1동제1투","대통령선거","전라북도","전주시덕진구",2190,1538,957,53,416,35,72,0,1,1,0,0,0,0,0,1535,3,652
"12320","송천1동","송천1동제2투","대통령선거","전라북도","전주시덕진구",2227,1671,1137,37,339,46,100,2,0,1,0,2,1,0,1,1666,5,556
"12321","송천1동","송천1동제3투","대통령선거","전라북도","전주시덕진구",2622,1895,1272,52,384,50,122,3,0,1,0,0,0,2,2,1888,7,727
"12322","송천1동","송천1동제4투","대통령선거","전라북도","전주시덕진구",2443,1922,1318,64,383,47,106,0,0,3,0,1,0,0,0,1922,0,521
"12323","송천1동","송천1동제5투","대통령선거","전라북도","전주시덕진구",2500,2108,1471,62,368,53,145,0,0,0,1,2,0,0,1,2103,5,392
"12324","송천1동","송천1동제6투","대통령선거","전라북도","전주시덕진구",2878,2394,1659,47,442,75,158,0,0,2,0,0,0,4,2,2389,5,484
"12325","송천1동","송천1동제7투","대통령선거","전라북도","전주시덕진구",2607,2084,1435,44,421,63,115,0,0,1,0,0,0,0,1,2080,4,523
"12326","송천1동","송천1동제8투","대통령선거","전라북도","전주시덕진구",2907,2503,1786,56,395,79,175,1,0,0,0,3,0,1,0,2496,7,404
"12327","송천2동","관내사전투표","대통령선거","전라북도","전주시덕진구",6084,6084,4297,110,1070,154,436,0,1,2,1,4,1,0,1,6077,7,0
"12328","송천2동","송천2동제1투","대통령선거","전라북도","전주시덕진구",1801,1312,862,30,298,33,82,0,0,0,0,0,1,1,0,1307,5,489
"12329","송천2동","송천2동제2투","대통령선거","전라북도","전주시덕진구",2261,1831,1231,45,363,49,136,0,0,1,1,0,0,0,1,1827,4,430
"12330","송천2동","송천2동제3투","대통령선거","전라북도","전주시덕진구",1669,1230,786,33,287,40,76,0,0,2,0,1,1,0,0,1226,4,439
"12331","송천2동","송천2동제4투","대통령선거","전라북도","전주시덕진구",2232,1676,1096,36,405,35,98,0,0,3,0,1,1,0,1,1676,0,556
"12332","송천2동","송천2동제5투","대통령선거","전라북도","전주시덕진구",3019,2401,1575,67,575,63,116,0,0,1,1,1,0,1,0,2400,1,618
"12333","송천2동","송천2동제6투","대통령선거","전라북도","전주시덕진구",905,639,405,15,186,12,18,0,0,0,0,0,0,0,1,637,2,266
"12334","송천2동","송천2동제7투","대통령선거","전라북도","전주시덕진구",2586,2075,1404,47,415,55,135,3,1,3,0,1,2,0,1,2067,8,511
"12335","조촌동","관내사전투표","대통령선거","전라북도","전주시덕진구",2269,2269,1600,38,449,43,118,0,0,5,0,2,2,0,4,2261,8,0
"12336","조촌동","조촌동제1투","대통령선거","전라북도","전주시덕진구",2051,1508,1034,28,300,42,93,0,0,4,0,1,0,0,2,1504,4,543
"12337","조촌동","조촌동제2투","대통령선거","전라북도","전주시덕진구",2290,1427,929,52,328,28,75,0,0,1,0,0,1,0,3,1417,10,863
"12338","조촌동","조촌동제3투","대통령선거","전라북도","전주시덕진구",1373,952,609,23,282,11,22,0,0,1,0,0,0,0,2,950,2,421
"12339","동산동","관내사전투표","대통령선거","전라북도","전주시덕진구",3426,3426,2412,75,655,74,186,0,0,3,1,0,1,3,3,3413,13,0
"12340","동산동","동산동제1투","대통령선거","전라북도","전주시덕진구",2586,1744,1137,46,396,53,98,1,0,2,0,0,1,0,0,1734,10,842
"12341","동산동","동산동제2투","대통령선거","전라북도","전주시덕진구",2430,1833,1217,50,424,44,86,0,1,1,0,3,0,0,3,1829,4,597
"12342","동산동","동산동제3투","대통령선거","전라북도","전주시덕진구",3110,2166,1445,38,481,53,129,0,0,3,1,2,1,2,3,2158,8,944
"12343","동산동","동산동제4투","대통령선거","전라북도","전주시덕진구",1783,1330,886,30,300,33,72,2,1,0,0,1,2,0,0,1327,3,453
"12344","동산동","동산동제5투","대통령선거","전라북도","전주시덕진구",4433,3812,2675,78,723,138,192,2,0,0,0,1,0,0,0,3809,3,621
"12345","잘못 투입·구분된 투표지","잘못 투입·구분된 투표지","대통령선거","전라북도","전주시덕진구",0,0,0,0,0,0,0,0,0,0,0,0,0,0,0,0,0,0
"12346","거소·선상투표","거소·선상투표","대통령선거","전라북도","군산시",713,677,366,24,213,23,28,2,1,2,1,1,0,3,4,668,9,36
"12347","관외사전투표","관외사전투표","대통령선거","전라북도","군산시",15900,15893,9959,636,3206,771,1175,7,5,6,2,15,9,5,15,15811,82,7
"12348","재외투표","재외투표","대통령선거","전라북도","군산시",935,711,509,28,84,15,71,1,0,0,0,0,0,1,0,709,2,224
"12349","옥구읍","관내사전투표","대통령선거","전라북도","군산시",1011,1011,652,29,251,33,37,1,1,0,0,2,0,1,1,1008,3,0
"12350","옥구읍","옥구읍투표소","대통령선거","전라북도","군산시",1975,1234,781,54,336,18,34,0,2,0,0,1,1,0,4,1231,3,741
"12351","옥산면","관내사전투표","대통령선거","전라북도","군산시",1029,1029,710,18,222,23,49,0,0,0,0,3,0,1,0,1026,3,0
"12352","옥산면","옥산면투표소","대통령선거","전라북도","군산시",1963,1317,811,58,364,26,46,1,0,2,1,1,0,1,3,1314,3,646
"12353","회현면","관내사전투표","대통령선거","전라북도","군산시",873,873,532,38,227,22,34,0,0,0,0,0,0,3,4,860,13,0
"12354","회현면","회현면투표소","대통령선거","전라북도","군산시",1846,1262,726,57,394,19,52,0,0,1,0,3,1,1,2,1256,6,584
"12355","임피면","관내사전투표","대통령선거","전라북도","군산시",763,763,453,17,239,16,27,0,0,2,0,0,1,2,1,758,5,0
"12356","임피면","임피면투표소","대통령선거","전라북도","군산시",1754,1105,659,52,343,15,24,0,0,2,1,0,1,0,3,1100,5,649
"12357","서수면","관내사전투표","대통령선거","전라북도","군산시",521,521,314,9,160,6,24,0,1,0,3,0,0,0,2,519,2,0
"12358","서수면","서수면투표소","대통령선거","전라북도","군산시",1796,1103,634,45,357,21,28,1,0,0,0,1,1,1,7,1096,7,693
"12359","대야면","관내사전투표","대통령선거","전라북도","군산시",1602,1602,1020,83,419,20,48,2,0,1,0,0,3,0,1,1597,5,0
"12360","대야면","대야면제1투","대통령선거","전라북도","군산시",1479,914,542,42,279,15,26,0,1,1,0,0,0,3,1,910,4,565
"12361","대야면","대야면제2투","대통령선거","전라북도","군산시",1584,944,572,35,274,16,34,0,0,2,0,3,2,0,0,938,6,640
"12362","개정면","관내사전투표","대통령선거","전라북도","군산시",643,643,413,30,171,5,22,0,0,0,0,0,0,0,0,641,2,0
"12363","개정면","개정면투표소","대통령선거","전라북도","군산시",2043,1298,746,74,400,28,42,0,0,0,0,0,1,0,1,1292,6,745
"12364","성산면","관내사전투표","대통령선거","전라북도","군산시",762,762,453,43,210,19,31,0,0,0,1,0,1,0,2,760,2,0
"12365","성산면","성산면투표소","대통령선거","전라북도","군산시",1894,1219,670,63,388,25,57,2,1,2,0,3,1,1,0,1213,6,675
"12366","나포면","관내사전투표","대통령선거","전라북도","군산시",568,568,332,19,168,16,28,0,0,0,0,0,1,1,0,565,3,0
"12367","나포면","나포면투표소","대통령선거","전라북도","군산시",1467,940,537,34,317,11,30,0,0,0,0,0,1,2,5,937,3,527
"12368","옥도면","관내사전투표","대통령선거","전라북도","군산시",193,193,110,12,60,6,4,0,0,0,0,0,0,0,1,193,0,0
"12369","옥도면","옥도면제1투","대통령선거","전라북도","군산시",441,195,139,3,44,3,4,0,0,0,0,0,0,1,0,194,1,246
"12370","옥도면","옥도면제2투","대통령선거","전라북도","군산시",97,55,35,1,17,0,2,0,0,0,0,0,0,0,0,55,0,42
"12371","옥도면","옥도면제3투","대통령선거","전라북도","군산시",232,117,60,7,43,3,1,0,0,0,0,0,0,0,1,115,2,115
"12372","옥도면","옥도면제4투","대통령선거","전라북도","군산시",167,85,60,4,16,0,4,0,0,0,0,0,0,0,0,84,1,82
"12373","옥도면","옥도면제5투","대통령선거","전라북도","군산시",218,151,95,1,52,1,2,0,0,0,0,0,0,0,0,151,0,67
"12374","옥도면","옥도면제6투","대통령선거","전라북도","군산시",696,380,203,9,149,3,8,0,0,1,0,0,1,0,5,379,1,316
"12375","옥도면","옥도면제7투","대통령선거","전라북도","군산시",53,34,22,2,9,0,1,0,0,0,0,0,0,0,0,34,0,19
"12376","옥도면","옥도면제8투","대통령선거","전라북도","군산시",126,62,45,1,16,0,0,0,0,0,0,0,0,0,0,62,0,64
"12377","옥도면","옥도면제9투","대통령선거","전라북도","군산시",39,27,15,3,9,0,0,0,0,0,0,0,0,0,0,27,0,12
"12378","옥도면","옥도면제10투","대통령선거","전라북도","군산시",205,96,40,1,52,1,1,0,0,0,0,0,1,0,0,96,0,109
"12379","옥서면","관내사전투표","대통령선거","전라북도","군산시",919,919,605,34,219,21,38,0,0,0,0,0,0,0,1,918,1,0
"12380","옥서면","옥서면투표소","대통령선거","전라북도","군산시",2303,1472,863,52,464,24,54,0,0,2,0,2,2,0,0,1463,9,831
"12381","해신동","관내사전투표","대통령선거","전라북도","군산시",746,746,474,30,197,9,28,0,0,0,0,0,1,0,0,739,7,0
"12382","해신동","해신동투표소","대통령선거","전라북도","군산시",1719,1014,602,41,327,15,25,0,0,1,0,0,0,1,0,1012,2,705
"12383","월명동","관내사전투표","대통령선거","전라북도","군산시",1560,1560,975,57,415,41,60,0,0,2,0,0,1,1,0,1552,8,0
"12384","월명동","월명동제1투","대통령선거","전라북도","군산시",816,495,251,28,192,9,13,0,1,1,0,0,0,0,0,495,0,321
"12385","월명동","월명동제2투","대통령선거","전라북도","군산시",1360,775,423,42,265,19,22,1,0,0,0,0,0,0,1,773,2,585
"12386","월명동","월명동제3투","대통령선거","전라북도","군산시",2057,1330,774,55,418,23,51,0,0,0,0,0,3,1,1,1326,4,727
"12387","삼학동","관내사전투표","대통령선거","전라북도","군산시",1935,1935,1223,62,512,43,82,1,0,4,1,0,1,0,1,1930,5,0
"12388","삼학동","삼학동제1투","대통령선거","전라북도","군산시",1340,830,441,71,261,17,38,1,0,0,0,1,0,0,0,830,0,510
"12389","삼학동","삼학동제2투","대통령선거","전라북도","군산시",1206,790,469,41,246,13,18,0,0,0,0,0,0,0,1,788,2,416
"12390","삼학동","삼학동제3투","대통령선거","전라북도","군산시",1583,1066,667,34,303,26,29,1,0,1,1,0,0,1,0,1063,3,517
"12391","신풍동","관내사전투표","대통령선거","전라북도","군산시",1349,1349,877,39,326,36,65,0,1,1,0,1,0,1,0,1347,2,0
"12392","신풍동","신풍동제1투","대통령선거","전라북도","군산시",1682,1046,634,56,289,30,29,1,1,3,0,1,0,0,1,1045,1,636
"12393","신풍동","신풍동제2투","대통령선거","전라북도","군산시",1366,883,527,42,260,15,35,0,0,2,0,0,0,0,1,882,1,483
"12394","신풍동","신풍동제3투","대통령선거","전라북도","군산시",1905,1429,874,73,385,30,61,1,0,0,0,1,0,0,1,1426,3,476
"12395","중앙동","관내사전투표","대통령선거","전라북도","군산시",883,883,555,34,246,16,27,0,0,1,0,1,1,0,1,882,1,0
"12396","중앙동","중앙동투표소","대통령선거","전라북도","군산시",2320,1357,768,78,450,20,31,0,0,0,0,0,1,1,1,1350,7,963
"12397","흥남동","관내사전투표","대통령선거","전라북도","군산시",2381,2381,1505,73,625,61,98,1,0,0,0,2,0,2,8,2375,6,0
"12398","흥남동","흥남동제1투","대통령선거","전라북도","군산시",812,446,253,21,149,7,12,0,0,1,0,0,0,0,3,446,0,366
"12399","흥남동","흥남동제2투","대통령선거","전라북도","군산시",2944,2003,1193,95,571,55,81,1,0,0,1,1,0,0,1,1999,4,941
"12400","흥남동","흥남동제3투","대통령선거","전라북도","군산시",1351,956,602,39,250,27,30,1,0,2,0,1,0,0,0,952,4,395
"12401","흥남동","흥남동제4투","대통령선거","전라북도","군산시",1607,1098,668,35,321,23,40,0,1,0,0,1,1,0,1,1091,7,509
"12402","조촌동","관내사전투표","대통령선거","전라북도","군산시",3660,3659,2504,102,785,74,183,0,0,4,0,0,1,1,0,3654,5,1
"12403","조촌동","조촌동제1투","대통령선거","전라북도","군산시",2366,1523,901,59,437,53,65,0,0,1,0,0,0,1,1,1518,5,843
"12404","조촌동","조촌동제2투","대통령선거","전라북도","군산시",2972,1992,1231,64,556,41,91,0,0,0,0,4,1,0,2,1990,2,980
"12405","조촌동","조촌동제3투","대통령선거","전라북도","군산시",1675,1090,631,50,348,19,34,0,0,1,0,0,2,0,1,1086,4,585
"12406","조촌동","조촌동제4투","대통령선거","전라북도","군산시",1775,1318,818,40,366,38,50,0,0,2,0,0,1,0,0,1315,3,457
"12407","경암동","관내사전투표","대통령선거","전라북도","군산시",1589,1589,1023,55,387,47,71,0,1,1,0,0,0,0,2,1587,2,0
"12408","경암동","경암동제1투","대통령선거","전라북도","군산시",1724,1055,560,44,374,26,34,4,0,2,0,2,0,1,2,1049,6,669
"12409","경암동","경암동제2투","대통령선거","전라북도","군산시",2453,1693,1052,59,450,38,83,3,0,3,0,0,1,0,2,1691,2,760
"12410","경암동","경암동제3투","대통령선거","전라북도","군산시",1322,903,506,59,278,20,32,3,0,1,0,0,0,0,0,899,4,419
"12411","구암동","관내사전투표","대통령선거","전라북도","군산시",1030,1030,656,33,253,32,54,0,0,0,0,0,0,0,0,1028,2,0
"12412","구암동","구암동제1투","대통령선거","전라북도","군산시",1717,1150,701,29,348,19,43,1,0,1,0,1,0,1,2,1146,4,567
"12413","구암동","구암동제2투","대통령선거","전라북도","군산시",1960,1469,882,56,413,48,59,2,0,2,0,0,1,1,2,1466,3,491
"12414","개정동","관내사전투표","대통령선거","전라북도","군산시",962,962,621,30,230,29,49,0,0,0,0,1,0,0,0,960,2,0
"12415","개정동","개정동투표소","대통령선거","전라북도","군산시",1791,1233,722,40,370,36,50,1,0,2,1,1,2,0,3,1228,5,558
"12416","수송동","관내사전투표","대통령선거","전라북도","군산시",8535,8535,5968,209,1512,298,508,3,0,1,2,2,0,2,3,8508,27,0
"12417","수송동","수송동제1투","대통령선거","전라북도","군산시",2565,1760,1114,82,400,56,102,1,0,1,0,2,0,0,1,1759,1,805
"12418","수송동","수송동제2투","대통령선거","전라북도","군산시",2154,1576,1035,48,362,45,79,0,1,0,0,0,0,1,0,1571,5,578
"12419","수송동","수송동제3투","대통령선거","전라북도","군산시",2518,1859,1219,61,454,46,74,0,0,1,0,1,1,0,1,1858,1,659
"12420","수송동","수송동제4투","대통령선거","전라북도","군산시",2256,1551,974,62,401,42,65,1,1,3,0,0,0,0,1,1550,1,705
"12421","수송동","수송동제5투","대통령선거","전라북도","군산시",3123,2025,1307,72,475,57,107,1,0,0,0,0,0,0,1,2020,5,1098
"12422","수송동","수송동제6투","대통령선거","전라북도","군산시",3348,2622,1759,89,512,93,156,0,0,5,1,2,0,0,2,2619,3,726
"12423","수송동","수송동제7투","대통령선거","전라북도","군산시",2998,2366,1600,74,477,72,131,0,0,0,1,4,0,0,2,2361,5,632
"12424","수송동","수송동제8투","대통령선거","전라북도","군산시",3226,2476,1617,82,588,55,118,2,0,5,0,1,2,0,1,2471,5,750
"12425","수송동","수송동제9투","대통령선거","전라북도","군산시",3224,2477,1722,73,451,76,146,0,0,1,0,6,0,0,1,2476,1,747
"12426","수송동","수송동제10투","대통령선거","전라북도","군산시",1582,1339,933,31,246,49,76,0,0,0,0,0,0,0,0,1335,4,243
"12427","나운1동","관내사전투표","대통령선거","전라북도","군산시",2457,2457,1621,85,530,67,133,1,1,1,0,6,1,1,2,2449,8,0
"12428","나운1동","나운1동제1투","대통령선거","전라북도","군산시",2286,1500,933,84,379,35,60,0,0,0,1,1,1,0,3,1497,3,786
"12429","나운1동","나운1동제2투","대통령선거","전라북도","군산시",3173,2130,1378,91,502,57,97,0,1,0,0,1,0,0,2,2129,1,1043
"12430","나운1동","나운1동제3투","대통령선거","전라북도","군산시",2191,1440,926,43,392,29,47,0,0,0,0,0,0,0,0,1437,3,751
"12431","나운1동","나운1동제4투","대통령선거","전라북도","군산시",898,544,322,36,145,13,22,0,0,2,0,0,0,1,0,541,3,354
"12432","나운2동","관내사전투표","대통령선거","전라북도","군산시",5897,5897,3956,147,1236,163,368,2,1,1,0,2,1,0,4,5881,16,0
"12433","나운2동","나운2동제1투","대통령선거","전라북도","군산시",2248,1647,1026,79,394,54,92,0,0,0,0,0,0,0,0,1645,2,601
"12434","나운2동","나운2동제2투","대통령선거","전라북도","군산시",1978,1303,747,63,427,21,18,1,0,0,0,1,1,2,8,1289,14,675
"12435","나운2동","나운2동제3투","대통령선거","전라북도","군산시",2209,1610,1047,69,358,52,63,2,1,4,0,5,0,1,1,1603,7,599
"12436","나운2동","나운2동제4투","대통령선거","전라북도","군산시",2759,2137,1434,56,453,57,131,1,0,0,0,3,0,0,1,2136,1,622
"12437","나운2동","나운2동제5투","대통령선거","전라북도","군산시",2637,1999,1283,82,469,55,100,2,0,0,1,2,1,0,1,1996,3,638
"12438","나운2동","나운2동제6투","대통령선거","전라북도","군산시",2014,1469,932,65,340,38,88,0,0,0,0,3,0,1,1,1468,1,545
"12439","나운3동","관내사전투표","대통령선거","전라북도","군산시",4137,4137,2863,105,773,113,261,2,0,1,0,7,1,2,2,4130,7,0
"12440","나운3동","나운3동제1투","대통령선거","전라북도","군산시",2552,1729,1150,59,398,33,82,0,0,0,0,1,0,1,1,1725,4,823
"12441","나운3동","나운3동제2투","대통령선거","전라북도","군산시",1769,1306,820,52,297,37,88,1,0,2,0,4,1,0,0,1302,4,463
"12442","나운3동","나운3동제3투","대통령선거","전라북도","군산시",2388,1757,1222,39,337,50,101,0,0,1,0,1,0,0,1,1752,5,631
"12443","나운3동","나운3동제4투","대통령선거","전라북도","군산시",2232,1567,991,45,398,42,84,0,1,0,0,3,0,0,0,1564,3,665
"12444","나운3동","나운3동제5투","대통령선거","전라북도","군산시",1671,1090,641,53,299,28,62,0,0,2,1,2,0,0,0,1088,2,581
"12445","나운3동","나운3동제6투","대통령선거","전라북도","군산시",2212,1155,752,38,273,30,51,1,1,0,0,2,0,0,5,1153,2,1057
"12446","나운3동","나운3동제7투","대통령선거","전라북도","군산시",2203,1602,1061,38,383,31,78,2,0,1,0,2,0,1,1,1598,4,601
"12447","나운3동","나운3동제8투","대통령선거","전라북도","군산시",1749,1333,885,47,292,20,74,1,0,0,0,9,0,0,1,1329,4,416
"12448","나운3동","나운3동제9투","대통령선거","전라북도","군산시",2634,2052,1292,92,498,67,95,2,0,0,0,3,0,0,0,2049,3,582
"12449","소룡동","관내사전투표","대통령선거","전라북도","군산시",3378,3378,2212,116,779,85,173,0,0,1,2,0,1,2,0,3371,7,0
"12450","소룡동","소룡동제1투","대통령선거","전라북도","군산시",2323,1291,805,60,331,28,57,0,0,1,0,3,0,0,2,1287,4,1032
"12451","소룡동","소룡동제2투","대통령선거","전라북도","군산시",1572,1018,639,44,275,20,33,0,0,0,0,0,1,1,1,1014,4,554
"12452","소룡동","소룡동제3투","대통령선거","전라북도","군산시",2413,1327,803,65,338,34,84,0,0,0,0,0,0,0,2,1326,1,1086
"12453","소룡동","소룡동제4투","대통령선거","전라북도","군산시",3463,2111,1364,63,521,42,105,0,0,2,4,3,0,0,4,2108,3,1352
"12454","소룡동","소룡동제5투","대통령선거","전라북도","군산시",1288,556,331,33,147,25,19,0,0,0,0,0,0,1,0,556,0,732
"12455","미성동","관내사전투표","대통령선거","전라북도","군산시",1590,1590,1033,49,396,32,74,0,1,1,0,1,0,1,0,1588,2,0
"12456","미성동","미성동제1투","대통령선거","전라북도","군산시",1771,937,565,29,294,11,27,2,0,1,0,0,1,0,4,934,3,834
"12457","미성동","미성동제2투","대통령선거","전라북도","군산시",2143,1417,898,68,356,26,60,0,1,4,0,1,0,0,1,1415,2,726
"12458","미성동","미성동제3투","대통령선거","전라북도","군산시",636,426,261,11,137,3,8,0,0,1,0,3,0,0,1,425,1,210
"12459","미성동","미성동제4투","대통령선거","전라북도","군산시",2943,1474,911,63,365,40,81,0,1,2,0,4,0,0,2,1469,5,1469
"12460","미성동","미성동제5투","대통령선거","전라북도","군산시",1528,1141,778,24,221,31,80,0,0,1,0,2,0,0,2,1139,2,387
"12461","잘못 투입·구분된 투표지","잘못 투입·구분된 투표지","대통령선거","전라북도","군산시",0,4,3,0,1,0,0,0,0,0,0,0,0,0,0,4,0,-4
"12462","거소·선상투표","거소·선상투표","대통령선거","전라북도","익산시",764,698,355,42,236,17,17,2,1,2,2,0,1,1,6,682,16,66
"12463","관외사전투표","관외사전투표","대통령선거","전라북도","익산시",19255,19239,12210,659,3765,991,1423,4,6,17,5,28,2,3,27,19140,99,16
"12464","재외투표","재외투표","대통령선거","전라북도","익산시",1029,793,564,14,113,14,85,1,0,0,0,1,0,0,0,792,1,236
"12465","함열읍","관내사전투표","대통령선거","전라북도","익산시",1886,1886,1229,53,477,30,75,0,0,1,5,1,0,2,4,1877,9,0
"12466","함열읍","함열읍제1투","대통령선거","전라북도","익산시",2538,1623,1008,67,443,23,67,1,0,1,3,0,0,2,2,1617,6,915
"12467","함열읍","함열읍제2투","대통령선거","전라북도","익산시",1945,1190,739,54,320,21,38,0,0,0,1,4,2,0,4,1183,7,755
"12468","오산면","관내사전투표","대통령선거","전라북도","익산시",933,933,630,21,215,22,39,1,0,0,1,1,1,0,1,932,1,0
"12469","오산면","오산면제1투","대통령선거","전라북도","익산시",1626,1025,641,41,299,19,18,0,1,0,0,1,0,1,2,1023,2,601
"12470","오산면","오산면제2투","대통령선거","전라북도","익산시",2530,1718,1117,42,446,24,76,0,0,1,0,3,0,0,5,1714,4,812
"12471","오산면","오산면제3투","대통령선거","전라북도","익산시",994,693,443,25,197,13,14,0,0,0,0,0,1,0,0,693,0,301
"12472","황등면","관내사전투표","대통령선거","전라북도","익산시",1602,1602,1027,43,380,37,85,1,2,3,2,3,3,1,3,1590,12,0
"12473","황등면","황등면제1투","대통령선거","전라북도","익산시",1733,1042,649,46,278,22,35,1,0,0,0,0,1,0,4,1036,6,691
"12474","황등면","황등면제2투","대통령선거","전라북도","익산시",2469,1614,1019,44,441,34,63,0,0,1,0,1,0,1,1,1605,9,855
"12475","황등면","황등면제3투","대통령선거","전라북도","익산시",737,515,341,19,134,4,13,0,0,0,0,0,0,0,2,513,2,222
"12476","함라면","관내사전투표","대통령선거","전라북도","익산시",499,499,299,13,136,17,22,0,0,2,0,0,0,1,3,493,6,0
"12477","함라면","함라면투표소","대통령선거","전라북도","익산시",1537,1010,595,50,289,18,40,0,1,2,2,0,0,1,4,1002,8,527
"12478","웅포면","관내사전투표","대통령선거","전라북도","익산시",347,347,214,14,96,7,14,0,0,0,0,0,0,0,1,346,1,0
"12479","웅포면","웅포면투표소","대통령선거","전라북도","익산시",1144,784,480,36,235,9,17,0,0,1,0,0,0,0,3,781,3,360
"12480","성당면","관내사전투표","대통령선거","전라북도","익산시",455,455,271,39,115,12,13,0,0,0,1,0,0,0,2,453,2,0
"12481","성당면","성당면투표소","대통령선거","전라북도","익산시",1259,753,468,45,192,6,24,0,0,1,4,4,1,0,2,747,6,506
"12482","용안면","관내사전투표","대통령선거","전라북도","익산시",561,561,344,25,136,5,26,2,0,2,0,0,1,0,6,547,14,0
"12483","용안면","용안면투표소","대통령선거","전라북도","익산시",1848,1182,672,70,367,25,40,0,0,1,0,1,1,0,1,1178,4,666
"12484","낭산면","관내사전투표","대통령선거","전라북도","익산시",554,554,338,14,158,9,24,0,0,1,4,3,0,0,2,553,1,0
"12485","낭산면","낭산면투표소","대통령선거","전라북도","익산시",2131,1387,794,58,418,41,41,1,0,1,5,11,0,4,5,1379,8,744
"12486","망성면","관내사전투표","대통령선거","전라북도","익산시",439,439,231,34,138,16,14,1,0,1,0,0,0,0,2,437,2,0
"12487","망성면","망성면투표소","대통령선거","전라북도","익산시",2270,1387,751,109,447,27,33,0,0,2,0,5,2,0,3,1379,8,883
"12488","여산면","관내사전투표","대통령선거","전라북도","익산시",743,743,444,35,207,23,25,1,0,1,1,2,0,1,1,741,2,0
"12489","여산면","여산면투표소","대통령선거","전라북도","익산시",2293,1506,861,91,431,54,40,1,1,5,2,6,0,2,4,1498,8,787
"12490","금마면","관내사전투표","대통령선거","전라북도","익산시",1558,1558,910,97,391,64,62,3,2,0,1,3,0,0,7,1540,18,0
"12491","금마면","금마면제1투","대통령선거","전라북도","익산시",1848,1147,639,91,312,37,55,0,0,0,0,1,1,0,2,1138,9,701
"12492","금마면","금마면제2투","대통령선거","전라북도","익산시",1151,764,464,41,206,15,33,0,0,0,0,1,0,0,0,760,4,387
"12493","왕궁면","관내사전투표","대통령선거","전라북도","익산시",640,640,412,38,144,13,24,0,1,0,0,0,0,0,2,634,6,0
"12494","왕궁면","왕궁면제1투","대통령선거","전라북도","익산시",1599,946,598,39,264,12,27,0,0,0,1,0,0,1,1,943,3,653
"12495","왕궁면","왕궁면제2투","대통령선거","전라북도","익산시",886,569,343,22,178,5,12,1,0,0,0,2,0,0,3,566,3,317
"12496","왕궁면","왕궁면제3투","대통령선거","전라북도","익산시",755,612,326,58,181,15,16,1,1,0,5,0,0,0,3,606,6,143
"12497","춘포면","관내사전투표","대통령선거","전라북도","익산시",495,495,303,16,120,10,24,0,0,0,1,1,2,0,1,478,17,0
"12498","춘포면","춘포면제1투","대통령선거","전라북도","익산시",1095,731,506,12,174,7,24,1,0,1,0,0,1,1,2,729,2,364
"12499","춘포면","춘포면제2투","대통령선거","전라북도","익산시",1048,706,446,19,205,7,17,0,1,0,1,0,0,1,4,701,5,342
"12500","춘포면","춘포면제3투","대통령선거","전라북도","익산시",1059,733,485,26,167,16,30,1,0,0,1,2,0,1,3,732,1,326
"12501","삼기면","관내사전투표","대통령선거","전라북도","익산시",641,641,426,15,151,13,20,3,0,1,2,0,0,0,1,632,9,0
"12502","삼기면","삼기면투표소","대통령선거","전라북도","익산시",1716,1029,589,51,310,19,45,1,1,0,0,2,2,2,4,1026,3,687
"12503","용동면","관내사전투표","대통령선거","전라북도","익산시",298,298,178,20,72,9,17,0,0,0,0,0,1,0,0,297,1,0
"12504","용동면","용동면투표소","대통령선거","전라북도","익산시",1146,781,469,49,218,14,22,0,1,3,0,0,0,1,4,781,0,365
"12505","중앙동","관내사전투표","대통령선거","전라북도","익산시",1467,1467,867,49,449,24,65,4,0,1,3,1,0,1,0,1464,3,0
"12506","중앙동","중앙동제1투","대통령선거","전라북도","익산시",1229,703,396,35,223,21,24,0,0,2,0,0,0,0,0,701,2,526
"12507","중앙동","중앙동제2투","대통령선거","전라북도","익산시",1300,800,411,49,282,17,32,0,0,0,2,2,0,0,1,796,4,500
"12508","평화동","관내사전투표","대통령선거","전라북도","익산시",1160,1160,785,30,263,34,45,0,0,1,2,0,0,0,0,1160,0,0
"12509","평화동","평화동제1투","대통령선거","전라북도","익산시",1580,1042,623,35,311,31,39,0,0,0,0,1,0,0,0,1040,2,538
"12510","평화동","평화동제2투","대통령선거","전라북도","익산시",1070,701,426,29,201,14,28,0,0,0,1,0,0,0,1,700,1,369
"12511","인화동","관내사전투표","대통령선거","전라북도","익산시",1436,1436,896,47,395,27,60,1,0,2,3,1,0,0,1,1433,3,0
"12512","인화동","인화동제1투","대통령선거","전라북도","익산시",2045,1246,759,48,338,37,51,1,0,3,1,1,0,0,2,1241,5,799
"12513","인화동","인화동제2투","대통령선거","전라북도","익산시",2479,1643,986,60,493,37,51,1,0,0,0,1,3,1,1,1634,9,836
"12514","동산동","관내사전투표","대통령선거","전라북도","익산시",3635,3635,2475,99,773,91,176,2,2,1,1,0,0,1,2,3623,12,0
"12515","동산동","동산동제1투","대통령선거","전라북도","익산시",1943,1211,790,44,309,20,42,0,0,1,0,1,0,1,0,1208,3,732
"12516","동산동","동산동제2투","대통령선거","전라북도","익산시",1924,1155,725,49,296,23,56,0,0,3,0,0,1,0,0,1153,2,769
"12517","동산동","동산동제3투","대통령선거","전라북도","익산시",2886,1959,1256,58,479,46,95,0,0,5,1,1,2,0,6,1949,10,927
"12518","동산동","동산동제4투","대통령선거","전라북도","익산시",2389,1614,1084,37,389,32,60,2,1,0,1,0,1,0,3,1610,4,775
"12519","동산동","동산동제5투","대통령선거","전라북도","익산시",1773,1072,706,22,269,25,42,0,0,1,0,0,1,1,2,1069,3,701
"12520","동산동","동산동제6투","대통령선거","전라북도","익산시",2134,1415,919,28,351,34,72,0,0,2,1,2,0,0,2,1411,4,719
"12521","마동","관내사전투표","대통령선거","전라북도","익산시",2661,2661,1788,70,590,73,120,2,0,3,2,0,0,0,6,2654,7,0
"12522","마동","마동제1투","대통령선거","전라북도","익산시",1461,792,482,26,230,22,22,0,0,0,1,1,0,1,2,787,5,669
"12523","마동","마동제2투","대통령선거","전라북도","익산시",2198,1355,826,39,393,30,58,1,0,0,1,0,1,1,0,1350,5,843
"12524","마동","마동제3투","대통령선거","전라북도","익산시",2473,1648,1030,58,454,39,56,0,0,1,1,2,0,1,0,1642,6,825
"12525","남중동","관내사전투표","대통령선거","전라북도","익산시",2805,2805,1676,107,794,76,123,0,0,3,3,3,0,0,5,2790,15,0
"12526","남중동","남중동제1투","대통령선거","전라북도","익산시",1949,1187,702,57,345,30,45,0,0,0,0,1,0,0,2,1182,5,762
"12527","남중동","남중동제2투","대통령선거","전라북도","익산시",1912,1284,726,67,402,34,46,0,0,3,1,1,0,1,0,1281,3,628
"12528","남중동","남중동제3투","대통령선거","전라북도","익산시",2028,1287,729,58,407,31,54,0,0,1,1,0,1,1,0,1283,4,741
"12529","남중동","남중동제4투","대통령선거","전라북도","익산시",1986,1311,751,59,404,43,48,0,0,2,0,0,0,0,1,1308,3,675
"12530","모현동","관내사전투표","대통령선거","전라북도","익산시",7133,7133,4955,150,1436,194,366,3,1,7,2,6,1,0,2,7123,10,0
"12531","모현동","모현동제1투","대통령선거","전라북도","익산시",2136,1291,866,41,299,27,52,0,0,0,0,0,1,0,1,1287,4,845
"12532","모현동","모현동제2투","대통령선거","전라북도","익산시",1803,1270,751,66,344,45,56,0,1,1,3,0,1,0,1,1269,1,533
"12533","모현동","모현동제3투","대통령선거","전라북도","익산시",1913,1317,864,43,305,36,60,1,0,3,1,0,0,0,0,1313,4,596
"12534","모현동","모현동제4투","대통령선거","전라북도","익산시",1946,1373,874,34,368,30,59,0,0,2,0,0,0,0,2,1369,4,573
"12535","모현동","모현동제5투","대통령선거","전라북도","익산시",2631,1919,1191,79,519,50,70,0,0,5,0,2,0,1,1,1918,1,712
"12536","모현동","모현동제6투","대통령선거","전라북도","익산시",2071,1550,1079,47,312,34,75,0,0,1,0,1,0,0,0,1549,1,521
"12537","모현동","모현동제7투","대통령선거","전라북도","익산시",2557,1765,1120,56,443,35,106,0,0,0,0,0,0,0,2,1762,3,792
"12538","모현동","모현동제8투","대통령선거","전라북도","익산시",2286,1887,1297,39,397,61,85,0,0,0,0,2,0,2,1,1884,3,399
"12539","모현동","모현동제9투","대통령선거","전라북도","익산시",1935,1525,1012,41,342,46,76,1,0,0,0,1,1,0,0,1520,5,410
"12540","모현동","모현동제10투","대통령선거","전라북도","익산시",2245,1800,1247,27,385,44,93,0,0,1,0,0,0,0,0,1797,3,445
"12541","송학동","관내사전투표","대통령선거","전라북도","익산시",2517,2517,1749,63,532,49,115,0,0,0,2,2,0,1,1,2514,3,0
"12542","송학동","송학동제1투","대통령선거","전라북도","익산시",1204,761,459,27,217,20,31,0,0,0,0,0,0,0,1,755,6,443
"12543","송학동","송학동제2투","대통령선거","전라북도","익산시",1320,970,615,25,248,30,47,0,0,0,1,1,0,0,1,968,2,350
"12544","송학동","송학동제3투","대통령선거","전라북도","익산시",2344,1696,1140,46,369,49,83,0,0,1,1,0,0,0,0,1689,7,648
"12545","신동","관내사전투표","대통령선거","전라북도","익산시",4123,4123,2795,114,819,138,236,0,0,1,4,3,1,2,0,4113,10,0
"12546","신동","신동제1투","대통령선거","전라북도","익산시",2281,1420,845,52,366,53,100,0,0,0,0,0,0,0,0,1416,4,861
"12547","신동","신동제2투","대통령선거","전라북도","익산시",2172,1366,835,58,357,43,65,0,0,1,0,1,0,1,0,1361,5,806
"12548","신동","신동제3투","대통령선거","전라북도","익산시",2517,1741,1117,58,412,60,87,1,1,0,0,1,0,0,1,1738,3,776
"12549","신동","신동제4투","대통령선거","전라북도","익산시",1606,884,552,44,225,17,34,1,0,4,1,0,0,1,1,880,4,722
"12550","영등1동","관내사전투표","대통령선거","전라북도","익산시",4706,4706,3183,124,1029,120,228,0,1,2,1,6,0,1,1,4696,10,0
"12551","영등1동","영등1동제1투","대통령선거","전라북도","익산시",1951,1354,838,77,332,36,69,0,0,1,0,1,0,0,0,1354,0,597
"12552","영등1동","영등1동제2투","대통령선거","전라북도","익산시",2010,1329,824,54,350,47,48,0,0,1,1,1,0,0,1,1327,2,681
"12553","영등1동","영등1동제3투","대통령선거","전라북도","익산시",2366,1567,972,58,393,48,81,0,1,0,1,2,0,0,2,1558,9,799
"12554","영등1동","영등1동제4투","대통령선거","전라북도","익산시",1925,1446,969,43,310,40,78,0,0,0,0,3,1,0,0,1444,2,479
"12555","영등1동","영등1동제5투","대통령선거","전라북도","익산시",1359,932,621,34,196,26,48,1,0,0,1,2,0,0,2,931,1,427
"12556","영등1동","영등1동제6투","대통령선거","전라북도","익산시",1871,1357,897,48,306,34,65,2,0,0,0,3,0,0,0,1355,2,514
"12557","영등1동","영등1동제7투","대통령선거","전라북도","익산시",2132,1640,1099,39,346,50,101,0,0,0,0,1,1,0,1,1638,2,492
"12558","영등2동","관내사전투표","대통령선거","전라북도","익산시",4366,4366,3079,78,757,128,301,4,0,2,1,2,0,2,4,4358,8,0
"12559","영등2동","영등2동제1투","대통령선거","전라북도","익산시",2736,2043,1416,50,394,56,123,0,0,1,1,0,1,1,0,2043,0,693
"12560","영등2동","영등2동제2투","대통령선거","전라북도","익산시",1946,1420,934,50,324,43,63,1,0,0,0,1,0,0,1,1417,3,526
"12561","영등2동","영등2동제3투","대통령선거","전라북도","익산시",2603,1819,1260,29,364,53,104,0,0,0,0,3,0,0,1,1814,5,784
"12562","어양동","관내사전투표","대통령선거","전라북도","익산시",5737,5737,3883,133,1145,176,372,0,0,2,0,5,1,1,5,5723,14,0
"12563","어양동","어양동제1투","대통령선거","전라북도","익산시",2310,1429,901,54,328,42,93,1,0,0,0,2,0,0,3,1424,5,881
"12564","어양동","어양동제2투","대통령선거","전라북도","익산시",2231,1422,917,42,338,34,83,0,0,2,1,1,0,1,2,1421,1,809
"12565","어양동","어양동제3투","대통령선거","전라북도","익산시",2122,1514,953,53,384,30,86,0,0,0,0,2,0,2,2,1512,2,608
"12566","어양동","어양동제4투","대통령선거","전라북도","익산시",2589,1922,1307,55,382,46,121,0,0,0,0,5,0,0,2,1918,4,667
"12567","어양동","어양동제5투","대통령선거","전라북도","익산시",1870,1369,919,33,289,30,91,0,1,0,1,0,0,0,1,1365,4,501
"12568","어양동","어양동제6투","대통령선거","전라북도","익산시",1531,1085,710,26,243,31,66,0,0,3,0,2,0,0,0,1081,4,446
"12569","팔봉동","관내사전투표","대통령선거","전라북도","익산시",1556,1556,1060,59,317,30,66,0,1,2,1,2,1,0,2,1541,15,0
"12570","팔봉동","팔봉동제1투","대통령선거","전라북도","익산시",2744,1695,1046,59,406,39,101,0,1,1,2,5,2,1,3,1666,29,1049
"12571","팔봉동","팔봉동제2투","대통령선거","전라북도","익산시",1039,666,375,29,197,17,27,0,0,3,2,1,0,1,3,655,11,373
"12572","삼성동","관내사전투표","대통령선거","전라북도","익산시",4995,4995,3374,128,984,149,317,0,0,1,3,8,2,2,4,4972,23,0
"12573","삼성동","삼성동제1투","대통령선거","전라북도","익산시",2082,1553,1061,28,348,36,73,0,0,0,1,4,0,0,0,1551,2,529
"12574","삼성동","삼성동제2투","대통령선거","전라북도","익산시",2221,1325,792,49,407,21,40,1,0,1,0,0,3,0,3,1317,8,896
"12575","삼성동","삼성동제3투","대통령선거","전라북도","익산시",2435,1579,975,68,390,57,83,0,0,0,0,1,0,0,0,1574,5,856
"12576","삼성동","삼성동제4투","대통령선거","전라북도","익산시",2533,1878,1233,53,423,38,118,0,0,0,0,2,0,0,3,1870,8,655
"12577","삼성동","삼성동제5투","대통령선거","전라북도","익산시",2701,1877,1249,63,403,47,108,0,0,1,0,2,0,0,1,1874,3,824
"12578","삼성동","삼성동제6투","대통령선거","전라북도","익산시",1832,1393,937,23,305,20,102,0,0,0,0,1,0,1,1,1390,3,439
"12579","삼성동","삼성동제7투","대통령선거","전라북도","익산시",1002,728,450,20,213,8,24,0,0,0,0,1,1,0,4,721,7,274
"12580","삼성동","삼성동제8투","대통령선거","전라북도","익산시",2507,1767,1177,43,391,43,109,0,0,0,1,1,0,0,1,1766,1,740
"12581","잘못 투입·구분된 투표지","잘못 투입·구분된 투표지","대통령선거","전라북도","익산시",0,14,6,1,6,1,0,0,0,0,0,0,0,0,0,14,0,-14
"12582","거소·선상투표","거소·선상투표","대통령선거","전라북도","정읍시",401,357,176,15,123,11,7,2,1,2,2,2,1,0,3,345,12,44
"12583","관외사전투표","관외사전투표","대통령선거","전라북도","정읍시",8016,8015,5146,258,1616,341,565,4,1,10,0,8,0,1,14,7964,51,1
"12584","재외투표","재외투표","대통령선거","전라북도","정읍시",316,214,167,7,23,3,11,2,0,0,0,0,0,0,0,213,1,102
"12585","신태인읍","관내사전투표","대통령선거","전라북도","정읍시",1263,1263,836,31,313,19,42,1,0,1,1,2,0,2,4,1252,11,0
"12586","신태인읍","신태인읍제1투","대통령선거","전라북도","정읍시",1741,1105,710,31,298,22,29,2,1,1,1,2,0,0,1,1098,7,636
"12587","신태인읍","신태인읍제2투","대통령선거","전라북도","정읍시",1351,848,518,23,246,22,24,0,1,0,1,1,1,1,3,841,7,503
"12588","신태인읍","신태인읍제3투","대통령선거","전라북도","정읍시",897,604,367,20,177,9,12,0,0,1,2,2,0,1,6,597,7,293
"12589","북면","관내사전투표","대통령선거","전라북도","정읍시",991,991,639,20,260,23,32,0,0,7,0,2,0,1,1,985,6,0
"12590","북면","북면제1투","대통령선거","전라북도","정읍시",1457,907,564,29,244,17,29,0,0,13,3,4,0,0,3,906,1,550
"12591","북면","북면제2투","대통령선거","전라북도","정읍시",1459,941,574,25,267,10,44,1,0,2,0,4,2,1,3,933,8,518
"12592","입암면","관내사전투표","대통령선거","전라북도","정읍시",466,466,280,12,141,11,17,0,0,0,1,1,0,0,2,465,1,0
"12593","입암면","입암면제1투","대통령선거","전라북도","정읍시",1069,698,398,21,236,13,15,0,0,1,1,1,0,1,8,695,3,371
"12594","입암면","입암면제2투","대통령선거","전라북도","정읍시",1104,782,470,28,244,8,20,1,0,1,0,1,0,0,1,774,8,322
"12595","소성면","관내사전투표","대통령선거","전라북도","정읍시",546,546,368,18,130,3,15,0,0,1,0,7,0,0,3,545,1,0
"12596","소성면","소성면투표소","대통령선거","전라북도","정읍시",1335,858,508,25,283,9,24,0,0,0,1,1,1,1,2,855,3,477
"12597","고부면","관내사전투표","대통령선거","전라북도","정읍시",470,470,284,23,125,10,21,0,0,1,0,2,0,0,3,469,1,0
"12598","고부면","고부면제1투","대통령선거","전라북도","정읍시",1412,859,530,36,228,17,19,0,2,2,1,6,1,2,6,850,9,553
"12599","고부면","고부면제2투","대통령선거","전라북도","정읍시",687,482,291,11,154,3,15,0,0,0,0,1,0,0,1,476,6,205
"12600","영원면","관내사전투표","대통령선거","전라북도","정읍시",455,455,288,11,127,4,17,0,0,0,0,2,0,0,1,450,5,0
"12601","영원면","영원면투표소","대통령선거","전라북도","정읍시",1196,783,481,28,236,7,22,0,0,2,1,1,0,0,2,780,3,413
"12602","덕천면","관내사전투표","대통령선거","전라북도","정읍시",286,286,177,5,76,5,17,0,1,0,0,3,0,0,0,284,2,0
"12603","덕천면","덕천면제1투","대통령선거","전라북도","정읍시",779,534,325,15,160,13,11,0,0,1,0,2,0,1,2,530,4,245
"12604","덕천면","덕천면제2투","대통령선거","전라북도","정읍시",612,430,228,18,148,6,15,1,0,0,0,4,1,1,4,426,4,182
"12605","이평면","관내사전투표","대통령선거","전라북도","정읍시",403,403,269,13,96,10,10,0,0,1,0,1,0,0,1,401,2,0
"12606","이평면","이평면제1투","대통령선거","전라북도","정읍시",904,553,337,18,153,11,23,0,0,0,0,6,1,0,1,550,3,351
"12607","이평면","이평면제2투","대통령선거","전라북도","정읍시",638,412,270,10,116,1,12,0,0,0,1,0,0,0,2,412,0,226
"12608","정우면","관내사전투표","대통령선거","전라북도","정읍시",510,510,295,22,154,10,19,1,0,0,0,2,0,1,2,506,4,0
"12609","정우면","정우면제1투","대통령선거","전라북도","정읍시",1206,779,430,27,271,8,33,0,0,3,0,1,2,0,2,777,2,427
"12610","정우면","정우면제2투","대통령선거","전라북도","정읍시",560,358,200,16,118,9,9,0,0,4,0,0,0,1,0,357,1,202
"12611","태인면","관내사전투표","대통령선거","전라북도","정읍시",735,735,437,17,218,12,36,0,0,0,1,0,1,1,4,727,8,0
"12612","태인면","태인면제1투","대통령선거","전라북도","정읍시",1306,884,540,28,256,11,23,1,0,12,0,0,0,0,2,873,11,422
"12613","태인면","태인면제2투","대통령선거","전라북도","정읍시",1115,687,437,15,211,4,11,0,0,0,0,1,1,0,3,683,4,428
"12614","감곡면","관내사전투표","대통령선거","전라북도","정읍시",582,582,394,12,129,6,24,0,0,0,1,2,0,1,2,571,11,0
"12615","감곡면","감곡면투표소","대통령선거","전라북도","정읍시",1820,1096,677,50,320,7,26,0,1,0,0,1,1,1,4,1088,8,724
"12616","옹동면","관내사전투표","대통령선거","전라북도","정읍시",305,304,169,7,116,2,6,1,0,1,0,0,0,0,0,302,2,1
"12617","옹동면","옹동면투표소","대통령선거","전라북도","정읍시",1148,734,412,24,266,3,13,0,1,0,0,1,1,1,5,727,7,414
"12618","칠보면","관내사전투표","대통령선거","전라북도","정읍시",495,495,285,17,160,9,18,0,0,0,1,0,2,1,0,493,2,0
"12619","칠보면","칠보면제1투","대통령선거","전라북도","정읍시",1162,778,473,39,233,4,17,0,1,3,0,1,1,0,3,775,3,384
"12620","칠보면","칠보면제2투","대통령선거","전라북도","정읍시",436,324,186,14,105,3,10,0,0,0,1,0,0,0,1,320,4,112
"12621","산내면","관내사전투표","대통령선거","전라북도","정읍시",342,342,209,10,91,6,9,2,1,0,2,3,1,1,3,338,4,0
"12622","산내면","산내면투표소","대통령선거","전라북도","정읍시",804,500,269,24,175,4,12,0,1,0,0,2,1,3,4,495,5,304
"12623","산외면","관내사전투표","대통령선거","전라북도","정읍시",398,398,250,19,100,8,16,0,0,0,0,0,0,0,4,397,1,0
"12624","산외면","산외면투표소","대통령선거","전라북도","정읍시",1482,981,576,41,304,18,26,0,0,2,0,2,1,1,6,977,4,501
"12625","수성동","관내사전투표","대통령선거","전라북도","정읍시",3310,3310,2257,59,717,76,182,0,0,5,0,2,0,0,2,3300,10,0
"12626","수성동","수성동제1투","대통령선거","전라북도","정읍시",1354,846,495,32,262,17,31,0,0,1,0,1,2,0,2,843,3,508
"12627","수성동","수성동제2투","대통령선거","전라북도","정읍시",1664,1212,738,35,355,25,51,1,0,1,1,0,1,0,1,1209,3,452
"12628","수성동","수성동제3투","대통령선거","전라북도","정읍시",1708,1098,659,29,341,20,29,1,0,0,1,0,1,0,7,1088,10,610
"12629","수성동","수성동제4투","대통령선거","전라북도","정읍시",2660,1788,1212,48,403,33,81,0,1,2,0,2,1,0,1,1784,4,872
"12630","수성동","수성동제5투","대통령선거","전라북도","정읍시",2911,1855,1212,40,446,36,104,0,0,2,2,3,0,1,2,1848,7,1056
"12631","장명동","관내사전투표","대통령선거","전라북도","정읍시",753,753,477,25,194,15,34,1,0,0,1,2,0,0,1,750,3,0
"12632","장명동","장명동투표소","대통령선거","전라북도","정읍시",1924,1249,728,44,395,16,57,1,0,0,0,3,0,0,1,1245,4,675
"12633","내장상동","관내사전투표","대통령선거","전라북도","정읍시",4105,4105,2727,73,960,91,229,0,1,2,0,2,2,1,3,4091,14,0
"12634","내장상동","내장상동제1투","대통령선거","전라북도","정읍시",2046,1403,888,36,378,30,59,0,0,0,2,2,0,1,1,1397,6,643
"12635","내장상동","내장상동제2투","대통령선거","전라북도","정읍시",2640,1855,1211,55,452,37,87,2,0,1,0,1,0,1,3,1850,5,785
"12636","내장상동","내장상동제3투","대통령선거","전라북도","정읍시",1465,1069,668,28,312,17,41,0,0,1,1,0,0,0,1,1069,0,396
"12637","내장상동","내장상동제4투","대통령선거","전라북도","정읍시",1806,1203,729,31,365,16,51,1,0,0,0,3,1,0,1,1198,5,603
"12638","내장상동","내장상동제5투","대통령선거","전라북도","정읍시",1276,867,510,20,292,13,21,0,1,0,0,2,0,1,6,866,1,409
"12639","내장상동","내장상동제6투","대통령선거","전라북도","정읍시",1726,1152,718,35,290,30,70,0,0,2,0,3,0,0,0,1148,4,574
"12640","시기동","관내사전투표","대통령선거","전라북도","정읍시",897,897,574,21,242,16,38,1,1,0,0,0,0,0,0,893,4,0
"12641","시기동","시기동제1투","대통령선거","전라북도","정읍시",1450,936,529,24,325,19,32,0,0,0,2,0,0,1,1,933,3,514
"12642","시기동","시기동제2투","대통령선거","전라북도","정읍시",948,653,386,14,215,7,28,0,0,0,0,0,0,1,1,652,1,295
"12643","초산동","관내사전투표","대통령선거","전라북도","정읍시",1474,1474,977,43,349,25,75,0,0,1,0,1,0,1,0,1472,2,0
"12644","초산동","초산동제1투","대통령선거","전라북도","정읍시",1394,906,584,15,253,16,33,0,0,0,0,2,0,0,0,903,3,488
"12645","초산동","초산동제2투","대통령선거","전라북도","정읍시",1415,972,555,43,307,18,41,0,0,2,0,1,0,0,0,967,5,443
"12646","초산동","초산동제3투","대통령선거","전라북도","정읍시",1781,1312,858,34,330,26,59,0,0,1,0,1,0,0,1,1310,2,469
"12647","연지동","관내사전투표","대통령선거","전라북도","정읍시",1676,1676,1033,35,490,30,71,1,0,3,0,0,1,1,1,1666,10,0
"12648","연지동","연지동투표소","대통령선거","전라북도","정읍시",2612,1694,954,68,575,26,57,2,0,2,0,0,0,1,2,1687,7,918
"12649","농소동","관내사전투표","대통령선거","전라북도","정읍시",696,696,454,18,169,16,33,0,0,1,1,1,0,0,0,693,3,0
"12650","농소동","농소동제1투","대통령선거","전라북도","정읍시",1104,677,418,21,188,14,31,0,0,0,0,0,0,1,1,674,3,427
"12651","농소동","농소동제2투","대통령선거","전라북도","정읍시",1605,1047,685,40,265,14,36,0,0,1,0,1,0,0,1,1043,4,558
"12652","상교동","관내사전투표","대통령선거","전라북도","정읍시",675,675,401,22,206,9,23,2,0,0,1,1,0,1,2,668,7,0
"12653","상교동","상교동제1투","대통령선거","전라북도","정읍시",1357,831,407,25,357,10,22,0,1,0,1,0,1,1,4,829,2,526
"12654","상교동","상교동제2투","대통령선거","전라북도","정읍시",1070,717,409,29,231,12,27,0,0,2,0,0,0,0,2,712,5,353
"12655","잘못 투입·구분된 투표지","잘못 투입·구분된 투표지","대통령선거","전라북도","정읍시",0,1,1,0,0,0,0,0,0,0,0,0,0,0,0,1,0,-1
"12656","거소·선상투표","거소·선상투표","대통령선거","전라북도","남원시",310,282,142,11,67,12,6,0,3,3,2,2,0,2,9,259,23,28
"12657","관외사전투표","관외사전투표","대통령선거","전라북도","남원시",5308,5308,3379,184,1036,231,406,2,0,4,3,8,6,1,12,5272,36,0
"12658","재외투표","재외투표","대통령선거","전라북도","남원시",288,204,150,4,24,6,19,0,0,0,0,0,1,0,0,204,0,84
"12659","운봉읍","관내사전투표","대통령선거","전라북도","남원시",667,667,482,19,127,16,19,0,0,0,0,0,0,2,1,666,1,0
"12660","운봉읍","운봉읍제1투","대통령선거","전라북도","남원시",1220,846,552,36,206,13,22,0,0,0,1,0,2,1,7,840,6,374
"12661","운봉읍","운봉읍제2투","대통령선거","전라북도","남원시",1416,977,662,44,213,15,30,2,0,0,0,1,0,0,6,973,4,439
"12662","주천면","관내사전투표","대통령선거","전라북도","남원시",482,482,323,17,120,3,17,0,0,0,0,0,0,0,0,480,2,0
"12663","주천면","주천면제1투","대통령선거","전라북도","남원시",1289,935,592,36,249,15,20,2,0,1,0,2,1,1,5,924,11,354
"12664","주천면","주천면제2투","대통령선거","전라북도","남원시",243,184,86,14,70,4,4,0,0,0,0,0,0,1,3,182,2,59
"12665","수지면","관내사전투표","대통령선거","전라북도","남원시",164,164,101,8,47,1,4,0,0,0,1,0,1,0,1,164,0,0
"12666","수지면","수지면투표소","대통령선거","전라북도","남원시",828,563,341,32,166,5,10,0,0,0,0,0,0,2,3,559,4,265
"12667","송동면","관내사전투표","대통령선거","전라북도","남원시",386,386,242,8,111,4,11,0,0,0,0,0,2,0,4,382,4,0
"12668","송동면","송동면투표소","대통령선거","전라북도","남원시",1367,951,576,44,273,12,22,0,1,0,0,5,4,0,6,943,8,416
"12669","주생면","관내사전투표","대통령선거","전라북도","남원시",384,384,218,8,132,5,13,0,0,0,0,1,0,0,4,381,3,0
"12670","주생면","주생면투표소","대통령선거","전라북도","남원시",1232,870,499,35,288,11,20,1,0,2,0,4,0,1,6,867,3,362
"12671","금지면","관내사전투표","대통령선거","전라북도","남원시",357,357,237,12,87,3,11,0,0,1,0,1,0,0,1,353,4,0
"12672","금지면","금지면투표소","대통령선거","전라북도","남원시",1753,1260,783,49,373,9,25,0,1,2,0,0,0,3,4,1249,11,493
"12673","대강면","관내사전투표","대통령선거","전라북도","남원시",247,247,126,6,87,4,14,1,0,1,0,4,0,0,3,246,1,0
"12674","대강면","대강면투표소","대통령선거","전라북도","남원시",1206,794,478,33,249,4,14,1,1,2,0,1,1,0,6,790,4,412
"12675","대산면","관내사전투표","대통령선거","전라북도","남원시",400,400,219,22,98,9,22,2,3,2,1,1,1,2,5,387,13,0
"12676","대산면","대산면투표소","대통령선거","전라북도","남원시",1040,677,432,24,188,6,16,1,0,1,0,0,2,1,0,671,6,363
"12677","사매면","관내사전투표","대통령선거","전라북도","남원시",284,284,181,9,78,2,11,0,0,1,0,0,1,0,0,283,1,0
"12678","사매면","사매면투표소","대통령선거","전라북도","남원시",1037,697,465,21,173,4,18,1,0,0,1,0,0,0,7,690,7,340
"12679","덕과면","관내사전투표","대통령선거","전라북도","남원시",172,172,118,2,41,1,8,0,0,0,0,1,1,0,0,172,0,0
"12680","덕과면","덕과면투표소","대통령선거","전라북도","남원시",625,440,285,6,121,3,14,0,0,0,0,4,1,1,2,437,3,185
"12681","보절면","관내사전투표","대통령선거","전라북도","남원시",327,327,178,3,126,3,10,0,0,0,1,4,0,0,0,325,2,0
"12682","보절면","보절면투표소","대통령선거","전라북도","남원시",1050,697,376,29,230,12,15,4,0,0,2,14,3,1,6,692,5,353
"12683","산동면","관내사전투표","대통령선거","전라북도","남원시",427,427,291,16,84,6,18,0,0,0,0,4,2,0,3,424,3,0
"12684","산동면","산동면투표소","대통령선거","전라북도","남원시",1132,785,545,23,170,14,19,0,0,1,0,1,1,1,4,779,6,347
"12685","이백면","관내사전투표","대통령선거","전라북도","남원시",515,515,324,10,150,8,11,0,0,0,0,0,0,0,6,509,6,0
"12686","이백면","이백면투표소","대통령선거","전라북도","남원시",1271,880,559,29,236,17,23,1,0,1,0,0,1,2,5,874,6,391
"12687","인월면","관내사전투표","대통령선거","전라북도","남원시",516,516,346,13,108,12,30,0,0,1,0,1,0,1,1,513,3,0
"12688","인월면","인월면투표소","대통령선거","전라북도","남원시",1775,1236,859,87,222,17,36,0,0,2,0,3,0,1,4,1231,5,539
"12689","아영면","관내사전투표","대통령선거","전라북도","남원시",373,373,225,22,93,11,19,0,0,0,0,0,0,2,0,372,1,0
"12690","아영면","아영면투표소","대통령선거","전라북도","남원시",1319,927,627,39,205,9,33,0,0,1,1,1,2,1,5,924,3,392
"12691","산내면","관내사전투표","대통령선거","전라북도","남원시",354,354,241,7,63,10,32,0,0,0,0,0,0,0,0,353,1,0
"12692","산내면","산내면투표소","대통령선거","전라북도","남원시",1340,942,591,68,188,16,63,0,0,1,0,1,2,5,5,940,2,398
"12693","동충동","관내사전투표","대통령선거","전라북도","남원시",1267,1267,812,40,313,29,66,0,0,1,0,0,1,0,2,1264,3,0
"12694","동충동","동충동투표소","대통령선거","전라북도","남원시",1942,1309,780,59,387,32,39,1,0,0,2,0,1,1,4,1306,3,633
"12695","죽항동","관내사전투표","대통령선거","전라북도","남원시",1023,1023,649,29,293,24,23,1,0,1,0,0,0,0,1,1021,2,0
"12696","죽항동","죽항동투표소","대통령선거","전라북도","남원시",2087,1329,843,39,371,22,45,2,0,1,1,0,1,0,0,1325,4,758
"12697","노암동","관내사전투표","대통령선거","전라북도","남원시",851,851,545,36,205,11,46,0,1,0,0,2,0,1,1,848,3,0
"12698","노암동","노암동제1투","대통령선거","전라북도","남원시",1010,707,451,17,202,13,20,1,0,1,0,0,0,0,1,706,1,303
"12699","노암동","노암동제2투","대통령선거","전라북도","남원시",1818,1244,757,59,346,21,44,1,0,0,0,2,1,2,2,1235,9,574
"12700","금동","관내사전투표","대통령선거","전라북도","남원시",1516,1516,1009,46,371,23,55,0,0,2,1,0,0,0,1,1508,8,0
"12701","금동","금동제1투","대통령선거","전라북도","남원시",1506,1018,618,50,310,10,18,2,0,2,2,1,1,0,2,1016,2,488
"12702","금동","금동제2투","대통령선거","전라북도","남원시",2476,1755,1159,67,437,19,60,1,0,1,1,1,0,2,2,1750,5,721
"12703","왕정동","관내사전투표","대통령선거","전라북도","남원시",840,840,569,32,177,20,35,0,1,2,0,0,0,0,0,836,4,0
"12704","왕정동","왕정동제1투","대통령선거","전라북도","남원시",1354,937,591,33,259,18,27,0,0,2,0,1,1,1,0,933,4,417
"12705","왕정동","왕정동제2투","대통령선거","전라북도","남원시",1177,842,536,34,240,10,18,0,0,0,0,0,0,2,1,841,1,335
"12706","향교동","관내사전투표","대통령선거","전라북도","남원시",1619,1619,1031,36,430,44,69,0,0,0,0,2,0,1,0,1613,6,0
"12707","향교동","향교동제1투","대통령선거","전라북도","남원시",2296,1510,903,67,447,34,50,0,0,1,0,3,0,1,2,1508,2,786
"12708","향교동","향교동제2투","대통령선거","전라북도","남원시",1278,835,533,21,229,20,27,0,1,0,1,0,0,0,0,832,3,443
"12709","향교동","향교동제3투","대통령선거","전라북도","남원시",889,533,317,16,159,12,16,3,0,0,0,2,1,0,1,527,6,356
"12710","도통동","관내사전투표","대통령선거","전라북도","남원시",3972,3972,2794,75,784,80,213,2,0,1,0,6,1,0,3,3959,13,0
"12711","도통동","도통동제1투","대통령선거","전라북도","남원시",1669,1221,802,28,296,35,54,0,1,0,0,2,0,0,2,1220,1,448
"12712","도통동","도통동제2투","대통령선거","전라북도","남원시",1612,1106,675,52,310,22,39,0,1,1,0,1,1,3,0,1105,1,506
"12713","도통동","도통동제3투","대통령선거","전라북도","남원시",2869,2103,1441,43,471,42,91,0,0,1,0,1,0,7,3,2100,3,766
"12714","도통동","도통동제4투","대통령선거","전라북도","남원시",1994,1324,893,30,318,24,53,0,1,0,0,0,0,1,2,1322,2,670
"12715","잘못 투입·구분된 투표지","잘못 투입·구분된 투표지","대통령선거","전라북도","남원시",0,0,0,0,0,0,0,0,0,0,0,0,0,0,0,0,0,0
"12716","거소·선상투표","거소·선상투표","대통령선거","전라북도","김제시",455,399,199,20,121,15,7,2,0,0,1,4,1,0,4,374,25,56
"12717","관외사전투표","관외사전투표","대통령선거","전라북도","김제시",6844,6843,4376,264,1428,260,447,3,0,4,1,4,1,4,8,6800,43,1
"12718","재외투표","재외투표","대통령선거","전라북도","김제시",296,217,149,5,38,4,18,1,0,0,0,1,0,1,0,217,0,79
"12719","만경읍","관내사전투표","대통령선거","전라북도","김제시",540,540,336,24,140,15,21,0,0,0,0,0,1,0,0,537,3,0
"12720","만경읍","만경읍제1투","대통령선거","전라북도","김제시",846,580,333,15,192,14,19,0,0,0,0,0,0,0,4,577,3,266
"12721","만경읍","만경읍제2투","대통령선거","전라북도","김제시",1075,739,387,38,267,15,20,0,0,2,0,1,1,2,1,734,5,336
"12722","죽산면","관내사전투표","대통령선거","전라북도","김제시",546,546,325,16,183,5,16,0,0,0,0,0,0,0,0,545,1,0
"12723","죽산면","죽산면투표소","대통령선거","전라북도","김제시",1726,1098,626,46,372,14,25,0,0,2,0,0,0,1,3,1089,9,628
"12724","백산면","관내사전투표","대통령선거","전라북도","김제시",400,400,254,10,114,8,8,2,0,0,0,1,0,0,1,398,2,0
"12725","백산면","백산면제1투","대통령선거","전라북도","김제시",1002,652,412,17,193,13,13,0,0,0,0,0,0,0,1,649,3,350
"12726","백산면","백산면제2투","대통령선거","전라북도","김제시",786,555,348,15,166,9,10,0,0,1,0,0,0,0,4,553,2,231
"12727","용지면","관내사전투표","대통령선거","전라북도","김제시",578,578,367,23,158,10,15,0,0,0,0,2,0,0,1,576,2,0
"12728","용지면","용지면제1투","대통령선거","전라북도","김제시",1490,920,578,50,249,8,28,0,0,0,0,0,1,0,2,916,4,570
"12729","용지면","용지면제2투","대통령선거","전라북도","김제시",1168,811,518,24,223,15,17,1,1,0,1,0,2,0,1,803,8,357
"12730","백구면","관내사전투표","대통령선거","전라북도","김제시",804,804,508,31,228,6,24,1,0,0,0,1,1,0,2,802,2,0
"12731","백구면","백구면제1투","대통령선거","전라북도","김제시",1328,877,518,52,264,13,21,0,0,0,0,1,1,1,1,872,5,451
"12732","백구면","백구면제2투","대통령선거","전라북도","김제시",1197,777,496,27,205,13,28,0,0,0,0,0,0,0,1,770,7,420
"12733","부량면","관내사전투표","대통령선거","전라북도","김제시",229,229,157,4,52,5,6,0,0,0,0,1,0,0,1,226,3,0
"12734","부량면","부량면투표소","대통령선거","전라북도","김제시",969,676,420,24,194,8,23,0,0,0,1,0,1,0,2,673,3,293
"12735","공덕면","관내사전투표","대통령선거","전라북도","김제시",506,506,328,13,136,10,13,0,0,1,0,0,0,1,2,504,2,0
"12736","공덕면","공덕면투표소","대통령선거","전라북도","김제시",1673,1140,713,33,329,12,43,1,1,1,0,0,2,2,2,1139,1,533
"12737","청하면","관내사전투표","대통령선거","전라북도","김제시",337,337,185,12,115,5,14,0,0,1,0,0,1,0,0,333,4,0
"12738","청하면","청하면투표소","대통령선거","전라북도","김제시",1247,878,506,41,290,12,16,0,1,0,2,0,1,2,4,875,3,369
"12739","성덕면","관내사전투표","대통령선거","전라북도","김제시",269,269,177,13,60,4,9,0,0,0,0,0,1,0,2,266,3,0
"12740","성덕면","성덕면투표소","대통령선거","전라북도","김제시",1329,872,463,32,321,16,28,2,0,0,0,0,0,1,1,864,8,457
"12741","진봉면","관내사전투표","대통령선거","전라북도","김제시",406,406,225,12,138,8,13,1,1,1,0,1,0,0,1,401,5,0
"12742","진봉면","진봉면제1투","대통령선거","전라북도","김제시",1294,854,500,23,291,5,24,1,0,0,0,1,0,0,0,845,9,440
"12743","진봉면","진봉면제2투","대통령선거","전라북도","김제시",636,435,266,20,143,2,3,0,0,0,0,0,0,0,0,434,1,201
"12744","금구면","관내사전투표","대통령선거","전라북도","김제시",779,779,510,23,192,11,37,0,0,0,0,0,0,1,2,776,3,0
"12745","금구면","금구면제1투","대통령선거","전라북도","김제시",1611,1079,682,32,285,20,39,0,0,1,2,0,1,2,7,1071,8,532
"12746","금구면","금구면제2투","대통령선거","전라북도","김제시",594,397,259,9,103,4,17,0,0,0,0,0,0,1,2,395,2,197
"12747","금구면","금구면제3투","대통령선거","전라북도","김제시",959,661,421,13,192,12,15,0,0,0,1,0,1,2,1,658,3,298
"12748","봉남면","관내사전투표","대통령선거","전라북도","김제시",441,441,263,15,139,6,13,0,0,0,0,0,1,0,1,438,3,0
"12749","봉남면","봉남면투표소","대통령선거","전라북도","김제시",1606,1084,661,30,336,19,26,0,0,1,0,0,2,1,3,1079,5,522
"12750","황산면","관내사전투표","대통령선거","전라북도","김제시",346,346,201,19,95,9,19,0,0,0,0,0,0,0,0,343,3,0
"12751","황산면","황산면투표소","대통령선거","전라북도","김제시",1413,974,569,26,307,18,29,0,0,6,0,1,2,1,5,964,10,439
"12752","금산면","관내사전투표","대통령선거","전라북도","김제시",773,773,481,31,212,13,30,1,0,0,0,0,2,0,1,771,2,0
"12753","금산면","금산면제1투","대통령선거","전라북도","김제시",1704,1104,639,75,324,21,26,0,0,0,2,0,1,2,4,1094,10,600
"12754","금산면","금산면제2투","대통령선거","전라북도","김제시",1561,1070,659,33,338,13,20,0,0,2,0,0,0,0,3,1068,2,491
"12755","광활면","관내사전투표","대통령선거","전라북도","김제시",238,238,156,6,62,2,11,0,0,0,0,0,0,1,0,238,0,0
"12756","광활면","광활면투표소","대통령선거","전라북도","김제시",995,692,436,14,208,10,11,0,0,1,0,0,0,0,6,686,6,303
"12757","요촌동","관내사전투표","대통령선거","전라북도","김제시",2617,2617,1732,76,603,55,135,3,0,0,4,0,0,1,0,2609,8,0
"12758","요촌동","요촌동제1투","대통령선거","전라북도","김제시",2384,1492,918,57,412,36,61,1,0,1,0,0,0,0,3,1489,3,892
"12759","요촌동","요촌동제2투","대통령선거","전라북도","김제시",1629,1123,650,55,361,26,23,0,0,0,0,0,0,0,0,1115,8,506
"12760","요촌동","요촌동제3투","대통령선거","전라북도","김제시",1727,1241,741,51,375,23,43,0,0,1,1,0,0,0,1,1236,5,486
"12761","요촌동","요촌동제4투","대통령선거","전라북도","김제시",661,448,248,26,154,4,12,0,0,1,0,0,0,1,1,447,1,213
"12762","신풍동","관내사전투표","대통령선거","전라북도","김제시",1770,1770,1131,63,454,28,79,0,0,3,1,0,0,1,4,1764,6,0
"12763","신풍동","신풍동제1투","대통령선거","전라북도","김제시",1409,944,550,53,277,17,38,0,0,0,0,0,0,0,1,936,8,465
"12764","신풍동","신풍동제2투","대통령선거","전라북도","김제시",1556,1091,671,45,295,20,48,0,0,1,0,0,0,2,2,1084,7,465
"12765","신풍동","신풍동제3투","대통령선거","전라북도","김제시",2035,1344,855,47,353,28,55,0,0,0,0,0,1,1,1,1341,3,691
"12766","신풍동","신풍동제4투","대통령선거","전라북도","김제시",1354,919,607,35,207,20,46,0,0,0,0,0,1,0,2,918,1,435
"12767","신풍동","신풍동제5투","대통령선거","전라북도","김제시",621,429,258,13,139,5,6,0,0,0,0,0,2,0,3,426,3,192
"12768","신풍동","신풍동제6투","대통령선거","전라북도","김제시",705,500,304,11,160,7,13,0,0,0,0,0,1,0,0,496,4,205
"12769","검산동","관내사전투표","대통령선거","전라북도","김제시",2279,2279,1530,50,482,61,143,0,0,0,0,1,1,1,2,2271,8,0
"12770","검산동","검산동제1투","대통령선거","전라북도","김제시",3043,2025,1287,60,533,47,88,0,2,0,0,0,0,0,2,2019,6,1018
"12771","검산동","검산동제2투","대통령선거","전라북도","김제시",1505,1005,615,29,292,16,29,0,1,2,0,0,2,0,4,990,15,500
"12772","검산동","검산동제3투","대통령선거","전라북도","김제시",1734,1196,772,25,281,38,72,0,1,0,3,2,0,0,0,1194,2,538
"12773","교월동","관내사전투표","대통령선거","전라북도","김제시",1234,1234,793,29,308,31,61,1,0,1,1,0,0,3,2,1230,4,0
"12774","교월동","교월동제1투","대통령선거","전라북도","김제시",1520,957,577,31,294,14,36,1,0,0,0,0,1,1,0,955,2,563
"12775","교월동","교월동제2투","대통령선거","전라북도","김제시",1243,832,506,36,238,15,26,0,0,1,0,1,0,0,2,825,7,411
"12776","교월동","교월동제3투","대통령선거","전라북도","김제시",1334,864,518,30,259,17,29,0,0,2,0,1,0,0,3,859,5,470
"12777","잘못 투입·구분된 투표지","잘못 투입·구분된 투표지","대통령선거","전라북도","김제시",0,0,0,0,0,0,0,0,0,0,0,0,0,0,0,0,0,0
"12778","거소·선상투표","거소·선상투표","대통령선거","전라북도","완주군",272,255,153,14,59,7,6,1,2,1,0,0,0,1,5,249,6,17
"12779","관외사전투표","관외사전투표","대통령선거","전라북도","완주군",9491,9491,6186,361,1833,377,664,1,2,5,0,4,2,5,10,9450,41,0
"12780","재외투표","재외투표","대통령선거","전라북도","완주군",322,248,179,8,23,7,30,0,0,0,0,0,0,1,0,248,0,74
"12781","삼례읍","관내사전투표","대통령선거","전라북도","완주군",2340,2340,1491,68,600,50,115,2,1,2,0,1,0,0,4,2334,6,0
"12782","삼례읍","삼례읍제1투","대통령선거","전라북도","완주군",2339,1445,927,47,380,26,53,0,0,2,0,0,0,2,1,1438,7,894
"12783","삼례읍","삼례읍제2투","대통령선거","전라북도","완주군",2335,1532,1030,52,331,35,77,0,0,1,0,0,0,1,2,1529,3,803
"12784","삼례읍","삼례읍제3투","대통령선거","전라북도","완주군",2439,1637,1039,41,447,38,62,2,0,0,0,0,1,2,1,1633,4,802
"12785","삼례읍","삼례읍제4투","대통령선거","전라북도","완주군",1658,1151,774,30,270,19,48,0,1,0,0,2,1,1,1,1147,4,507
"12786","봉동읍","관내사전투표","대통령선거","전라북도","완주군",4499,4498,3114,108,809,110,337,0,3,3,1,4,0,1,0,4490,8,1
"12787","봉동읍","봉동읍제1투","대통령선거","전라북도","완주군",2523,1657,1051,64,409,47,73,0,0,1,1,0,0,1,5,1652,5,866
"12788","봉동읍","봉동읍제2투","대통령선거","전라북도","완주군",2966,2064,1370,59,480,46,92,0,0,1,0,3,1,0,3,2055,9,902
"12789","봉동읍","봉동읍제3투","대통령선거","전라북도","완주군",911,614,406,20,138,11,31,0,0,0,1,2,0,0,2,611,3,297
"12790","봉동읍","봉동읍제4투","대통령선거","전라북도","완주군",1427,973,619,24,221,26,71,0,0,0,0,6,1,0,2,970,3,454
"12791","봉동읍","봉동읍제5투","대통령선거","전라북도","완주군",2617,2132,1460,62,363,59,177,1,0,0,0,1,0,1,0,2124,8,485
"12792","봉동읍","봉동읍제6투","대통령선거","전라북도","완주군",2872,2156,1496,85,368,52,148,0,0,1,0,1,0,0,1,2152,4,716
"12793","용진읍","관내사전투표","대통령선거","전라북도","완주군",976,976,635,21,236,17,58,1,0,1,0,1,1,0,2,973,3,0
"12794","용진읍","용진읍제1투","대통령선거","전라북도","완주군",782,534,317,10,163,11,22,2,0,1,0,0,2,2,1,531,3,248
"12795","용진읍","용진읍제2투","대통령선거","전라북도","완주군",892,665,442,21,158,9,29,0,0,0,0,0,0,0,2,661,4,227
"12796","용진읍","용진읍제3투","대통령선거","전라북도","완주군",1041,755,470,22,208,18,32,0,0,0,0,1,0,0,2,753,2,286
"12797","용진읍","용진읍제4투","대통령선거","전라북도","완주군",1755,1214,765,42,307,28,60,1,1,0,0,3,0,1,1,1209,5,541
"12798","상관면","관내사전투표","대통령선거","전라북도","완주군",884,884,580,34,191,19,50,2,0,1,0,2,1,1,0,881,3,0
"12799","상관면","상관면제1투","대통령선거","전라북도","완주군",1981,1336,829,58,353,36,50,0,0,0,0,0,1,2,3,1332,4,645
"12800","상관면","상관면제2투","대통령선거","전라북도","완주군",591,396,245,7,111,8,16,0,0,2,0,2,0,0,2,393,3,195
"12801","이서면","관내사전투표","대통령선거","전라북도","완주군",2048,2048,1461,61,355,54,107,1,0,0,0,4,0,0,2,2045,3,0
"12802","이서면","이서면제1투","대통령선거","전라북도","완주군",1871,1235,758,43,334,30,55,0,0,9,0,1,0,0,1,1231,4,636
"12803","이서면","이서면제2투","대통령선거","전라북도","완주군",2662,1962,1314,52,434,53,97,0,0,3,0,5,0,1,0,1959,3,700
"12804","이서면","이서면제3투","대통령선거","전라북도","완주군",3273,2614,1818,67,500,68,146,0,0,2,0,4,0,0,3,2608,6,659
"12805","소양면","관내사전투표","대통령선거","전라북도","완주군",1082,1082,683,44,240,23,52,2,1,6,2,2,2,1,2,1060,22,0
"12806","소양면","소양면제1투","대통령선거","전라북도","완주군",1083,697,458,25,165,16,25,0,0,0,0,0,1,0,1,691,6,386
"12807","소양면","소양면제2투","대통령선거","전라북도","완주군",1068,800,541,23,177,20,30,0,0,0,0,0,0,1,6,798,2,268
"12808","소양면","소양면제3투","대통령선거","전라북도","완주군",757,519,363,22,107,8,12,0,0,0,0,0,1,1,2,516,3,238
"12809","소양면","소양면제4투","대통령선거","전라북도","완주군",990,648,459,30,120,10,23,1,0,1,0,0,0,0,1,645,3,342
"12810","구이면","관내사전투표","대통령선거","전라북도","완주군",914,914,577,27,235,18,48,0,1,0,1,3,0,0,2,912,2,0
"12811","구이면","구이면제1투","대통령선거","전라북도","완주군",1426,1025,606,35,309,16,49,1,0,3,0,0,1,0,1,1021,4,401
"12812","구이면","구이면제2투","대통령선거","전라북도","완주군",1176,890,546,25,263,11,36,0,0,0,0,2,0,1,4,888,2,286
"12813","구이면","구이면제3투","대통령선거","전라북도","완주군",978,657,372,20,221,13,19,0,0,0,1,2,1,0,5,654,3,321
"12814","고산면","관내사전투표","대통령선거","전라북도","완주군",1572,1572,1052,35,360,17,73,1,0,2,3,5,1,1,5,1555,17,0
"12815","고산면","고산면제1투","대통령선거","전라북도","완주군",1668,1081,732,42,240,16,41,0,0,0,0,3,1,0,2,1077,4,587
"12816","고산면","고산면제2투","대통령선거","전라북도","완주군",822,574,384,19,142,7,20,0,0,0,0,0,2,0,0,574,0,248
"12817","비봉면","관내사전투표","대통령선거","전라북도","완주군",333,333,221,7,81,4,15,0,1,0,0,0,0,0,1,330,3,0
"12818","비봉면","비봉면제1투","대통령선거","전라북도","완주군",800,521,368,9,115,11,13,1,1,0,0,0,0,0,1,519,2,279
"12819","비봉면","비봉면제2투","대통령선거","전라북도","완주군",381,271,187,11,51,8,6,0,1,0,0,0,1,0,6,271,0,110
"12820","운주면","관내사전투표","대통령선거","전라북도","완주군",416,416,249,29,106,8,19,0,0,0,0,1,0,1,1,414,2,0
"12821","운주면","운주면투표소","대통령선거","전라북도","완주군",1235,814,455,80,222,17,26,0,0,2,1,0,2,2,5,812,2,421
"12822","화산면","관내사전투표","대통령선거","전라북도","완주군",475,475,338,17,96,3,16,0,0,0,0,0,0,0,4,474,1,0
"12823","화산면","화산면투표소","대통령선거","전라북도","완주군",1661,1095,731,40,257,15,35,0,0,1,1,1,1,1,7,1090,5,566
"12824","동상면","관내사전투표","대통령선거","전라북도","완주군",217,217,124,20,61,1,8,0,0,1,0,1,0,0,0,216,1,0
"12825","동상면","동상면투표소","대통령선거","전라북도","완주군",543,343,216,25,79,2,12,0,0,0,0,0,0,2,7,343,0,200
"12826","경천면","관내사전투표","대통령선거","전라북도","완주군",321,321,217,16,68,5,11,0,1,0,0,0,0,1,0,319,2,0
"12827","경천면","경천면투표소","대통령선거","전라북도","완주군",564,392,249,25,100,5,11,0,0,0,1,0,0,0,1,392,0,172
"12828","잘못 투입·구분된 투표지","잘못 투입·구분된 투표지","대통령선거","전라북도","완주군",0,1,0,0,1,0,0,0,0,0,0,0,0,0,0,1,0,-1
"12829","거소·선상투표","거소·선상투표","대통령선거","전라북도","진안군",107,101,50,3,32,3,3,0,0,0,0,0,0,0,3,94,7,6
"12830","관외사전투표","관외사전투표","대통령선거","전라북도","진안군",3175,3175,2118,129,535,118,256,1,0,2,0,2,1,0,5,3167,8,0
"12831","재외투표","재외투표","대통령선거","전라북도","진안군",107,79,54,6,7,3,7,1,0,0,0,0,0,0,0,78,1,28
"12832","진안읍","관내사전투표","대통령선거","전라북도","진안군",2092,2092,1465,75,370,49,105,1,0,2,1,2,1,1,4,2076,16,0
"12833","진안읍","진안읍제1투","대통령선거","전라북도","진안군",1541,963,616,49,238,18,30,0,0,1,0,1,3,1,2,959,4,578
"12834","진안읍","진안읍제2투","대통령선거","전라북도","진안군",2050,1426,967,37,335,24,51,1,0,0,0,0,0,1,5,1421,5,624
"12835","진안읍","진안읍제3투","대통령선거","전라북도","진안군",1960,1249,835,67,287,18,32,0,0,0,0,0,2,0,4,1245,4,711
"12836","용담면","관내사전투표","대통령선거","전라북도","진안군",153,153,89,14,37,2,4,0,0,1,0,0,0,1,2,150,3,0
"12837","용담면","용담면투표소","대통령선거","전라북도","진안군",506,353,206,29,90,10,12,0,0,0,0,0,2,1,2,352,1,153
"12838","안천면","관내사전투표","대통령선거","전라북도","진안군",164,164,105,2,43,4,8,0,0,0,0,0,0,0,2,164,0,0
"12839","안천면","안천면투표소","대통령선거","전라북도","진안군",660,496,282,38,132,10,14,1,0,0,0,0,4,3,6,490,6,164
"12840","동향면","관내사전투표","대통령선거","전라북도","진안군",274,274,185,13,53,5,13,0,0,0,0,0,1,0,2,272,2,0
"12841","동향면","동향면투표소","대통령선거","전라북도","진안군",912,659,431,26,145,13,29,1,0,0,0,1,0,3,5,654,5,253
"12842","상전면","관내사전투표","대통령선거","전라북도","진안군",137,137,91,2,36,2,5,0,0,0,0,0,0,0,1,137,0,0
"12843","상전면","상전면투표소","대통령선거","전라북도","진안군",502,344,189,16,117,7,7,0,0,0,0,0,0,2,5,343,1,158
"12844","백운면","관내사전투표","대통령선거","전라북도","진안군",411,411,291,17,64,7,21,0,0,0,0,3,0,0,2,405,6,0
"12845","백운면","백운면투표소","대통령선거","전라북도","진안군",1143,796,545,40,157,16,22,0,1,2,0,2,2,1,4,792,4,347
"12846","성수면","관내사전투표","대통령선거","전라북도","진안군",274,274,199,11,53,1,7,1,0,0,1,0,1,0,0,274,0,0
"12847","성수면","성수면투표소","대통령선거","전라북도","진안군",1054,719,485,27,167,6,22,0,0,0,0,1,1,2,5,716,3,335
"12848","마령면","관내사전투표","대통령선거","전라북도","진안군",326,326,221,12,68,4,16,0,0,0,0,0,0,1,2,324,2,0
"12849","마령면","마령면투표소","대통령선거","전라북도","진안군",1125,786,500,34,194,13,29,2,0,0,0,0,2,0,7,781,5,339
"12850","부귀면","관내사전투표","대통령선거","전라북도","진안군",481,481,338,15,100,8,17,0,0,0,0,1,1,0,0,480,1,0
"12851","부귀면","부귀면투표소","대통령선거","전라북도","진안군",1502,1029,692,42,224,21,38,2,0,2,0,0,0,1,4,1026,3,473
"12852","정천면","관내사전투표","대통령선거","전라북도","진안군",209,209,130,4,58,3,6,0,0,1,0,0,0,1,5,208,1,0
"12853","정천면","정천면투표소","대통령선거","전라북도","진안군",598,441,297,17,99,10,13,1,0,0,0,0,0,0,1,438,3,157
"12854","주천면","관내사전투표","대통령선거","전라북도","진안군",267,267,170,24,48,8,12,0,1,0,0,0,0,1,1,265,2,0
"12855","주천면","주천면투표소","대통령선거","전라북도","진안군",974,703,367,70,215,9,27,0,1,1,0,0,1,3,4,698,5,271
"12856","잘못 투입·구분된 투표지","잘못 투입·구분된 투표지","대통령선거","전라북도","진안군",0,0,0,0,0,0,0,0,0,0,0,0,0,0,0,0,0,0
"12857","거소·선상투표","거소·선상투표","대통령선거","전라북도","무주군",157,143,65,15,40,6,1,0,1,2,1,3,0,1,2,137,6,14
"12858","관외사전투표","관외사전투표","대통령선거","전라북도","무주군",2129,2129,1285,139,410,98,165,3,2,3,0,4,1,1,4,2115,14,0
"12859","재외투표","재외투표","대통령선거","전라북도","무주군",91,65,43,0,10,3,7,0,0,0,1,1,0,0,0,65,0,26
"12860","무주읍","관내사전투표","대통령선거","전라북도","무주군",2386,2386,1563,123,506,53,122,1,0,2,2,2,1,0,3,2378,8,0
"12861","무주읍","무주읍제1투","대통령선거","전라북도","무주군",1615,1078,632,82,285,27,48,1,0,0,0,0,0,2,0,1077,1,537
"12862","무주읍","무주읍제2투","대통령선거","전라북도","무주군",1779,1205,735,90,299,29,43,0,0,0,0,0,0,0,2,1198,7,574
"12863","무주읍","무주읍제3투","대통령선거","전라북도","무주군",1382,865,499,86,212,14,30,1,0,3,0,2,1,4,7,859,6,517
"12864","무풍면","관내사전투표","대통령선거","전라북도","무주군",398,398,245,31,92,9,16,0,0,1,0,1,0,0,2,397,1,0
"12865","무풍면","무풍면제1투","대통령선거","전라북도","무주군",1326,913,465,108,260,37,26,0,0,0,0,4,1,1,2,904,9,413
"12866","무풍면","무풍면제2투","대통령선거","전라북도","무주군",188,136,79,7,42,1,5,0,0,0,0,0,0,0,1,135,1,52
"12867","설천면","관내사전투표","대통령선거","전라북도","무주군",734,734,465,56,152,26,30,0,0,1,0,0,1,1,0,732,2,0
"12868","설천면","설천면제1투","대통령선거","전라북도","무주군",1537,1052,611,91,261,21,49,0,0,2,1,0,2,0,5,1043,9,485
"12869","설천면","설천면제2투","대통령선거","전라북도","무주군",951,676,393,48,178,18,29,0,0,1,0,0,0,0,5,672,4,275
"12870","적상면","관내사전투표","대통령선거","전라북도","무주군",403,403,250,31,103,7,10,0,0,0,0,0,0,0,0,401,2,0
"12871","적상면","적상면제1투","대통령선거","전라북도","무주군",821,586,374,55,135,7,9,0,0,0,0,0,0,1,2,583,3,235
"12872","적상면","적상면제2투","대통령선거","전라북도","무주군",333,237,141,16,70,4,2,0,0,1,1,0,0,0,0,235,2,96
"12873","적상면","적상면제3투","대통령선거","전라북도","무주군",586,415,237,33,124,8,4,1,0,0,0,1,2,0,2,412,3,171
"12874","안성면","관내사전투표","대통령선거","전라북도","무주군",746,746,493,34,158,12,36,0,0,0,0,0,2,1,8,744,2,0
"12875","안성면","안성면제1투","대통령선거","전라북도","무주군",1373,980,644,47,217,18,31,0,0,0,0,1,1,3,7,969,11,393
"12876","안성면","안성면제2투","대통령선거","전라북도","무주군",1449,973,651,54,196,14,42,1,0,3,2,3,0,1,3,970,3,476
"12877","부남면","관내사전투표","대통령선거","전라북도","무주군",240,240,147,21,61,4,3,0,0,0,0,0,1,1,1,239,1,0
"12878","부남면","부남면투표소","대통령선거","전라북도","무주군",967,659,364,58,187,18,15,0,1,0,0,1,2,0,7,653,6,308
"12879","잘못 투입·구분된 투표지","잘못 투입·구분된 투표지","대통령선거","전라북도","무주군",0,0,0,0,0,0,0,0,0,0,0,0,0,0,0,0,0,0
"12880","거소·선상투표","거소·선상투표","대통령선거","전라북도","장수군",48,44,31,3,6,0,0,1,0,0,0,0,0,0,0,41,3,4
"12881","관외사전투표","관외사전투표","대통령선거","전라북도","장수군",2345,2344,1575,93,383,100,178,1,0,1,1,1,0,1,2,2336,8,1
"12882","재외투표","재외투표","대통령선거","전라북도","장수군",91,68,44,0,11,1,12,0,0,0,0,0,0,0,0,68,0,23
"12883","장수읍","관내사전투표","대통령선거","전라북도","장수군",1425,1425,974,42,289,32,67,1,0,1,1,3,1,2,3,1416,9,0
"12884","장수읍","장수읍제1투","대통령선거","전라북도","장수군",1266,891,567,51,219,13,31,0,0,0,0,1,0,0,5,887,4,375
"12885","장수읍","장수읍제2투","대통령선거","전라북도","장수군",1120,795,519,47,179,15,20,0,0,0,1,1,1,1,5,789,6,325
"12886","장수읍","장수읍제3투","대통령선거","전라북도","장수군",1751,1221,783,76,280,28,36,1,1,2,0,0,1,0,2,1210,11,530
"12887","산서면","관내사전투표","대통령선거","전라북도","장수군",421,421,290,12,92,7,11,1,0,1,0,0,2,1,1,418,3,0
"12888","산서면","산서면투표소","대통령선거","전라북도","장수군",1376,961,648,27,230,11,27,0,1,0,0,0,3,1,6,954,7,415
"12889","번암면","관내사전투표","대통령선거","전라북도","장수군",468,468,315,9,96,13,28,0,0,0,0,1,0,2,2,466,2,0
"12890","번암면","번암면투표소","대통령선거","전라북도","장수군",1477,1046,706,51,220,14,24,0,1,1,0,2,4,2,10,1035,11,431
"12891","장계면","관내사전투표","대통령선거","전라북도","장수군",966,966,621,45,216,24,43,0,0,0,0,2,2,0,5,958,8,0
"12892","장계면","장계면제1투","대통령선거","전라북도","장수군",1476,991,679,48,188,20,42,0,1,2,0,0,2,1,4,987,4,485
"12893","장계면","장계면제2투","대통령선거","전라북도","장수군",1118,789,541,40,162,12,23,1,0,0,0,1,2,0,3,785,4,329
"12894","천천면","관내사전투표","대통령선거","전라북도","장수군",378,378,266,11,77,4,13,0,0,0,0,1,1,0,2,375,3,0
"12895","천천면","천천면투표소","대통령선거","전라북도","장수군",1378,951,627,54,210,17,26,0,0,4,0,0,0,2,5,945,6,427
"12896","계남면","관내사전투표","대통령선거","전라북도","장수군",353,353,226,12,87,5,17,1,0,0,0,0,0,1,2,351,2,0
"12897","계남면","계남면투표소","대통령선거","전라북도","장수군",1392,982,650,46,204,13,44,1,0,1,0,4,2,3,5,973,9,410
"12898","계북면","관내사전투표","대통령선거","전라북도","장수군",325,325,211,15,71,3,18,0,1,1,0,1,0,0,3,324,1,0
"12899","계북면","계북면투표소","대통령선거","전라북도","장수군",949,660,441,35,133,10,28,0,1,0,0,0,0,0,9,657,3,289
"12900","잘못 투입·구분된 투표지","잘못 투입·구분된 투표지","대통령선거","전라북도","장수군",0,0,0,0,0,0,0,0,0,0,0,0,0,0,0,0,0,0
"12901","거소·선상투표","거소·선상투표","대통령선거","전라북도","임실군",141,126,59,14,25,4,8,1,3,1,0,0,1,2,0,118,8,15
"12902","관외사전투표","관외사전투표","대통령선거","전라북도","임실군",3474,3473,2256,111,693,133,240,1,0,3,3,4,2,1,8,3455,18,1
"12903","재외투표","재외투표","대통령선거","전라북도","임실군",90,63,44,1,9,2,7,0,0,0,0,0,0,0,0,63,0,27
"12904","임실읍","관내사전투표","대통령선거","전라북도","임실군",1573,1573,1042,63,288,49,110,0,1,3,0,1,0,0,4,1561,12,0
"12905","임실읍","임실읍제1투","대통령선거","전라북도","임실군",1398,929,518,57,276,28,37,2,0,0,0,0,1,1,2,922,7,469
"12906","임실읍","임실읍제2투","대통령선거","전라북도","임실군",1347,929,608,34,222,15,44,0,0,1,0,0,1,0,2,927,2,418
"12907","임실읍","임실읍제3투","대통령선거","전라북도","임실군",1192,764,461,37,220,7,20,0,0,0,0,0,4,2,6,757,7,428
"12908","청웅면","관내사전투표","대통령선거","전라북도","임실군",261,261,145,8,93,5,5,0,1,0,0,0,0,0,1,258,3,0
"12909","청웅면","청웅면투표소","대통령선거","전라북도","임실군",895,609,359,24,183,3,21,0,0,3,1,1,2,0,9,606,3,286
"12910","운암면","관내사전투표","대통령선거","전라북도","임실군",91,91,64,1,20,1,4,0,0,0,0,0,0,0,1,91,0,0
"12911","운암면","운암면제1투","대통령선거","전라북도","임실군",323,228,139,11,58,6,7,0,0,2,0,1,0,0,1,225,3,95
"12912","운암면","운암면제2투","대통령선거","전라북도","임실군",272,198,141,4,30,1,8,0,1,0,0,0,3,2,7,197,1,74
"12913","운암면","운암면제3투","대통령선거","전라북도","임실군",480,312,186,16,84,2,8,0,0,1,0,1,0,3,10,311,1,168
"12914","신평면","관내사전투표","대통령선거","전라북도","임실군",329,329,211,15,84,1,10,0,2,0,0,0,1,1,2,327,2,0
"12915","신평면","신평면투표소","대통령선거","전라북도","임실군",847,547,334,17,147,11,23,1,0,0,1,1,0,1,3,539,8,300
"12916","성수면","관내사전투표","대통령선거","전라북도","임실군",205,205,131,3,47,2,21,0,0,0,0,0,0,0,0,204,1,0
"12917","성수면","성수면제1투","대통령선거","전라북도","임실군",797,540,339,35,130,9,14,0,1,0,3,1,0,0,3,535,5,257
"12918","성수면","성수면제2투","대통령선거","전라북도","임실군",347,261,186,5,51,1,7,0,0,0,0,0,1,2,5,258,3,86
"12919","오수면","관내사전투표","대통령선거","전라북도","임실군",843,843,558,31,195,6,39,0,0,0,0,2,1,1,5,838,5,0
"12920","오수면","오수면제1투","대통령선거","전라북도","임실군",1196,810,555,25,181,7,33,0,0,1,0,0,0,0,4,806,4,386
"12921","오수면","오수면제2투","대통령선거","전라북도","임실군",1288,877,561,32,238,13,17,0,0,2,0,1,0,2,3,869,8,411
"12922","신덕면","관내사전투표","대통령선거","전라북도","임실군",196,196,142,5,36,5,7,0,0,0,0,0,0,0,0,195,1,0
"12923","신덕면","신덕면투표소","대통령선거","전라북도","임실군",844,580,365,14,162,7,11,0,0,1,1,0,2,1,7,571,9,264
"12924","삼계면","관내사전투표","대통령선거","전라북도","임실군",220,220,141,10,52,4,9,0,1,0,0,0,1,1,1,220,0,0
"12925","삼계면","삼계면투표소","대통령선거","전라북도","임실군",1003,675,435,21,175,6,25,0,0,0,0,0,0,2,6,670,5,328
"12926","관촌면","관내사전투표","대통령선거","전라북도","임실군",1070,1070,676,44,264,24,47,0,0,0,1,0,0,0,6,1062,8,0
"12927","관촌면","관촌면제1투","대통령선거","전라북도","임실군",1188,750,433,36,222,14,33,0,0,0,0,2,0,0,7,747,3,438
"12928","관촌면","관촌면제2투","대통령선거","전라북도","임실군",689,457,270,7,141,8,20,0,0,1,0,0,1,0,1,449,8,232
"12929","강진면","관내사전투표","대통령선거","전라북도","임실군",308,308,201,7,82,1,13,0,0,1,0,1,0,1,1,308,0,0
"12930","강진면","강진면투표소","대통령선거","전라북도","임실군",1028,684,412,33,197,10,12,0,0,0,0,0,0,5,10,679,5,344
"12931","덕치면","관내사전투표","대통령선거","전라북도","임실군",140,140,91,1,33,0,12,0,0,0,0,0,0,0,1,138,2,0
"12932","덕치면","덕치면제1투","대통령선거","전라북도","임실군",479,345,204,15,95,4,12,0,0,0,1,0,2,1,4,338,7,134
"12933","덕치면","덕치면제2투","대통령선거","전라북도","임실군",298,211,129,12,60,1,2,0,0,0,0,0,0,2,1,207,4,87
"12934","지사면","관내사전투표","대통령선거","전라북도","임실군",179,179,114,10,49,2,4,0,0,0,0,0,0,0,0,179,0,0
"12935","지사면","지사면투표소","대통령선거","전라북도","임실군",832,598,383,12,167,11,14,1,0,0,0,1,0,1,6,596,2,234
"12936","잘못 투입·구분된 투표지","잘못 투입·구분된 투표지","대통령선거","전라북도","임실군",0,0,0,0,0,0,0,0,0,0,0,0,0,0,0,0,0,0
"12937","거소·선상투표","거소·선상투표","대통령선거","전라북도","순창군",208,193,99,15,56,1,3,1,3,1,0,3,1,2,2,187,6,15
"12938","관외사전투표","관외사전투표","대통령선거","전라북도","순창군",3122,3122,1987,106,700,91,215,0,0,1,1,13,0,0,1,3115,7,0
"12939","재외투표","재외투표","대통령선거","전라북도","순창군",130,78,42,10,16,0,10,0,0,0,0,0,0,0,0,78,0,52
"12940","순창읍","관내사전투표","대통령선거","전라북도","순창군",2016,2016,1325,47,492,26,98,2,0,1,0,7,1,1,7,2007,9,0
"12941","순창읍","순창읍제1투","대통령선거","전라북도","순창군",1529,1083,658,37,311,26,44,0,0,0,0,2,0,0,3,1081,2,446
"12942","순창읍","순창읍제2투","대통령선거","전라북도","순창군",1711,1152,666,42,367,26,34,1,0,1,1,6,1,0,3,1148,4,559
"12943","순창읍","순창읍제3투","대통령선거","전라북도","순창군",1885,1302,732,38,450,17,45,2,0,1,0,5,0,0,3,1293,9,583
"12944","인계면","관내사전투표","대통령선거","전라북도","순창군",287,287,177,12,84,3,3,0,0,0,0,1,0,2,2,284,3,0
"12945","인계면","인계면투표소","대통령선거","전라북도","순창군",980,666,418,26,180,9,14,1,1,0,0,4,2,3,4,662,4,314
"12946","동계면","관내사전투표","대통령선거","전라북도","순창군",461,461,300,9,124,4,17,0,0,0,0,2,0,2,1,459,2,0
"12947","동계면","동계면제1투","대통령선거","전라북도","순창군",799,551,333,26,158,3,12,1,0,0,0,3,2,1,7,546,5,248
"12948","동계면","동계면제2투","대통령선거","전라북도","순창군",443,292,160,14,94,5,13,0,0,0,0,2,0,0,4,292,0,151
"12949","적성면","관내사전투표","대통령선거","전라북도","순창군",355,355,228,16,86,5,10,0,0,0,0,3,3,0,2,353,2,0
"12950","적성면","적성면투표소","대통령선거","전라북도","순창군",772,510,313,20,128,12,17,0,0,0,0,6,2,2,4,504,6,262
"12951","유등면","관내사전투표","대통령선거","전라북도","순창군",217,217,155,10,32,2,13,0,0,0,0,2,0,0,1,215,2,0
"12952","유등면","유등면투표소","대통령선거","전라북도","순창군",784,515,309,11,148,12,19,0,0,0,0,6,1,1,3,510,5,269
"12953","풍산면","관내사전투표","대통령선거","전라북도","순창군",298,298,181,9,85,4,13,0,0,0,0,2,0,0,3,297,1,0
"12954","풍산면","풍산면제1투","대통령선거","전라북도","순창군",606,429,276,15,120,1,4,0,0,0,0,4,2,0,3,425,4,177
"12955","풍산면","풍산면제2투","대통령선거","전라북도","순창군",554,411,269,11,89,4,11,0,1,4,0,11,0,0,7,407,4,143
"12956","금과면","관내사전투표","대통령선거","전라북도","순창군",381,381,230,12,117,6,15,0,0,0,0,0,0,0,0,380,1,0
"12957","금과면","금과면투표소","대통령선거","전라북도","순창군",1017,682,419,17,195,10,22,1,0,0,2,1,2,2,7,678,4,335
"12958","팔덕면","관내사전투표","대통령선거","전라북도","순창군",278,278,185,6,76,2,5,0,0,0,0,1,0,0,1,276,2,0
"12959","팔덕면","팔덕면투표소","대통령선거","전라북도","순창군",939,646,398,24,189,6,21,0,0,0,0,1,1,0,2,642,4,293
"12960","복흥면","관내사전투표","대통령선거","전라북도","순창군",385,385,256,11,97,4,10,0,0,0,0,1,0,0,4,383,2,0
"12961","복흥면","복흥면제1투","대통령선거","전라북도","순창군",965,647,410,15,186,11,16,0,2,0,0,1,0,0,5,646,1,318
"12962","복흥면","복흥면제2투","대통령선거","전라북도","순창군",488,345,197,15,112,2,9,1,0,0,1,0,0,1,4,342,3,143
"12963","쌍치면","관내사전투표","대통령선거","전라북도","순창군",429,429,256,23,111,7,12,1,0,0,2,1,0,2,5,420,9,0
"12964","쌍치면","쌍치면제1투","대통령선거","전라북도","순창군",678,436,262,20,130,2,11,2,1,1,0,1,1,2,1,434,2,242
"12965","쌍치면","쌍치면제2투","대통령선거","전라북도","순창군",556,380,194,17,149,5,5,0,0,0,0,4,0,1,3,378,2,176
"12966","구림면","관내사전투표","대통령선거","전라북도","순창군",517,517,276,17,183,10,12,0,1,0,0,3,2,0,5,509,8,0
"12967","구림면","구림면제1투","대통령선거","전라북도","순창군",1017,681,380,21,243,4,13,2,0,0,0,7,1,0,8,679,2,336
"12968","구림면","구림면제2투","대통령선거","전라북도","순창군",512,381,218,16,116,4,9,0,0,1,0,11,1,0,2,378,3,131
"12969","잘못 투입·구분된 투표지","잘못 투입·구분된 투표지","대통령선거","전라북도","순창군",0,0,0,0,0,0,0,0,0,0,0,0,0,0,0,0,0,0
"12970","거소·선상투표","거소·선상투표","대통령선거","전라북도","고창군",241,223,119,12,66,4,6,2,2,0,0,0,0,0,2,213,10,18
"12971","관외사전투표","관외사전투표","대통령선거","전라북도","고창군",5175,5175,3308,155,1104,190,373,1,1,2,1,9,2,1,6,5153,22,0
"12972","재외투표","재외투표","대통령선거","전라북도","고창군",161,122,86,11,15,1,9,0,0,0,0,0,0,0,0,122,0,39
"12973","고창읍","관내사전투표","대통령선거","전라북도","고창군",3949,3949,2618,91,899,115,204,0,0,0,0,5,1,0,4,3937,12,0
"12974","고창읍","고창읍제1투","대통령선거","전라북도","고창군",1293,833,506,32,243,7,34,1,0,1,0,1,0,0,2,827,6,460
"12975","고창읍","고창읍제2투","대통령선거","전라북도","고창군",1550,1050,715,24,240,27,38,0,0,0,0,1,0,1,1,1047,3,500
"12976","고창읍","고창읍제3투","대통령선거","전라북도","고창군",1817,1211,725,48,387,17,27,0,0,0,0,0,0,0,2,1206,5,606
"12977","고창읍","고창읍제4투","대통령선거","전라북도","고창군",1344,879,514,30,295,13,19,1,0,1,0,0,0,2,1,876,3,465
"12978","고창읍","고창읍제5투","대통령선거","전라북도","고창군",1094,709,400,31,234,11,19,0,0,1,0,2,2,0,4,704,5,385
"12979","고창읍","고창읍제6투","대통령선거","전라북도","고창군",1484,1056,629,25,334,19,32,1,1,1,0,2,1,0,4,1049,7,428
"12980","고창읍","고창읍제7투","대통령선거","전라북도","고창군",2432,1658,1043,46,463,29,57,4,0,3,0,2,0,0,1,1648,10,774
"12981","고수면","관내사전투표","대통령선거","전라북도","고창군",793,793,475,15,236,8,33,0,0,0,0,1,2,2,7,779,14,0
"12982","고수면","고수면제1투","대통령선거","전라북도","고창군",636,401,221,13,144,5,13,0,1,0,0,0,1,0,3,401,0,235
"12983","고수면","고수면제2투","대통령선거","전라북도","고창군",719,487,260,15,183,6,17,0,0,1,0,0,2,0,1,485,2,232
"12984","아산면","관내사전투표","대통령선거","전라북도","고창군",664,664,385,30,190,12,24,0,1,0,0,12,0,1,6,661,3,0
"12985","아산면","아산면제1투","대통령선거","전라북도","고창군",1152,738,426,27,232,14,19,0,0,0,0,6,1,1,6,732,6,414
"12986","아산면","아산면제2투","대통령선거","전라북도","고창군",642,424,225,15,146,11,15,1,0,0,1,0,0,2,4,420,4,218
"12987","무장면","관내사전투표","대통령선거","전라북도","고창군",608,608,365,21,188,3,16,0,0,2,0,1,0,0,2,598,10,0
"12988","무장면","무장면제1투","대통령선거","전라북도","고창군",864,525,313,25,157,6,12,1,0,1,0,2,0,3,2,522,3,339
"12989","무장면","무장면제2투","대통령선거","전라북도","고창군",1015,649,396,18,208,3,10,0,0,0,0,4,2,0,6,647,2,366
"12990","공음면","관내사전투표","대통령선거","전라북도","고창군",623,623,361,15,196,7,19,1,0,0,0,6,1,1,10,617,6,0
"12991","공음면","공음면제1투","대통령선거","전라북도","고창군",943,618,341,15,216,6,16,1,1,1,0,5,1,1,5,609,9,325
"12992","공음면","공음면제2투","대통령선거","전라북도","고창군",751,475,266,10,180,3,7,0,0,0,0,3,0,1,0,470,5,276
"12993","상하면","관내사전투표","대통령선거","전라북도","고창군",625,625,371,20,164,9,21,0,1,0,1,6,2,1,10,606,19,0
"12994","상하면","상하면제1투","대통령선거","전라북도","고창군",723,477,281,17,148,6,11,0,0,0,0,2,1,1,7,474,3,246
"12995","상하면","상하면제2투","대통령선거","전라북도","고창군",841,526,307,9,170,7,16,0,0,0,0,1,2,3,5,520,6,315
"12996","해리면","관내사전투표","대통령선거","전라북도","고창군",764,764,466,22,228,14,17,1,0,0,0,1,1,0,9,759,5,0
"12997","해리면","해리면제1투","대통령선거","전라북도","고창군",1087,648,393,27,194,4,13,0,1,2,2,0,4,2,3,645,3,439
"12998","해리면","해리면제2투","대통령선거","전라북도","고창군",773,509,307,4,173,3,7,0,1,0,1,1,1,0,4,502,7,264
"12999","성송면","관내사전투표","대통령선거","전라북도","고창군",400,400,244,19,114,4,15,0,0,1,0,0,0,1,0,398,2,0
"13000","성송면","성송면제1투","대통령선거","전라북도","고창군",747,512,311,14,152,11,10,2,0,0,0,2,0,2,4,508,4,235
"13001","성송면","성송면제2투","대통령선거","전라북도","고창군",523,325,190,11,101,5,10,0,0,0,0,0,0,0,4,321,4,198
"13002","대산면","관내사전투표","대통령선거","전라북도","고창군",774,774,470,29,227,11,24,0,0,0,0,1,0,2,2,766,8,0
"13003","대산면","대산면제1투","대통령선거","전라북도","고창군",1380,838,474,20,294,11,26,3,1,0,0,0,1,2,3,835,3,542
"13004","대산면","대산면제2투","대통령선거","전라북도","고창군",966,660,358,23,241,4,15,0,0,0,1,0,2,2,6,652,8,306
"13005","심원면","관내사전투표","대통령선거","전라북도","고창군",598,598,358,19,177,10,23,2,0,1,0,0,3,2,2,597,1,0
"13006","심원면","심원면제1투","대통령선거","전라북도","고창군",890,542,327,18,153,11,17,2,0,2,0,0,2,3,2,537,5,348
"13007","심원면","심원면제2투","대통령선거","전라북도","고창군",784,508,305,19,157,8,9,2,0,0,0,0,0,0,3,503,5,276
"13008","흥덕면","관내사전투표","대통령선거","전라북도","고창군",698,698,467,22,158,9,28,0,0,1,0,3,0,1,2,691,7,0
"13009","흥덕면","흥덕면제1투","대통령선거","전라북도","고창군",1189,794,479,33,223,12,27,0,1,2,0,3,0,4,4,788,6,395
"13010","흥덕면","흥덕면제2투","대통령선거","전라북도","고창군",1029,677,414,19,207,8,13,0,0,2,0,0,0,1,8,672,5,352
"13011","성내면","관내사전투표","대통령선거","전라북도","고창군",571,571,349,21,156,7,22,1,1,1,0,3,2,0,4,567,4,0
"13012","성내면","성내면제1투","대통령선거","전라북도","고창군",613,384,210,14,125,3,21,1,4,0,0,0,1,1,2,382,2,229
"13013","성내면","성내면제2투","대통령선거","전라북도","고창군",571,365,225,5,113,3,8,0,1,1,0,4,2,0,0,362,3,206
"13014","신림면","관내사전투표","대통령선거","전라북도","고창군",508,508,315,13,147,9,13,0,0,0,0,1,2,1,3,504,4,0
"13015","신림면","신림면제1투","대통령선거","전라북도","고창군",823,498,323,16,131,5,5,1,0,0,0,1,0,3,8,493,5,325
"13016","신림면","신림면제2투","대통령선거","전라북도","고창군",577,380,232,12,115,8,8,1,0,0,0,1,0,0,2,379,1,197
"13017","부안면","관내사전투표","대통령선거","전라북도","고창군",661,661,386,17,213,6,16,0,1,1,4,0,2,2,3,651,10,0
"13018","부안면","부안면제1투","대통령선거","전라북도","고창군",915,586,332,29,185,10,14,1,1,1,0,1,1,2,4,581,5,329
"13019","부안면","부안면제2투","대통령선거","전라북도","고창군",754,490,286,19,160,7,5,0,0,1,0,2,2,1,0,483,7,264
"13020","잘못 투입·구분된 투표지","잘못 투입·구분된 투표지","대통령선거","전라북도","고창군",0,0,0,0,0,0,0,0,0,0,0,0,0,0,0,0,0,0
"13021","거소·선상투표","거소·선상투표","대통령선거","전라북도","부안군",184,164,73,16,54,5,0,1,2,0,0,1,0,1,1,154,10,20
"13022","관외사전투표","관외사전투표","대통령선거","전라북도","부안군",4943,4943,3119,199,1040,170,366,2,0,3,2,7,2,1,10,4921,22,0
"13023","재외투표","재외투표","대통령선거","전라북도","부안군",164,128,83,8,17,4,16,0,0,0,0,0,0,0,0,128,0,36
"13024","부안읍","관내사전투표","대통령선거","전라북도","부안군",4317,4317,2776,149,1005,100,247,2,0,4,0,3,1,1,6,4294,23,0
"13025","부안읍","부안읍제1투","대통령선거","전라북도","부안군",1076,619,346,39,210,9,12,0,0,0,0,1,1,1,0,619,0,457
"13026","부안읍","부안읍제2투","대통령선거","전라북도","부안군",1014,667,390,42,195,12,21,0,0,2,0,0,0,1,1,664,3,347
"13027","부안읍","부안읍제3투","대통령선거","전라북도","부안군",1975,1230,755,62,325,20,55,0,0,1,0,0,1,1,1,1221,9,745
"13028","부안읍","부안읍제4투","대통령선거","전라북도","부안군",1676,1000,597,39,288,14,55,0,0,3,0,0,1,0,0,997,3,676
"13029","부안읍","부안읍제5투","대통령선거","전라북도","부안군",2124,1343,842,57,355,25,54,1,0,1,1,0,0,1,5,1342,1,781
"13030","부안읍","부안읍제6투","대통령선거","전라북도","부안군",2657,1737,1064,53,486,41,85,0,1,1,0,0,0,1,1,1733,4,920
"13031","부안읍","부안읍제7투","대통령선거","전라북도","부안군",896,601,368,20,180,10,11,0,0,1,0,1,1,2,3,597,4,295
"13032","주산면","관내사전투표","대통령선거","전라북도","부안군",427,427,269,12,123,3,13,1,1,1,1,0,0,0,1,425,2,0
"13033","주산면","주산면투표소","대통령선거","전라북도","부안군",1392,866,494,30,298,8,19,0,0,2,0,0,1,2,4,858,8,526
"13034","동진면","관내사전투표","대통령선거","전라북도","부안군",367,367,210,16,112,8,16,0,1,0,0,0,0,1,1,365,2,0
"13035","동진면","동진면제1투","대통령선거","전라북도","부안군",1007,628,408,29,149,10,26,0,0,0,0,0,0,0,1,623,5,379
"13036","동진면","동진면제2투","대통령선거","전라북도","부안군",485,313,198,18,76,2,10,0,1,0,0,0,0,0,4,309,4,172
"13037","동진면","동진면제3투","대통령선거","전라북도","부안군",687,462,302,18,114,2,14,0,0,0,1,1,0,1,6,459,3,225
"13038","행안면","관내사전투표","대통령선거","전라북도","부안군",723,723,459,27,171,17,46,0,0,0,0,0,0,0,2,722,1,0
"13039","행안면","행안면투표소","대통령선거","전라북도","부안군",1487,921,546,43,274,11,29,0,3,1,0,0,0,3,4,914,7,566
"13040","계화면","관내사전투표","대통령선거","전라북도","부안군",481,481,293,13,129,8,31,1,0,0,0,1,1,0,2,479,2,0
"13041","계화면","계화면제1투","대통령선거","전라북도","부안군",892,560,357,27,148,5,14,0,0,0,0,1,0,2,3,557,3,332
"13042","계화면","계화면제2투","대통령선거","전라북도","부안군",728,507,332,18,131,3,15,0,0,2,0,0,0,0,2,503,4,221
"13043","계화면","계화면제3투","대통령선거","전라북도","부안군",677,454,227,8,187,6,14,0,0,0,0,0,2,0,2,446,8,223
"13044","계화면","계화면제4투","대통령선거","전라북도","부안군",451,317,203,16,81,2,7,0,0,0,2,1,0,0,4,316,1,134
"13045","보안면","관내사전투표","대통령선거","전라북도","부안군",426,426,242,12,128,13,24,0,0,0,0,1,0,0,2,422,4,0
"13046","보안면","보안면제1투","대통령선거","전라북도","부안군",1097,682,356,31,252,12,16,0,0,3,0,0,0,1,4,675,7,415
"13047","보안면","보안면제2투","대통령선거","전라북도","부안군",728,488,283,17,152,8,24,0,0,0,0,0,0,0,2,486,2,240
"13048","변산면","관내사전투표","대통령선거","전라북도","부안군",685,685,418,34,168,18,33,1,1,0,0,0,0,1,6,680,5,0
"13049","변산면","변산면제1투","대통령선거","전라북도","부안군",1313,819,457,38,263,12,34,0,0,1,0,0,3,3,5,816,3,494
"13050","변산면","변산면제2투","대통령선거","전라북도","부안군",1802,1177,727,34,332,21,47,0,0,3,0,2,0,0,3,1169,8,625
"13051","진서면","관내사전투표","대통령선거","전라북도","부안군",358,358,206,15,106,12,16,0,0,1,0,0,0,0,0,356,2,0
"13052","진서면","진서면제1투","대통령선거","전라북도","부안군",1040,652,394,25,199,8,17,0,0,0,0,0,2,1,1,647,5,388
"13053","진서면","진서면제2투","대통령선거","전라북도","부안군",688,480,280,21,142,11,17,0,0,0,0,0,0,1,3,475,5,208
"13054","백산면","관내사전투표","대통령선거","전라북도","부안군",491,491,306,17,133,1,20,0,0,3,0,1,0,0,4,485,6,0
"13055","백산면","백산면제1투","대통령선거","전라북도","부안군",1070,673,447,29,163,11,15,0,0,1,0,0,1,0,1,668,5,397
"13056","백산면","백산면제2투","대통령선거","전라북도","부안군",771,511,312,21,147,9,13,0,0,0,1,0,2,1,1,507,4,260
"13057","상서면","관내사전투표","대통령선거","전라북도","부안군",459,459,286,23,109,4,32,0,0,2,1,1,0,0,1,459,0,0
"13058","상서면","상서면투표소","대통령선거","전라북도","부안군",1479,905,537,36,279,11,24,1,0,0,0,0,1,0,7,896,9,574
"13059","하서면","관내사전투표","대통령선거","전라북도","부안군",578,578,363,29,156,5,18,0,0,2,0,0,1,0,1,575,3,0
"13060","하서면","하서면제1투","대통령선거","전라북도","부안군",719,416,265,15,112,5,9,0,0,0,0,1,1,0,2,410,6,303
"13061","하서면","하서면제2투","대통령선거","전라북도","부안군",585,388,230,20,114,9,6,0,0,0,0,0,1,1,5,386,2,197
"13062","하서면","하서면제3투","대통령선거","전라북도","부안군",587,361,238,12,96,4,6,0,0,1,0,0,0,0,2,359,2,226
"13063","줄포면","관내사전투표","대통령선거","전라북도","부안군",539,539,333,33,132,12,24,0,0,1,0,0,1,0,1,537,2,0
"13064","줄포면","줄포면제1투","대통령선거","전라북도","부안군",1265,801,489,51,225,5,21,0,0,0,0,2,1,0,3,797,4,464
"13065","줄포면","줄포면제2투","대통령선거","전라북도","부안군",599,382,242,17,100,6,11,0,1,0,1,0,1,0,2,381,1,217
"13066","위도면","관내사전투표","대통령선거","전라북도","부안군",215,215,142,6,54,1,6,0,0,0,0,1,0,0,3,213,2,0
"13067","위도면","위도면제1투","대통령선거","전라북도","부안군",557,312,189,10,88,2,12,0,0,0,0,1,0,1,5,308,4,245
"13068","위도면","위도면제2투","대통령선거","전라북도","부안군",145,74,29,2,39,0,1,0,0,0,0,0,1,0,0,72,2,71
"13069","잘못 투입·구분된 투표지","잘못 투입·구분된 투표지","대통령선거","전라북도","부안군",0,0,0,0,0,0,0,0,0,0,0,0,0,0,0,0,0,0
"13070","거소·선상투표","거소·선상투표","대통령선거","전라남도","목포시",831,784,403,23,274,37,28,3,2,1,2,3,0,1,3,780,4,47
"13071","관외사전투표","관외사전투표","대통령선거","전라남도","목포시",15591,15591,9419,330,3937,576,1151,6,8,8,2,29,2,4,21,15493,98,0
"13072","재외투표","재외투표","대통령선거","전라남도","목포시",618,458,329,7,64,9,46,1,0,0,0,0,0,1,0,457,1,160
"13073","용당1동","관내사전투표","대통령선거","전라남도","목포시",2179,2179,1040,36,957,38,89,0,0,2,0,2,0,1,3,2168,11,0
"13074","용당1동","용당1동제1투","대통령선거","전라남도","목포시",1998,1322,625,25,612,17,32,0,1,0,0,2,1,2,2,1319,3,676
"13075","용당1동","용당1동제2투","대통령선거","전라남도","목포시",1857,1092,492,34,510,16,34,0,0,0,0,1,0,0,2,1089,3,765
"13076","용당1동","용당1동제3투","대통령선거","전라남도","목포시",1728,1161,526,28,543,15,43,0,0,0,0,0,1,0,0,1156,5,567
"13077","용당1동","용당1동제4투","대통령선거","전라남도","목포시",1874,1148,504,39,535,14,39,1,1,0,0,3,2,1,3,1142,6,726
"13078","용당2동","관내사전투표","대통령선거","전라남도","목포시",1310,1310,638,12,581,24,43,0,0,0,1,2,0,2,1,1304,6,0
"13079","용당2동","용당2동제1투","대통령선거","전라남도","목포시",1958,1206,519,31,588,18,42,0,0,0,1,2,0,0,1,1202,4,752
"13080","용당2동","용당2동제2투","대통령선거","전라남도","목포시",1643,992,474,22,434,15,34,1,0,1,0,1,1,0,1,984,8,651
"13081","연동","관내사전투표","대통령선거","전라남도","목포시",1082,1082,464,26,522,15,38,1,0,0,0,1,3,1,3,1074,8,0
"13082","연동","연동제1투","대통령선거","전라남도","목포시",1614,873,338,29,461,19,15,1,0,1,0,1,0,0,1,866,7,741
"13083","연동","연동제2투","대통령선거","전라남도","목포시",1729,1134,530,12,542,17,26,0,0,0,0,0,0,0,3,1130,4,595
"13084","산정동","관내사전투표","대통령선거","전라남도","목포시",1970,1970,1039,32,748,38,93,0,0,2,0,2,2,3,3,1962,8,0
"13085","산정동","산정동제1투","대통령선거","전라남도","목포시",2261,1438,741,33,552,31,74,1,0,2,0,1,1,0,0,1436,2,823
"13086","산정동","산정동제2투","대통령선거","전라남도","목포시",2297,1593,821,38,634,23,65,1,0,1,0,2,0,0,4,1589,4,704
"13087","연산동","관내사전투표","대통령선거","전라남도","목포시",1518,1518,840,21,522,22,91,0,1,1,1,5,1,0,2,1507,11,0
"13088","연산동","연산동제1투","대통령선거","전라남도","목포시",1589,1045,554,19,400,13,53,0,0,0,0,2,0,0,3,1044,1,544
"13089","연산동","연산동제2투","대통령선거","전라남도","목포시",1449,1068,595,14,369,26,58,1,0,1,0,2,1,1,0,1068,0,381
"13090","원산동","관내사전투표","대통령선거","전라남도","목포시",2410,2410,1311,41,830,52,154,0,0,3,1,6,0,0,4,2402,8,0
"13091","원산동","원산동제1투","대통령선거","전라남도","목포시",1524,933,453,15,396,22,37,1,0,0,0,2,0,0,1,927,6,591
"13092","원산동","원산동제2투","대통령선거","전라남도","목포시",2090,1456,843,26,471,30,81,1,0,0,0,1,0,0,2,1455,1,634
"13093","원산동","원산동제3투","대통령선거","전라남도","목포시",2323,1496,770,31,590,26,67,1,0,2,0,0,0,0,1,1488,8,827
"13094","원산동","원산동제4투","대통령선거","전라남도","목포시",1857,1302,682,25,474,23,94,0,0,1,0,0,1,0,0,1300,2,555
"13095","대성동","관내사전투표","대통령선거","전라남도","목포시",1392,1392,744,31,507,30,68,1,0,2,0,3,0,0,0,1386,6,0
"13096","대성동","대성동투표소","대통령선거","전라남도","목포시",2893,1875,1015,24,722,18,82,2,1,0,0,1,0,1,1,1867,8,1018
"13097","목원동","관내사전투표","대통령선거","전라남도","목포시",2054,2054,950,32,941,32,85,0,0,3,1,2,1,0,2,2049,5,0
"13098","목원동","목원동제1투","대통령선거","전라남도","목포시",1805,1115,519,23,515,7,39,0,0,2,0,1,0,0,3,1109,6,690
"13099","목원동","목원동제2투","대통령선거","전라남도","목포시",1871,1040,427,29,521,22,37,0,0,0,0,0,0,1,1,1038,2,831
"13100","목원동","목원동제3투","대통령선거","전라남도","목포시",1937,1086,449,24,576,6,22,0,0,0,0,4,0,0,1,1082,4,851
"13101","동명동","관내사전투표","대통령선거","전라남도","목포시",1157,1157,507,22,552,20,41,0,0,0,0,0,2,1,2,1147,10,0
"13102","동명동","동명동제1투","대통령선거","전라남도","목포시",2027,1205,545,24,570,15,40,0,0,3,0,0,0,0,0,1197,8,822
"13103","동명동","동명동제2투","대통령선거","전라남도","목포시",1898,1244,543,19,610,20,38,0,0,1,0,2,1,0,1,1235,9,654
"13104","삼학동","관내사전투표","대통령선거","전라남도","목포시",1750,1750,892,17,726,27,77,0,0,1,0,5,0,0,0,1745,5,0
"13105","삼학동","삼학동제1투","대통령선거","전라남도","목포시",1909,1256,653,9,496,22,65,2,0,1,0,3,0,1,0,1252,4,653
"13106","삼학동","삼학동제2투","대통령선거","전라남도","목포시",1621,1093,500,14,523,11,43,0,0,0,0,0,1,0,0,1092,1,528
"13107","만호동","관내사전투표","대통령선거","전라남도","목포시",742,742,327,3,362,11,29,0,0,0,0,3,1,0,2,738,4,0
"13108","만호동","만호동투표소","대통령선거","전라남도","목포시",2315,1174,483,16,624,13,26,0,0,0,1,0,2,1,4,1170,4,1141
"13109","유달동","관내사전투표","대통령선거","전라남도","목포시",1285,1285,604,33,567,18,38,1,0,2,0,2,0,1,4,1270,15,0
"13110","유달동","유달동제1투","대통령선거","전라남도","목포시",1541,813,368,16,384,13,25,0,0,0,0,1,2,0,0,809,4,728
"13111","유달동","유달동제2투","대통령선거","전라남도","목포시",1370,752,334,6,360,11,24,0,1,1,0,2,3,0,7,749,3,618
"13112","유달동","유달동제3투","대통령선거","전라남도","목포시",155,117,42,3,58,0,4,2,0,0,0,0,1,0,1,111,6,38
"13113","유달동","유달동제4투","대통령선거","전라남도","목포시",188,106,40,8,53,2,2,0,0,0,0,0,0,0,1,106,0,82
"13114","유달동","유달동제5투","대통령선거","전라남도","목포시",146,100,44,0,56,0,0,0,0,0,0,0,0,0,0,100,0,46
"13115","죽교동","관내사전투표","대통령선거","전라남도","목포시",901,901,425,18,373,20,46,10,0,1,0,1,0,1,1,896,5,0
"13116","죽교동","죽교동제1투","대통령선거","전라남도","목포시",1064,607,265,11,297,3,21,0,0,1,0,3,0,0,0,601,6,457
"13117","죽교동","죽교동제2투","대통령선거","전라남도","목포시",1215,711,322,24,307,14,30,4,0,1,0,0,1,0,2,705,6,504
"13118","북항동","관내사전투표","대통령선거","전라남도","목포시",2319,2319,1243,42,842,50,133,0,0,0,1,4,1,0,2,2318,1,0
"13119","북항동","북항동제1투","대통령선거","전라남도","목포시",2980,2017,1101,33,735,30,110,1,0,0,0,2,0,0,0,2012,5,963
"13120","북항동","북항동제2투","대통령선거","전라남도","목포시",1400,835,407,15,345,14,45,1,0,1,0,1,0,0,0,829,6,565
"13121","북항동","북항동제3투","대통령선거","전라남도","목포시",1358,891,426,20,390,12,32,1,0,0,0,5,0,0,1,887,4,467
"13122","용해동","관내사전투표","대통령선거","전라남도","목포시",3329,3329,1983,50,1024,75,172,1,0,1,4,2,0,0,3,3315,14,0
"13123","용해동","용해동제1투","대통령선거","전라남도","목포시",809,523,235,16,230,10,29,0,0,1,0,0,0,0,0,521,2,286
"13124","용해동","용해동제2투","대통령선거","전라남도","목포시",1383,870,435,27,356,10,41,0,0,0,0,0,0,1,0,870,0,513
"13125","용해동","용해동제3투","대통령선거","전라남도","목포시",2224,1546,878,12,533,27,88,0,1,0,0,2,0,1,0,1542,4,678
"13126","용해동","용해동제4투","대통령선거","전라남도","목포시",2679,1777,964,29,636,26,111,0,0,1,0,5,1,0,2,1775,2,902
"13127","용해동","용해동제5투","대통령선거","전라남도","목포시",2029,1427,827,15,471,24,83,1,0,0,0,1,0,1,1,1424,3,602
"13128","이로동","관내사전투표","대통령선거","전라남도","목포시",1917,1917,987,30,737,43,105,0,0,2,1,4,0,1,2,1912,5,0
"13129","이로동","이로동제1투","대통령선거","전라남도","목포시",1463,987,479,30,419,21,33,0,0,0,0,1,1,0,2,986,1,476
"13130","이로동","이로동제2투","대통령선거","전라남도","목포시",1582,1082,521,26,462,19,50,0,0,0,0,2,0,0,0,1080,2,500
"13131","이로동","이로동제3투","대통령선거","전라남도","목포시",2370,1822,1042,16,612,40,98,0,0,3,0,4,0,1,1,1817,5,548
"13132","상동","관내사전투표","대통령선거","전라남도","목포시",2977,2976,1531,55,1156,59,141,3,1,4,0,6,5,0,1,2962,14,1
"13133","상동","상동제1투","대통령선거","전라남도","목포시",1400,801,392,11,347,13,33,0,0,1,0,1,1,0,1,800,1,599
"13134","상동","상동제2투","대통령선거","전라남도","목포시",1391,868,453,8,346,24,28,0,0,1,0,0,1,0,3,864,4,523
"13135","상동","상동제3투","대통령선거","전라남도","목포시",1307,699,297,22,336,9,23,0,0,1,0,0,0,0,2,690,9,608
"13136","상동","상동제4투","대통령선거","전라남도","목포시",4268,3362,1910,39,1149,75,166,3,0,3,1,5,0,0,1,3352,10,906
"13137","상동","상동제5투","대통령선거","전라남도","목포시",1639,1165,642,24,426,18,51,0,0,0,0,1,0,0,1,1163,2,474
"13138","하당동","관내사전투표","대통령선거","전라남도","목포시",2965,2965,1701,39,917,86,188,0,2,7,1,8,1,1,0,2951,14,0
"13139","하당동","하당동제1투","대통령선거","전라남도","목포시",1854,921,489,25,326,23,55,0,0,0,0,0,0,0,0,918,3,933
"13140","하당동","하당동제2투","대통령선거","전라남도","목포시",2653,1311,700,39,463,22,85,0,0,0,0,2,0,0,0,1311,0,1342
"13141","하당동","하당동제3투","대통령선거","전라남도","목포시",1909,1512,858,24,487,34,99,1,0,2,0,6,0,0,0,1511,1,397
"13142","신흥동","관내사전투표","대통령선거","전라남도","목포시",3312,3312,1891,42,1080,67,217,0,1,0,1,5,1,1,4,3310,2,0
"13143","신흥동","신흥동제1투","대통령선거","전라남도","목포시",2127,1507,848,19,532,35,68,0,0,0,0,1,0,2,1,1506,1,620
"13144","신흥동","신흥동제2투","대통령선거","전라남도","목포시",1889,1354,741,21,489,28,67,0,0,0,0,3,1,0,2,1352,2,535
"13145","신흥동","신흥동제3투","대통령선거","전라남도","목포시",2328,1730,967,22,596,46,91,0,0,1,1,0,1,0,2,1727,3,598
"13146","신흥동","신흥동제4투","대통령선거","전라남도","목포시",2600,1837,970,29,686,34,109,3,0,3,0,2,0,0,0,1836,1,763
"13147","삼향동","관내사전투표","대통령선거","전라남도","목포시",1237,1237,710,16,426,26,55,0,0,1,0,1,0,0,2,1237,0,0
"13148","삼향동","삼향동제1투","대통령선거","전라남도","목포시",1375,925,476,10,358,13,61,0,0,1,0,0,0,1,0,920,5,450
"13149","삼향동","삼향동제2투","대통령선거","전라남도","목포시",1423,935,498,25,350,17,40,0,0,1,0,1,0,0,0,932,3,488
"13150","옥암동","관내사전투표","대통령선거","전라남도","목포시",2865,2865,1711,38,879,58,165,0,0,1,1,4,0,0,1,2858,7,0
"13151","옥암동","옥암동제1투","대통령선거","전라남도","목포시",2627,1891,1097,31,627,34,95,0,0,0,0,5,0,0,0,1889,2,736
"13152","옥암동","옥암동제2투","대통령선거","전라남도","목포시",2404,1689,888,23,648,25,96,1,0,2,0,1,0,0,2,1686,3,715
"13153","부흥동","관내사전투표","대통령선거","전라남도","목포시",2832,2832,1637,42,875,69,188,1,0,5,0,6,1,0,2,2826,6,0
"13154","부흥동","부흥동제1투","대통령선거","전라남도","목포시",1983,1258,676,23,458,20,73,0,0,1,0,1,1,0,1,1254,4,725
"13155","부흥동","부흥동제2투","대통령선거","전라남도","목포시",1602,1054,585,18,348,19,76,0,0,1,0,2,0,2,0,1051,3,548
"13156","부흥동","부흥동제3투","대통령선거","전라남도","목포시",2046,1525,815,28,565,29,82,0,0,0,0,1,0,0,0,1520,5,521
"13157","부주동","관내사전투표","대통령선거","전라남도","목포시",4100,4100,2558,60,1120,88,258,0,1,1,0,6,0,0,0,4092,8,0
"13158","부주동","부주동제1투","대통령선거","전라남도","목포시",3554,2701,1645,41,806,54,149,0,0,0,0,2,0,0,2,2699,2,853
"13159","부주동","부주동제2투","대통령선거","전라남도","목포시",3613,2591,1476,53,850,75,126,1,0,1,0,3,0,0,1,2586,5,1022
"13160","부주동","부주동제3투","대통령선거","전라남도","목포시",2962,2075,1258,41,619,41,105,0,0,1,0,7,0,0,2,2074,1,887
"13161","잘못 투입·구분된 투표지","잘못 투입·구분된 투표지","대통령선거","전라남도","목포시",0,0,0,0,0,0,0,0,0,0,0,0,0,0,0,0,0,0
"13162","거소·선상투표","거소·선상투표","대통령선거","전라남도","여수시",876,807,452,39,215,35,28,2,0,1,3,6,1,1,2,785,22,69
"13163","관외사전투표","관외사전투표","대통령선거","전라남도","여수시",17631,17628,11236,464,3701,842,1195,3,5,9,2,39,7,1,29,17533,95,3
"13164","재외투표","재외투표","대통령선거","전라남도","여수시",992,733,515,17,105,18,72,2,0,0,0,2,0,0,0,731,2,259
"13165","돌산읍","관내사전투표","대통령선거","전라남도","여수시",954,954,565,32,307,15,18,0,0,2,0,5,1,1,1,947,7,0
"13166","돌산읍","돌산읍제1투","대통령선거","전라남도","여수시",983,573,328,10,204,9,13,1,0,4,0,0,0,1,2,572,1,410
"13167","돌산읍","돌산읍제2투","대통령선거","전라남도","여수시",816,524,307,13,187,4,6,0,0,0,0,1,0,1,0,519,5,292
"13168","돌산읍","돌산읍제3투","대통령선거","전라남도","여수시",1595,1095,672,25,356,8,16,2,0,0,1,0,0,2,6,1088,7,500
"13169","돌산읍","돌산읍제4투","대통령선거","전라남도","여수시",1260,866,511,19,291,12,22,0,0,0,0,3,1,1,3,863,3,394
"13170","돌산읍","돌산읍제5투","대통령선거","전라남도","여수시",1178,784,473,16,261,7,13,0,0,0,0,4,0,1,5,780,4,394
"13171","돌산읍","돌산읍제6투","대통령선거","전라남도","여수시",3465,2289,1320,66,758,42,80,1,0,0,0,7,1,1,3,2279,10,1176
"13172","소라면","관내사전투표","대통령선거","전라남도","여수시",2364,2364,1562,46,585,46,95,1,1,4,3,10,1,1,5,2360,4,0
"13173","소라면","소라면제1투","대통령선거","전라남도","여수시",1366,885,514,29,291,9,26,0,0,2,0,2,0,1,5,879,6,481
"13174","소라면","소라면제2투","대통령선거","전라남도","여수시",823,561,352,17,161,10,13,0,0,0,0,0,0,0,4,557,4,262
"13175","소라면","소라면제3투","대통령선거","전라남도","여수시",1151,728,439,13,236,5,21,0,0,1,0,3,1,0,5,724,4,423
"13176","소라면","소라면제4투","대통령선거","전라남도","여수시",914,592,335,20,201,7,12,1,0,1,0,0,0,0,6,583,9,322
"13177","소라면","소라면제5투","대통령선거","전라남도","여수시",2495,1681,1117,34,421,22,73,1,0,3,0,4,0,0,3,1678,3,814
"13178","소라면","소라면제6투","대통령선거","전라남도","여수시",3156,2325,1522,46,593,46,96,0,0,1,0,13,1,0,0,2318,7,831
"13179","율촌면","관내사전투표","대통령선거","전라남도","여수시",1268,1268,749,29,407,27,35,0,0,0,1,7,0,1,5,1261,7,0
"13180","율촌면","율촌면제1투","대통령선거","전라남도","여수시",2255,1402,858,38,419,28,38,1,0,0,0,6,1,2,2,1393,9,853
"13181","율촌면","율촌면제2투","대통령선거","전라남도","여수시",769,512,326,29,138,5,5,0,0,0,0,2,1,0,4,510,2,257
"13182","율촌면","율촌면제3투","대통령선거","전라남도","여수시",806,501,312,9,152,3,12,0,0,0,0,1,1,0,7,497,4,305
"13183","율촌면","율촌면제4투","대통령선거","전라남도","여수시",184,147,91,7,47,0,2,0,0,0,0,0,0,0,0,147,0,37
"13184","화양면","관내사전투표","대통령선거","전라남도","여수시",996,996,586,28,314,16,36,2,1,0,1,3,2,0,4,993,3,0
"13185","화양면","화양면제1투","대통령선거","전라남도","여수시",1246,746,396,19,280,12,22,0,0,1,0,1,2,0,3,736,10,500
"13186","화양면","화양면제2투","대통령선거","전라남도","여수시",930,597,351,11,199,10,10,0,0,1,1,5,2,3,3,596,1,333
"13187","화양면","화양면제3투","대통령선거","전라남도","여수시",1166,718,383,19,263,14,8,1,2,2,0,2,2,1,7,704,14,448
"13188","화양면","화양면제4투","대통령선거","전라남도","여수시",1038,592,373,14,173,12,10,0,0,0,0,0,1,0,3,586,6,446
"13189","남면","관내사전투표","대통령선거","전라남도","여수시",507,507,293,14,165,3,22,2,0,1,1,0,0,0,2,503,4,0
"13190","남면","남면제1투","대통령선거","전라남도","여수시",735,397,220,10,148,5,1,0,0,0,1,0,1,2,3,391,6,338
"13191","남면","남면제2투","대통령선거","전라남도","여수시",142,104,68,4,29,1,0,0,0,1,0,0,0,0,0,103,1,38
"13192","남면","남면제3투","대통령선거","전라남도","여수시",265,212,141,4,58,1,3,0,0,0,0,0,1,0,3,211,1,53
"13193","남면","남면제4투","대통령선거","전라남도","여수시",109,88,66,0,21,0,0,0,0,0,0,0,0,0,1,88,0,21
"13194","남면","남면제5투","대통령선거","전라남도","여수시",303,201,110,5,70,2,7,0,0,0,0,0,1,0,3,198,3,102
"13195","남면","남면제6투","대통령선거","전라남도","여수시",354,260,148,8,87,1,4,1,0,0,0,0,0,3,4,256,4,94
"13196","화정면","관내사전투표","대통령선거","전라남도","여수시",217,217,130,8,64,4,6,0,1,0,0,1,0,1,1,216,1,0
"13197","화정면","화정면제1투","대통령선거","전라남도","여수시",155,102,73,2,20,0,2,0,0,1,0,0,2,0,2,102,0,53
"13198","화정면","화정면제2투","대통령선거","전라남도","여수시",535,357,241,9,89,2,4,0,0,1,0,0,0,2,3,351,6,178
"13199","화정면","화정면제3투","대통령선거","전라남도","여수시",207,140,89,0,46,1,0,0,1,0,0,1,0,0,1,139,1,67
"13200","화정면","화정면제4투","대통령선거","전라남도","여수시",54,44,33,1,8,0,0,0,0,0,0,0,1,1,0,44,0,10
"13201","화정면","화정면제5투","대통령선거","전라남도","여수시",227,184,115,7,52,0,1,0,0,0,0,2,0,1,3,181,3,43
"13202","화정면","화정면제6투","대통령선거","전라남도","여수시",22,19,15,0,4,0,0,0,0,0,0,0,0,0,0,19,0,3
"13203","화정면","화정면제7투","대통령선거","전라남도","여수시",86,59,32,2,22,0,0,0,0,1,0,0,0,0,1,58,1,27
"13204","화정면","화정면제8투","대통령선거","전라남도","여수시",185,112,79,3,24,1,2,0,0,0,0,2,0,0,0,111,1,73
"13205","화정면","화정면제9투","대통령선거","전라남도","여수시",78,58,38,1,17,1,0,0,0,0,0,0,0,0,1,58,0,20
"13206","화정면","화정면제10투","대통령선거","전라남도","여수시",37,23,13,0,9,0,0,0,0,0,0,0,0,0,0,22,1,14
"13207","화정면","화정면제11투","대통령선거","전라남도","여수시",33,26,11,0,12,0,0,0,0,0,0,0,0,0,3,26,0,7
"13208","화정면","화정면제12투","대통령선거","전라남도","여수시",36,23,13,1,8,0,0,0,0,0,0,0,1,0,0,23,0,13
"13209","삼산면","관내사전투표","대통령선거","전라남도","여수시",314,314,224,6,67,9,8,0,0,0,0,0,0,0,0,314,0,0
"13210","삼산면","삼산면제1투","대통령선거","전라남도","여수시",278,124,85,9,24,2,2,0,0,0,0,0,0,0,0,122,2,154
"13211","삼산면","삼산면제2투","대통령선거","전라남도","여수시",170,110,63,5,35,0,3,0,0,1,0,0,0,0,1,108,2,60
"13212","삼산면","삼산면제3투","대통령선거","전라남도","여수시",216,137,82,4,39,6,2,0,1,1,0,0,0,0,1,136,1,79
"13213","삼산면","삼산면제4투","대통령선거","전라남도","여수시",181,127,82,6,36,2,1,0,0,0,0,0,0,0,0,127,0,54
"13214","삼산면","삼산면제5투","대통령선거","전라남도","여수시",282,166,87,9,58,4,5,0,0,1,0,0,2,0,0,166,0,116
"13215","삼산면","삼산면제6투","대통령선거","전라남도","여수시",165,87,33,4,45,0,2,1,0,0,0,0,0,0,1,86,1,78
"13216","동문동","관내사전투표","대통령선거","전라남도","여수시",1108,1108,710,30,299,25,36,0,0,1,0,1,0,0,2,1104,4,0
"13217","동문동","동문동제1투","대통령선거","전라남도","여수시",1219,711,376,25,265,13,26,0,0,0,0,1,1,0,1,708,3,508
"13218","동문동","동문동제2투","대통령선거","전라남도","여수시",1137,724,370,33,282,17,19,0,0,0,0,0,0,0,2,723,1,413
"13219","동문동","동문동제3투","대통령선거","전라남도","여수시",806,567,320,14,214,6,4,0,0,0,0,3,0,1,0,562,5,239
"13220","한려동","관내사전투표","대통령선거","전라남도","여수시",765,765,468,17,232,19,23,0,0,1,0,1,1,0,0,762,3,0
"13221","한려동","한려동제1투","대통령선거","전라남도","여수시",748,483,283,16,162,8,11,0,0,0,0,0,0,0,2,482,1,265
"13222","한려동","한려동제2투","대통령선거","전라남도","여수시",1463,954,549,25,338,15,18,1,0,1,0,1,1,0,1,950,4,509
"13223","중앙동","관내사전투표","대통령선거","전라남도","여수시",1462,1462,857,37,487,27,45,0,0,1,0,2,0,0,3,1459,3,0
"13224","중앙동","중앙동제1투","대통령선거","전라남도","여수시",1610,1100,670,29,348,14,32,0,0,2,0,1,0,0,0,1096,4,510
"13225","중앙동","중앙동제2투","대통령선거","전라남도","여수시",1627,1038,579,27,393,15,15,0,0,2,0,2,0,0,3,1036,2,589
"13226","충무동","관내사전투표","대통령선거","전라남도","여수시",1274,1274,782,26,394,14,47,0,0,0,1,1,1,1,0,1267,7,0
"13227","충무동","충무동제1투","대통령선거","전라남도","여수시",1394,866,525,19,291,6,14,0,0,3,0,2,1,0,3,864,2,528
"13228","충무동","충무동제2투","대통령선거","전라남도","여수시",1513,918,545,15,316,11,17,1,1,0,0,3,0,1,3,913,5,595
"13229","광림동","관내사전투표","대통령선거","전라남도","여수시",1241,1241,805,13,357,19,36,0,0,3,0,0,1,1,1,1236,5,0
"13230","광림동","광림동제1투","대통령선거","전라남도","여수시",1604,988,568,24,352,15,23,0,0,2,0,1,0,0,1,986,2,616
"13231","광림동","광림동제2투","대통령선거","전라남도","여수시",1042,722,468,14,216,10,9,1,0,0,0,2,0,0,0,720,2,320
"13232","광림동","광림동제3투","대통령선거","전라남도","여수시",1818,1216,720,33,397,19,44,0,0,0,0,0,0,0,0,1213,3,602
"13233","서강동","관내사전투표","대통령선거","전라남도","여수시",1224,1224,718,26,404,15,47,0,0,2,1,2,1,0,2,1218,6,0
"13234","서강동","서강동제1투","대통령선거","전라남도","여수시",1211,739,402,24,276,9,15,1,0,1,0,2,0,0,2,732,7,472
"13235","서강동","서강동제2투","대통령선거","전라남도","여수시",1349,900,525,24,292,18,32,0,0,1,0,3,1,0,1,897,3,449
"13236","대교동","관내사전투표","대통령선거","전라남도","여수시",1136,1136,685,30,363,16,29,0,0,3,0,1,0,0,6,1133,3,0
"13237","대교동","대교동제1투","대통령선거","전라남도","여수시",1616,1005,549,25,398,8,14,0,0,2,0,2,1,0,1,1000,5,611
"13238","대교동","대교동제2투","대통령선거","전라남도","여수시",1434,827,469,22,307,8,16,0,0,0,0,1,0,0,0,823,4,607
"13239","대교동","대교동제3투","대통령선거","전라남도","여수시",1154,770,472,12,255,4,19,0,0,1,0,0,0,0,4,767,3,384
"13240","국동","관내사전투표","대통령선거","전라남도","여수시",2787,2787,1782,62,788,38,91,0,1,5,0,5,0,0,2,2774,13,0
"13241","국동","국동제1투","대통령선거","전라남도","여수시",1434,871,542,23,271,14,19,0,0,0,0,0,1,0,0,870,1,563
"13242","국동","국동제2투","대통령선거","전라남도","여수시",1832,1045,637,25,335,8,33,0,0,1,0,1,0,0,0,1040,5,787
"13243","국동","국동제3투","대통령선거","전라남도","여수시",2268,1549,978,25,460,25,48,0,0,3,0,4,0,0,0,1543,6,719
"13244","국동","국동제4투","대통령선거","전라남도","여수시",2002,1334,792,21,447,25,34,0,0,3,1,5,1,0,1,1330,4,668
"13245","월호동","관내사전투표","대통령선거","전라남도","여수시",1926,1927,1268,24,511,49,66,0,0,0,0,5,0,0,1,1924,3,-1
"13246","월호동","월호동제1투","대통령선거","전라남도","여수시",1879,1258,744,41,409,19,36,0,0,1,0,2,1,0,3,1256,2,621
"13247","월호동","월호동제2투","대통령선거","전라남도","여수시",1693,1267,785,34,379,29,34,0,0,1,0,1,0,0,2,1265,2,426
"13248","월호동","월호동제3투","대통령선거","전라남도","여수시",533,367,223,10,112,6,6,0,0,0,1,1,1,1,4,365,2,166
"13249","월호동","월호동제4투","대통령선거","전라남도","여수시",90,59,30,2,25,0,1,0,0,0,0,0,0,0,0,58,1,31
"13250","여서동","관내사전투표","대통령선거","전라남도","여수시",4280,4280,2832,69,1065,107,173,0,1,4,1,13,1,1,3,4270,10,0
"13251","여서동","여서동제1투","대통령선거","전라남도","여수시",2189,1342,800,36,425,27,49,0,0,0,0,2,0,1,2,1342,0,847
"13252","여서동","여서동제2투","대통령선거","전라남도","여수시",1738,1338,803,39,428,30,33,0,0,0,0,0,1,0,1,1335,3,400
"13253","여서동","여서동제3투","대통령선거","전라남도","여수시",2169,1686,1011,46,525,36,62,0,0,1,0,0,2,1,0,1684,2,483
"13254","여서동","여서동제4투","대통령선거","전라남도","여수시",2041,1522,970,29,424,32,60,0,0,1,0,1,0,0,2,1519,3,519
"13255","여서동","여서동제5투","대통령선거","전라남도","여수시",1714,1379,875,36,386,30,45,0,0,0,1,2,0,0,0,1375,4,335
"13256","여서동","여서동제6투","대통령선거","전라남도","여수시",1817,1298,859,15,342,25,50,0,0,3,0,1,0,0,0,1295,3,519
"13257","문수동","관내사전투표","대통령선거","전라남도","여수시",4065,4065,2770,62,911,102,195,1,0,1,1,8,0,0,3,4054,11,0
"13258","문수동","문수동제1투","대통령선거","전라남도","여수시",1260,907,523,28,308,11,28,0,0,0,0,1,0,1,2,902,5,353
"13259","문수동","문수동제2투","대통령선거","전라남도","여수시",1799,1311,804,26,391,27,58,0,0,0,1,3,0,0,0,1310,1,488
"13260","문수동","문수동제3투","대통령선거","전라남도","여수시",2770,1881,1206,41,503,41,77,1,0,0,0,8,0,1,0,1878,3,889
"13261","문수동","문수동제4투","대통령선거","전라남도","여수시",1112,867,544,13,269,11,28,0,0,0,0,1,0,1,0,867,0,245
"13262","문수동","문수동제5투","대통령선거","전라남도","여수시",2020,1259,733,40,413,22,31,0,0,1,1,5,1,1,4,1252,7,761
"13263","문수동","문수동제6투","대통령선거","전라남도","여수시",2915,2001,1375,35,453,41,87,0,0,1,0,6,0,0,0,1998,3,914
"13264","미평동","관내사전투표","대통령선거","전라남도","여수시",3239,3239,2177,50,758,71,157,0,1,2,0,5,0,1,4,3226,13,0
"13265","미평동","미평동제1투","대통령선거","전라남도","여수시",2092,1402,874,31,394,32,64,0,0,1,0,4,0,1,0,1401,1,690
"13266","미평동","미평동제2투","대통령선거","전라남도","여수시",1931,1264,768,31,388,18,39,0,0,0,0,2,1,1,4,1252,12,667
"13267","미평동","미평동제3투","대통령선거","전라남도","여수시",1524,1036,631,29,322,20,28,0,0,0,0,2,0,0,0,1032,4,488
"13268","미평동","미평동제4투","대통령선거","전라남도","여수시",1397,1080,707,20,276,22,46,0,0,3,0,0,0,1,2,1077,3,317
"13269","둔덕동","관내사전투표","대통령선거","전라남도","여수시",1766,1766,1177,31,420,42,76,2,0,1,0,5,0,2,0,1756,10,0
"13270","둔덕동","둔덕동제1투","대통령선거","전라남도","여수시",1273,815,512,20,226,17,35,0,0,1,0,1,0,0,0,812,3,458
"13271","둔덕동","둔덕동제2투","대통령선거","전라남도","여수시",2855,2173,1338,49,643,48,83,0,0,1,0,4,0,1,1,2168,5,682
"13272","둔덕동","둔덕동제3투","대통령선거","전라남도","여수시",1561,1204,833,18,243,28,77,0,0,0,0,1,1,0,1,1202,2,357
"13273","만덕동","관내사전투표","대통령선거","전라남도","여수시",1710,1710,1122,37,439,43,60,0,0,1,0,2,0,0,1,1705,5,0
"13274","만덕동","만덕동제1투","대통령선거","전라남도","여수시",2322,1634,953,46,551,30,40,0,1,0,0,5,1,0,2,1629,5,688
"13275","만덕동","만덕동제2투","대통령선거","전라남도","여수시",1848,1387,875,34,395,29,49,0,0,0,0,0,0,1,0,1383,4,461
"13276","만덕동","만덕동제3투","대통령선거","전라남도","여수시",916,667,366,6,254,14,17,0,1,0,0,2,2,1,2,665,2,249
"13277","쌍봉동","관내사전투표","대통령선거","전라남도","여수시",8179,8179,5529,138,1832,221,405,0,1,9,1,28,0,0,1,8165,14,0
"13278","쌍봉동","쌍봉동제1투","대통령선거","전라남도","여수시",1501,934,590,25,246,31,36,0,0,1,0,4,0,0,0,933,1,567
"13279","쌍봉동","쌍봉동제2투","대통령선거","전라남도","여수시",2192,1383,879,40,389,23,47,1,0,0,0,1,0,0,0,1380,3,809
"13280","쌍봉동","쌍봉동제3투","대통령선거","전라남도","여수시",2324,1685,1115,58,379,46,74,4,0,0,0,3,1,0,0,1680,5,639
"13281","쌍봉동","쌍봉동제4투","대통령선거","전라남도","여수시",2026,1562,989,38,390,50,82,0,0,1,0,5,0,0,0,1555,7,464
"13282","쌍봉동","쌍봉동제5투","대통령선거","전라남도","여수시",2723,2108,1351,37,550,44,109,0,0,2,0,8,1,0,1,2103,5,615
"13283","쌍봉동","쌍봉동제6투","대통령선거","전라남도","여수시",1934,1391,891,48,341,31,69,2,0,0,0,2,0,0,1,1385,6,543
"13284","쌍봉동","쌍봉동제7투","대통령선거","전라남도","여수시",2620,1978,1304,63,447,54,99,0,0,2,0,3,0,0,1,1973,5,642
"13285","쌍봉동","쌍봉동제8투","대통령선거","전라남도","여수시",2618,2147,1460,60,483,53,79,1,0,1,0,3,1,1,2,2144,3,471
"13286","시전동","관내사전투표","대통령선거","전라남도","여수시",5394,5394,3640,83,1207,152,274,0,0,7,0,14,0,1,4,5382,12,0
"13287","시전동","시전동제1투","대통령선거","전라남도","여수시",1893,1214,728,35,382,23,34,0,0,2,0,3,0,0,3,1210,4,679
"13288","시전동","시전동제2투","대통령선거","전라남도","여수시",3754,3045,2094,51,692,74,116,1,0,3,0,6,0,1,1,3039,6,709
"13289","시전동","시전동제3투","대통령선거","전라남도","여수시",1633,1134,747,22,235,33,83,2,0,0,0,7,0,0,3,1132,2,499
"13290","시전동","시전동제4투","대통령선거","전라남도","여수시",1584,1032,633,22,315,25,29,0,0,0,0,4,0,0,2,1030,2,552
"13291","시전동","시전동제5투","대통령선거","전라남도","여수시",1311,980,653,30,238,14,40,0,0,1,0,1,0,0,1,978,2,331
"13292","시전동","시전동제6투","대통령선거","전라남도","여수시",2024,1441,918,40,391,31,53,0,0,0,0,3,0,0,0,1436,5,583
"13293","시전동","시전동제7투","대통령선거","전라남도","여수시",2912,2274,1543,31,537,66,88,0,0,0,0,3,1,0,0,2269,5,638
"13294","여천동","관내사전투표","대통령선거","전라남도","여수시",5567,5566,3720,108,1228,144,313,2,0,5,0,22,3,2,4,5551,15,1
"13295","여천동","여천동제1투","대통령선거","전라남도","여수시",1514,1039,616,34,303,15,61,1,0,0,0,0,1,0,2,1033,6,475
"13296","여천동","여천동제2투","대통령선거","전라남도","여수시",2570,1871,1237,42,463,35,86,0,1,0,0,3,0,0,1,1868,3,699
"13297","여천동","여천동제3투","대통령선거","전라남도","여수시",2368,1465,980,33,357,26,53,0,0,1,0,6,1,1,1,1459,6,903
"13298","여천동","여천동제4투","대통령선거","전라남도","여수시",3303,2169,1385,66,590,38,70,0,0,2,0,2,2,0,2,2157,12,1134
"13299","여천동","여천동제5투","대통령선거","전라남도","여수시",2520,1760,1074,56,503,39,67,0,0,1,2,9,3,0,2,1756,4,760
"13300","주삼동","관내사전투표","대통령선거","전라남도","여수시",1596,1596,1092,27,355,27,76,1,0,2,0,7,0,0,1,1588,8,0
"13301","주삼동","주삼동제1투","대통령선거","전라남도","여수시",769,488,280,9,179,1,13,0,0,0,0,0,1,0,2,485,3,281
"13302","주삼동","주삼동제2투","대통령선거","전라남도","여수시",1358,1035,744,17,202,27,42,1,0,0,0,2,0,0,0,1035,0,323
"13303","주삼동","주삼동제3투","대통령선거","전라남도","여수시",1931,1472,1009,34,321,38,65,0,0,1,0,3,0,0,0,1471,1,459
"13304","삼일동","관내사전투표","대통령선거","전라남도","여수시",750,750,507,17,171,15,22,0,0,1,0,6,2,1,1,743,7,0
"13305","삼일동","삼일동투표소","대통령선거","전라남도","여수시",1495,914,575,23,256,14,26,2,0,4,0,2,2,1,8,913,1,581
"13306","묘도동","관내사전투표","대통령선거","전라남도","여수시",264,264,174,4,66,4,5,0,0,0,0,5,1,0,1,260,4,0
"13307","묘도동","묘도동투표소","대통령선거","전라남도","여수시",686,436,266,15,131,4,10,0,0,0,0,4,0,2,2,434,2,250
"13308","잘못 투입·구분된 투표지","잘못 투입·구분된 투표지","대통령선거","전라남도","여수시",0,0,0,0,0,0,0,0,0,0,0,0,0,0,0,0,0,0
"13309","거소·선상투표","거소·선상투표","대통령선거","전라남도","순천시",637,604,326,37,163,22,13,1,1,5,1,10,2,1,4,586,18,33
"13310","관외사전투표","관외사전투표","대통령선거","전라남도","순천시",19759,19759,13001,518,3856,854,1282,9,5,14,9,75,1,7,17,19648,111,0
"13311","재외투표","재외투표","대통령선거","전라남도","순천시",970,735,534,12,92,14,73,1,1,0,0,1,0,0,1,729,6,235
"13312","승주읍","관내사전투표","대통령선거","전라남도","순천시",704,704,491,16,146,10,27,0,1,2,0,4,1,0,1,699,5,0
"13313","승주읍","승주읍제1투","대통령선거","전라남도","순천시",1506,922,570,31,255,12,27,1,1,0,0,4,1,3,7,912,10,584
"13314","승주읍","승주읍제2투","대통령선거","전라남도","순천시",374,265,164,11,74,3,6,0,0,0,0,4,0,2,0,264,1,109
"13315","주암면","관내사전투표","대통령선거","전라남도","순천시",691,691,377,26,240,9,17,0,0,0,0,10,0,1,2,682,9,0
"13316","주암면","주암면제1투","대통령선거","전라남도","순천시",1008,722,396,23,238,3,10,1,1,0,1,32,1,2,4,712,10,286
"13317","주암면","주암면제2투","대통령선거","전라남도","순천시",1226,770,413,23,279,10,24,0,0,0,0,3,0,1,5,758,12,456
"13318","송광면","관내사전투표","대통령선거","전라남도","순천시",403,403,242,13,120,6,14,0,0,1,1,3,0,0,3,403,0,0
"13319","송광면","송광면투표소","대통령선거","전라남도","순천시",978,615,336,25,205,9,15,0,1,1,0,0,3,1,13,609,6,363
"13320","외서면","관내사전투표","대통령선거","전라남도","순천시",229,229,153,7,59,0,2,1,0,0,0,2,0,1,1,226,3,0
"13321","외서면","외서면투표소","대통령선거","전라남도","순천시",587,393,245,10,115,7,4,0,0,0,0,3,0,3,3,390,3,194
"13322","낙안면","관내사전투표","대통령선거","전라남도","순천시",1015,1015,674,20,268,8,22,0,2,0,0,5,3,1,6,1009,6,0
"13323","낙안면","낙안면제1투","대통령선거","전라남도","순천시",1172,702,441,18,199,12,21,0,0,0,0,2,2,1,2,698,4,470
"13324","낙안면","낙안면제2투","대통령선거","전라남도","순천시",754,477,265,12,173,10,7,0,1,1,0,0,1,0,3,473,4,277
"13325","별량면","관내사전투표","대통령선거","전라남도","순천시",1378,1379,916,36,356,15,29,2,3,2,0,5,1,1,6,1372,7,-1
"13326","별량면","별량면제1투","대통령선거","전라남도","순천시",1345,812,524,22,207,17,23,1,1,2,0,6,1,1,3,808,4,533
"13327","별량면","별량면제2투","대통령선거","전라남도","순천시",1268,757,461,28,234,8,12,0,0,0,0,6,3,1,0,753,4,511
"13328","별량면","별량면제3투","대통령선거","전라남도","순천시",893,621,414,12,168,6,15,0,0,1,0,0,0,1,1,618,3,272
"13329","상사면","관내사전투표","대통령선거","전라남도","순천시",593,593,413,4,137,6,23,1,1,0,0,2,0,1,3,591,2,0
"13330","상사면","상사면제1투","대통령선거","전라남도","순천시",630,425,267,14,113,8,12,0,0,1,0,3,0,2,3,423,2,205
"13331","상사면","상사면제2투","대통령선거","전라남도","순천시",1119,765,475,36,212,8,12,0,1,0,0,6,1,1,3,755,10,354
"13332","해룡면","관내사전투표","대통령선거","전라남도","순천시",4203,4203,3175,59,659,112,171,2,0,0,0,18,1,2,2,4201,2,0
"13333","해룡면","해룡면제1투","대통령선거","전라남도","순천시",2239,1352,894,35,361,14,35,0,0,2,0,4,0,0,3,1348,4,887
"13334","해룡면","해룡면제2투","대통령선거","전라남도","순천시",2091,1678,1243,28,303,33,59,0,0,0,0,6,1,0,0,1673,5,413
"13335","해룡면","해룡면제3투","대통령선거","전라남도","순천시",3283,2724,1988,47,501,73,102,1,0,1,0,8,0,1,0,2722,2,559
"13336","해룡면","해룡면제4투","대통령선거","전라남도","순천시",755,485,345,6,111,3,11,1,0,0,0,2,0,0,2,481,4,270
"13337","해룡면","해룡면제5투","대통령선거","전라남도","순천시",2547,1825,1228,50,400,37,82,0,1,2,0,16,0,1,3,1820,5,722
"13338","해룡면","해룡면제6투","대통령선거","전라남도","순천시",2504,1863,1330,44,348,34,84,3,0,2,0,9,2,0,0,1856,7,641
"13339","해룡면","해룡면제7투","대통령선거","전라남도","순천시",2471,1812,1275,38,328,47,106,3,0,0,0,13,0,0,0,1810,2,659
"13340","해룡면","해룡면제8투","대통령선거","전라남도","순천시",2559,2029,1528,35,325,50,81,0,1,0,0,5,0,1,0,2026,3,530
"13341","해룡면","해룡면제9투","대통령선거","전라남도","순천시",2414,1996,1460,44,344,56,82,0,0,1,0,7,0,0,0,1994,2,418
"13342","해룡면","해룡면제10투","대통령선거","전라남도","순천시",2094,1603,1182,22,274,36,69,0,0,0,2,13,0,2,1,1601,2,491
"13343","서면","관내사전투표","대통령선거","전라남도","순천시",1709,1709,1199,33,349,36,71,0,1,0,0,10,0,1,1,1701,8,0
"13344","서면","서면제1투","대통령선거","전라남도","순천시",767,509,334,14,133,7,7,0,0,0,0,7,0,0,2,504,5,258
"13345","서면","서면제2투","대통령선거","전라남도","순천시",1152,801,475,36,233,14,28,0,0,0,0,2,0,1,3,792,9,351
"13346","서면","서면제3투","대통령선거","전라남도","순천시",1503,1145,815,17,229,29,39,0,0,0,0,3,1,0,1,1134,11,358
"13347","서면","서면제4투","대통령선거","전라남도","순천시",2668,1851,1283,48,414,23,60,0,0,0,0,8,1,0,3,1840,11,817
"13348","서면","서면제5투","대통령선거","전라남도","순천시",834,583,370,14,163,17,12,0,0,0,0,1,0,1,2,580,3,251
"13349","황전면","관내사전투표","대통령선거","전라남도","순천시",773,773,529,22,147,21,15,0,0,1,0,28,0,1,3,767,6,0
"13350","황전면","황전면제1투","대통령선거","전라남도","순천시",986,603,387,21,156,9,7,0,0,1,0,13,0,1,2,597,6,383
"13351","황전면","황전면제2투","대통령선거","전라남도","순천시",1063,704,492,8,154,8,9,0,0,0,0,24,0,0,4,699,5,359
"13352","월등면","관내사전투표","대통령선거","전라남도","순천시",443,443,302,12,95,15,16,0,0,0,0,1,0,0,1,442,1,0
"13353","월등면","월등면투표소","대통령선거","전라남도","순천시",1054,666,462,17,136,20,15,0,0,1,0,3,1,2,5,662,4,388
"13354","향동","관내사전투표","대통령선거","전라남도","순천시",1608,1608,1037,41,423,27,53,0,0,0,1,15,0,1,3,1601,7,0
"13355","향동","향동투표소","대통령선거","전라남도","순천시",2175,1330,802,58,372,32,49,0,0,2,0,6,1,0,2,1324,6,845
"13356","매곡동","관내사전투표","대통령선거","전라남도","순천시",1613,1613,1058,36,388,37,78,2,0,1,0,9,0,0,2,1611,2,0
"13357","매곡동","매곡동제1투","대통령선거","전라남도","순천시",1426,943,584,53,251,16,30,1,0,1,0,0,1,0,1,938,5,483
"13358","매곡동","매곡동제2투","대통령선거","전라남도","순천시",1409,920,555,35,232,30,58,0,0,0,0,2,0,1,2,915,5,489
"13359","삼산동","관내사전투표","대통령선거","전라남도","순천시",5335,5335,3632,99,1117,152,293,2,0,5,0,14,0,1,3,5318,17,0
"13360","삼산동","삼산동제1투","대통령선거","전라남도","순천시",1109,739,452,20,200,15,44,0,0,0,0,2,0,0,0,733,6,370
"13361","삼산동","삼산동제2투","대통령선거","전라남도","순천시",1659,1270,848,36,299,27,55,0,0,2,0,2,0,0,0,1269,1,389
"13362","삼산동","삼산동제3투","대통령선거","전라남도","순천시",1373,934,602,28,249,16,29,0,0,1,0,4,0,0,1,930,4,439
"13363","삼산동","삼산동제4투","대통령선거","전라남도","순천시",2473,1927,1287,63,470,23,69,0,0,1,1,5,0,0,2,1921,6,546
"13364","삼산동","삼산동제5투","대통령선거","전라남도","순천시",2893,1978,1287,54,502,28,92,0,0,0,1,6,2,0,0,1972,6,915
"13365","삼산동","삼산동제6투","대통령선거","전라남도","순천시",1281,946,654,26,205,27,28,0,0,0,0,5,0,0,1,946,0,335
"13366","삼산동","삼산동제7투","대통령선거","전라남도","순천시",1472,1223,860,29,248,26,55,0,0,0,0,0,0,1,0,1219,4,249
"13367","조곡동","관내사전투표","대통령선거","전라남도","순천시",1743,1743,1198,32,389,39,65,0,0,3,0,9,2,0,0,1737,6,0
"13368","조곡동","조곡동제1투","대통령선거","전라남도","순천시",1869,1429,892,48,373,30,73,0,0,1,0,7,0,2,2,1428,1,440
"13369","조곡동","조곡동제2투","대통령선거","전라남도","순천시",789,470,285,19,137,10,14,1,0,1,0,1,0,0,0,468,2,319
"13370","조곡동","조곡동제3투","대통령선거","전라남도","순천시",1409,993,618,28,297,14,31,0,0,0,0,0,1,0,0,989,4,416
"13371","덕연동","관내사전투표","대통령선거","전라남도","순천시",7441,7441,5360,132,1414,174,298,4,1,2,2,33,0,0,4,7424,17,0
"13372","덕연동","덕연동제1투","대통령선거","전라남도","순천시",2463,1787,1188,64,434,34,60,0,0,0,0,1,1,0,1,1783,4,676
"13373","덕연동","덕연동제2투","대통령선거","전라남도","순천시",3031,2104,1423,65,471,43,77,1,0,0,0,13,0,2,1,2096,8,927
"13374","덕연동","덕연동제3투","대통령선거","전라남도","순천시",2400,1871,1232,40,457,49,66,0,0,2,0,18,0,0,2,1866,5,529
"13375","덕연동","덕연동제4투","대통령선거","전라남도","순천시",2114,1635,1044,63,430,40,44,1,0,0,0,7,1,0,0,1630,5,479
"13376","덕연동","덕연동제5투","대통령선거","전라남도","순천시",1912,1453,985,32,346,34,44,1,0,3,1,2,2,1,0,1451,2,459
"13377","덕연동","덕연동제6투","대통령선거","전라남도","순천시",2022,1553,1026,43,389,24,60,1,1,1,0,4,0,0,1,1550,3,469
"13378","덕연동","덕연동제7투","대통령선거","전라남도","순천시",2038,1429,970,35,339,29,44,0,0,0,1,6,0,0,1,1425,4,609
"13379","덕연동","덕연동제8투","대통령선거","전라남도","순천시",2403,1743,1246,26,321,53,89,0,0,1,0,3,0,0,0,1739,4,660
"13380","덕연동","덕연동제9투","대통령선거","전라남도","순천시",2263,1805,1337,35,288,44,84,2,1,2,1,9,0,0,0,1803,2,458
"13381","덕연동","덕연동제10투","대통령선거","전라남도","순천시",1953,1514,1067,29,307,29,63,0,1,0,0,13,0,0,1,1510,4,439
"13382","덕연동","덕연동제11투","대통령선거","전라남도","순천시",2802,2122,1402,62,519,39,83,0,0,1,0,9,0,1,2,2118,4,680
"13383","풍덕동","관내사전투표","대통령선거","전라남도","순천시",1998,1998,1349,42,503,28,58,2,1,0,0,9,0,0,1,1993,5,0
"13384","풍덕동","풍덕동제1투","대통령선거","전라남도","순천시",1271,789,508,26,209,20,16,0,0,0,0,4,0,0,1,784,5,482
"13385","풍덕동","풍덕동제2투","대통령선거","전라남도","순천시",1603,1115,703,39,312,18,32,0,1,1,0,3,2,0,1,1112,3,488
"13386","풍덕동","풍덕동제3투","대통령선거","전라남도","순천시",2368,1742,1071,46,523,29,54,0,0,0,0,9,1,0,2,1735,7,626
"13387","남제동","관내사전투표","대통령선거","전라남도","순천시",2133,2133,1348,55,578,47,83,0,0,1,1,9,0,2,4,2128,5,0
"13388","남제동","남제동제1투","대통령선거","전라남도","순천시",1395,878,550,27,254,10,23,0,0,3,1,3,1,0,1,873,5,517
"13389","남제동","남제동제2투","대통령선거","전라남도","순천시",1371,865,550,29,232,20,29,0,0,0,1,3,0,0,0,864,1,506
"13390","남제동","남제동제3투","대통령선거","전라남도","순천시",1651,1025,624,30,294,24,40,0,0,0,0,7,1,0,1,1021,4,626
"13391","남제동","남제동제4투","대통령선거","전라남도","순천시",1281,851,557,23,227,15,25,0,0,0,0,0,0,1,3,851,0,430
"13392","저전동","관내사전투표","대통령선거","전라남도","순천시",1477,1477,983,31,349,36,60,0,0,3,1,11,0,0,0,1474,3,0
"13393","저전동","저전동투표소","대통령선거","전라남도","순천시",1659,1115,664,35,354,13,37,1,0,1,0,5,0,1,0,1111,4,544
"13394","장천동","관내사전투표","대통령선거","전라남도","순천시",1164,1164,786,30,262,26,51,0,0,1,0,4,1,0,1,1162,2,0
"13395","장천동","장천동투표소","대통령선거","전라남도","순천시",1751,1021,611,44,316,15,26,0,1,1,1,4,0,0,0,1019,2,730
"13396","중앙동","관내사전투표","대통령선거","전라남도","순천시",1761,1761,1132,42,449,47,70,1,0,2,0,10,1,0,1,1755,6,0
"13397","중앙동","중앙동투표소","대통령선거","전라남도","순천시",2116,1280,793,41,399,18,22,1,0,0,0,2,0,1,0,1277,3,836
"13398","도사동","관내사전투표","대통령선거","전라남도","순천시",2605,2605,1789,45,577,54,106,0,1,1,2,14,1,1,4,2595,10,0
"13399","도사동","도사동제1투","대통령선거","전라남도","순천시",2519,1593,1080,43,369,36,54,0,0,1,1,4,0,1,0,1589,4,926
"13400","도사동","도사동제2투","대통령선거","전라남도","순천시",1337,859,595,14,200,19,24,0,0,1,0,0,1,0,1,855,4,478
"13401","도사동","도사동제3투","대통령선거","전라남도","순천시",1136,771,474,25,231,11,22,0,0,0,0,2,0,0,3,768,3,365
"13402","도사동","도사동제4투","대통령선거","전라남도","순천시",1501,1214,832,29,274,27,46,0,0,0,0,2,0,0,0,1210,4,287
"13403","도사동","도사동제5투","대통령선거","전라남도","순천시",1053,861,604,13,184,17,35,0,0,0,0,6,0,1,1,861,0,192
"13404","왕조1동","관내사전투표","대통령선거","전라남도","순천시",5886,5886,4174,111,1122,136,266,1,1,4,3,31,2,5,2,5858,28,0
"13405","왕조1동","왕조1동제1투","대통령선거","전라남도","순천시",2119,1660,1140,37,368,36,67,0,0,0,0,5,1,1,2,1657,3,459
"13406","왕조1동","왕조1동제2투","대통령선거","전라남도","순천시",2172,1435,1000,38,275,43,68,0,0,0,0,8,0,0,1,1433,2,737
"13407","왕조1동","왕조1동제3투","대통령선거","전라남도","순천시",3090,2132,1372,89,520,45,93,0,0,0,0,9,0,0,0,2128,4,958
"13408","왕조1동","왕조1동제4투","대통령선거","전라남도","순천시",1361,1037,703,23,233,30,42,0,0,0,0,6,0,0,0,1037,0,324
"13409","왕조1동","왕조1동제5투","대통령선거","전라남도","순천시",1611,1084,681,31,298,24,32,1,0,2,1,8,0,0,0,1078,6,527
"13410","왕조1동","왕조1동제6투","대통령선거","전라남도","순천시",2395,1456,946,52,334,35,72,1,0,1,0,12,0,0,0,1453,3,939
"13411","왕조1동","왕조1동제7투","대통령선거","전라남도","순천시",2038,1545,1053,46,332,29,72,1,0,0,0,2,1,0,1,1537,8,493
"13412","왕조1동","왕조1동제8투","대통령선거","전라남도","순천시",2331,1902,1334,46,377,49,80,0,0,1,0,7,0,0,1,1895,7,429
"13413","왕조1동","왕조1동제9투","대통령선거","전라남도","순천시",3861,3118,2028,108,766,97,107,0,0,0,0,8,0,0,0,3114,4,743
"13414","왕조2동","관내사전투표","대통령선거","전라남도","순천시",8588,8588,6398,148,1372,200,390,0,1,3,2,50,2,2,3,8571,17,0
"13415","왕조2동","왕조2동제1투","대통령선거","전라남도","순천시",1840,1429,1053,29,249,26,61,0,0,1,0,6,1,1,0,1427,2,411
"13416","왕조2동","왕조2동제2투","대통령선거","전라남도","순천시",1789,1196,800,35,263,36,49,1,0,1,0,6,0,0,1,1192,4,593
"13417","왕조2동","왕조2동제3투","대통령선거","전라남도","순천시",1469,1143,773,11,264,32,55,0,0,0,0,4,0,0,2,1141,2,326
"13418","왕조2동","왕조2동제4투","대통령선거","전라남도","순천시",1865,1378,984,36,254,38,55,0,0,0,0,7,0,0,1,1375,3,487
"13419","왕조2동","왕조2동제5투","대통령선거","전라남도","순천시",2362,1772,1228,41,367,48,74,1,0,0,0,7,0,2,1,1769,3,590
"13420","잘못 투입·구분된 투표지","잘못 투입·구분된 투표지","대통령선거","전라남도","순천시",0,0,0,0,0,0,0,0,0,0,0,0,0,0,0,0,0,0
"13421","거소·선상투표","거소·선상투표","대통령선거","전라남도","나주시",509,464,209,35,114,7,13,3,0,3,4,0,2,0,4,394,70,45
"13422","관외사전투표","관외사전투표","대통령선거","전라남도","나주시",11165,11162,7067,228,2694,400,660,6,1,6,2,27,2,3,8,11104,58,3
"13423","재외투표","재외투표","대통령선거","전라남도","나주시",367,237,168,8,33,5,20,1,0,0,0,1,0,0,0,236,1,130
"13424","남평읍","관내사전투표","대통령선거","전라남도","나주시",1822,1822,1065,30,608,33,63,1,0,0,1,1,2,4,5,1813,9,0
"13425","남평읍","남평읍제1투","대통령선거","전라남도","나주시",1630,1038,639,14,348,15,18,0,0,0,0,0,0,1,0,1035,3,592
"13426","남평읍","남평읍제2투","대통령선거","전라남도","나주시",2181,1455,862,23,475,20,55,0,0,2,1,3,1,1,3,1446,9,726
"13427","남평읍","남평읍제3투","대통령선거","전라남도","나주시",575,400,238,9,136,1,6,0,0,0,0,0,0,1,5,396,4,175
"13428","세지면","관내사전투표","대통령선거","전라남도","나주시",669,669,411,15,214,4,18,0,0,1,0,0,0,2,2,667,2,0
"13429","세지면","세지면투표소","대통령선거","전라남도","나주시",1754,1114,632,17,420,10,20,0,0,0,0,2,3,1,6,1111,3,640
"13430","왕곡면","관내사전투표","대통령선거","전라남도","나주시",724,724,458,13,219,7,13,0,0,0,0,2,1,1,4,718,6,0
"13431","왕곡면","왕곡면제1투","대통령선거","전라남도","나주시",881,557,309,12,204,6,11,0,1,1,0,1,1,2,4,552,5,324
"13432","왕곡면","왕곡면제2투","대통령선거","전라남도","나주시",885,610,321,15,239,9,16,0,0,2,0,1,0,0,3,606,4,275
"13433","반남면","관내사전투표","대통령선거","전라남도","나주시",410,410,268,5,118,5,6,1,0,0,0,0,0,0,2,405,5,0
"13434","반남면","반남면투표소","대통령선거","전라남도","나주시",891,580,326,11,209,9,14,0,0,0,0,0,0,1,4,574,6,311
"13435","공산면","관내사전투표","대통령선거","전라남도","나주시",615,615,347,6,227,3,16,1,0,0,0,6,1,1,5,613,2,0
"13436","공산면","공산면제1투","대통령선거","전라남도","나주시",1007,693,388,14,245,13,13,0,0,0,0,5,0,2,9,689,4,314
"13437","공산면","공산면제2투","대통령선거","전라남도","나주시",421,305,152,9,130,4,6,0,0,0,0,0,0,0,3,304,1,116
"13438","동강면","관내사전투표","대통령선거","전라남도","나주시",841,841,488,23,281,12,17,0,1,0,0,2,2,2,7,835,6,0
"13439","동강면","동강면투표소","대통령선거","전라남도","나주시",1441,877,467,25,326,7,23,1,1,1,0,1,1,5,9,867,10,564
"13440","다시면","관내사전투표","대통령선거","전라남도","나주시",1197,1197,678,15,437,19,29,0,0,2,0,2,2,0,4,1188,9,0
"13441","다시면","다시면제1투","대통령선거","전라남도","나주시",1582,1033,541,31,411,11,22,0,0,0,0,0,4,1,1,1022,11,549
"13442","다시면","다시면제2투","대통령선거","전라남도","나주시",518,341,182,8,134,4,8,0,0,0,0,1,0,0,1,338,3,177
"13443","문평면","관내사전투표","대통령선거","전라남도","나주시",476,476,270,14,164,5,8,0,1,0,0,1,2,0,6,471,5,0
"13444","문평면","문평면제1투","대통령선거","전라남도","나주시",725,479,274,12,158,2,15,0,1,0,1,0,0,1,6,470,9,246
"13445","문평면","문평면제2투","대통령선거","전라남도","나주시",472,308,163,2,137,1,4,0,0,0,0,0,0,0,0,307,1,164
"13446","노안면","관내사전투표","대통령선거","전라남도","나주시",892,892,566,15,260,10,20,2,0,0,1,8,2,2,1,887,5,0
"13447","노안면","노안면제1투","대통령선거","전라남도","나주시",712,433,251,10,149,3,11,0,0,0,0,4,1,1,1,431,2,279
"13448","노안면","노안면제2투","대통령선거","전라남도","나주시",1058,782,460,11,271,9,17,1,1,1,0,2,1,1,4,779,3,276
"13449","노안면","노안면제3투","대통령선거","전라남도","나주시",1307,823,491,12,277,8,16,0,0,2,0,4,0,2,4,816,7,484
"13450","금천면","관내사전투표","대통령선거","전라남도","나주시",955,955,544,16,342,13,24,3,1,1,0,1,1,1,6,953,2,0
"13451","금천면","금천면제1투","대통령선거","전라남도","나주시",1005,631,326,12,264,4,13,1,0,1,0,0,2,2,3,628,3,374
"13452","금천면","금천면제2투","대통령선거","전라남도","나주시",779,505,313,8,160,4,7,0,0,0,1,1,5,1,3,503,2,274
"13453","금천면","금천면제3투","대통령선거","전라남도","나주시",979,648,392,9,216,4,14,0,0,0,0,1,2,1,3,642,6,331
"13454","산포면","관내사전투표","대통령선거","전라남도","나주시",713,713,465,7,201,7,21,0,0,0,1,0,1,3,3,709,4,0
"13455","산포면","산포면제1투","대통령선거","전라남도","나주시",1324,865,489,13,322,10,21,1,0,0,0,0,1,0,0,857,8,459
"13456","산포면","산포면제2투","대통령선거","전라남도","나주시",222,168,98,6,55,2,4,0,0,0,0,0,0,1,2,168,0,54
"13457","산포면","산포면제3투","대통령선거","전라남도","나주시",719,539,306,9,185,7,19,0,0,3,0,0,0,1,5,535,4,180
"13458","다도면","관내사전투표","대통령선거","전라남도","나주시",538,538,312,18,148,9,23,2,3,2,2,2,2,1,5,529,9,0
"13459","다도면","다도면투표소","대통령선거","전라남도","나주시",1162,660,380,13,236,3,7,0,0,1,1,4,1,2,3,651,9,502
"13460","봉황면","관내사전투표","대통령선거","전라남도","나주시",1002,1002,602,13,346,7,19,1,0,1,0,3,2,2,5,1001,1,0
"13461","봉황면","봉황면제1투","대통령선거","전라남도","나주시",1733,1097,652,25,371,7,22,0,0,1,0,0,5,4,4,1091,6,636
"13462","봉황면","봉황면제2투","대통령선거","전라남도","나주시",743,465,256,6,166,6,14,0,0,0,1,0,3,2,5,459,6,278
"13463","송월동","관내사전투표","대통령선거","전라남도","나주시",1064,1064,730,14,233,25,55,0,0,0,1,3,0,1,0,1062,2,0
"13464","송월동","송월동제1투","대통령선거","전라남도","나주시",474,295,156,3,120,5,7,0,0,0,0,0,0,2,1,294,1,179
"13465","송월동","송월동제2투","대통령선거","전라남도","나주시",1603,1149,723,20,330,16,55,0,0,1,0,2,1,0,0,1148,1,454
"13466","송월동","송월동제3투","대통령선거","전라남도","나주시",1420,1001,618,28,290,27,30,0,0,0,2,1,0,1,1,998,3,419
"13467","영강동","관내사전투표","대통령선거","전라남도","나주시",910,910,586,11,262,11,19,1,0,0,0,6,2,1,5,904,6,0
"13468","영강동","영강동투표소","대통령선거","전라남도","나주시",1449,813,476,17,273,11,31,0,1,1,0,0,0,2,0,812,1,636
"13469","금남동","관내사전투표","대통령선거","전라남도","나주시",1223,1223,773,14,352,18,54,0,0,1,0,3,0,0,2,1217,6,0
"13470","금남동","금남동제1투","대통령선거","전라남도","나주시",1165,748,387,25,285,21,22,0,0,0,0,0,0,0,2,742,6,417
"13471","금남동","금남동제2투","대통령선거","전라남도","나주시",863,519,297,11,184,12,10,0,0,2,0,0,0,0,1,517,2,344
"13472","금남동","금남동제3투","대통령선거","전라남도","나주시",1104,704,425,14,224,9,20,0,0,0,0,4,0,2,2,700,4,400
"13473","성북동","관내사전투표","대통령선거","전라남도","나주시",2588,2588,1589,54,749,53,128,0,1,3,0,2,1,0,1,2581,7,0
"13474","성북동","성북동제1투","대통령선거","전라남도","나주시",1148,690,373,21,256,15,19,0,0,0,0,3,1,0,1,689,1,458
"13475","성북동","성북동제2투","대통령선거","전라남도","나주시",1103,757,427,15,254,21,30,0,0,2,0,3,0,0,0,752,5,346
"13476","성북동","성북동제3투","대통령선거","전라남도","나주시",2416,1852,1174,30,520,38,78,1,0,1,0,7,0,0,1,1850,2,564
"13477","영산동","관내사전투표","대통령선거","전라남도","나주시",825,825,507,16,263,10,17,1,0,0,0,2,1,1,5,823,2,0
"13478","영산동","영산동제1투","대통령선거","전라남도","나주시",906,563,327,18,191,8,10,1,0,0,1,0,0,0,3,559,4,343
"13479","영산동","영산동제2투","대통령선거","전라남도","나주시",1243,752,444,21,247,9,18,0,0,1,0,1,2,0,5,748,4,491
"13480","이창동","관내사전투표","대통령선거","전라남도","나주시",1376,1376,887,25,399,24,36,0,0,3,0,0,0,0,1,1375,1,0
"13481","이창동","이창동투표소","대통령선거","전라남도","나주시",2181,1259,726,19,447,19,29,1,0,0,0,2,2,1,6,1252,7,922
"13482","빛가람동","관내사전투표","대통령선거","전라남도","나주시",4539,4539,3240,83,766,156,276,3,1,4,0,5,0,0,1,4535,4,0
"13483","빛가람동","빛가람동제1투","대통령선거","전라남도","나주시",2222,1753,1183,52,332,88,92,1,0,0,0,2,0,0,0,1750,3,469
"13484","빛가람동","빛가람동제2투","대통령선거","전라남도","나주시",1767,1415,972,29,316,39,55,0,0,0,0,2,0,0,0,1413,2,352
"13485","빛가람동","빛가람동제3투","대통령선거","전라남도","나주시",1446,1086,716,17,265,28,55,0,0,0,0,3,0,0,0,1084,2,360
"13486","빛가람동","빛가람동제4투","대통령선거","전라남도","나주시",2110,1677,1171,48,323,53,70,0,0,0,0,6,0,0,0,1671,6,433
"13487","빛가람동","빛가람동제5투","대통령선거","전라남도","나주시",1134,828,512,20,228,18,42,0,0,0,0,4,0,0,2,826,2,306
"13488","빛가람동","빛가람동제6투","대통령선거","전라남도","나주시",1432,1090,722,26,252,25,62,0,0,0,0,0,0,0,1,1088,2,342
"13489","잘못 투입·구분된 투표지","잘못 투입·구분된 투표지","대통령선거","전라남도","나주시",0,0,0,0,0,0,0,0,0,0,0,0,0,0,0,0,0,0
"13490","거소·선상투표","거소·선상투표","대통령선거","전라남도","광양시",338,315,158,17,95,10,10,1,2,2,1,0,0,3,3,302,13,23
"13491","관외사전투표","관외사전투표","대통령선거","전라남도","광양시",12445,12442,7905,522,2254,713,908,8,5,6,1,35,0,6,22,12385,57,3
"13492","재외투표","재외투표","대통령선거","전라남도","광양시",543,389,245,9,71,13,47,2,0,0,0,0,0,0,0,387,2,154
"13493","광양읍","관내사전투표","대통령선거","전라남도","광양시",8724,8724,6222,217,1630,185,375,2,1,3,1,36,5,1,8,8686,38,0
"13494","광양읍","광양읍제1투","대통령선거","전라남도","광양시",2062,1346,872,57,345,23,40,0,0,1,1,3,0,1,0,1343,3,716
"13495","광양읍","광양읍제2투","대통령선거","전라남도","광양시",2242,1337,849,38,356,26,56,2,0,0,0,4,0,1,2,1334,3,905
"13496","광양읍","광양읍제3투","대통령선거","전라남도","광양시",729,485,320,25,124,5,8,1,0,0,0,1,1,0,0,485,0,244
"13497","광양읍","광양읍제4투","대통령선거","전라남도","광양시",2880,1921,1249,61,494,32,67,1,0,0,0,8,0,0,3,1915,6,959
"13498","광양읍","광양읍제5투","대통령선거","전라남도","광양시",470,328,247,4,65,2,8,0,0,0,0,0,0,1,1,328,0,142
"13499","광양읍","광양읍제6투","대통령선거","전라남도","광양시",536,379,250,13,89,4,14,0,0,1,0,3,0,0,4,378,1,157
"13500","광양읍","광양읍제7투","대통령선거","전라남도","광양시",912,640,441,6,170,5,14,0,0,0,0,1,0,0,1,638,2,272
"13501","광양읍","광양읍제8투","대통령선거","전라남도","광양시",2318,1436,874,68,368,41,70,0,0,0,0,3,0,0,4,1428,8,882
"13502","광양읍","광양읍제9투","대통령선거","전라남도","광양시",2765,1903,1300,40,396,56,97,1,0,2,0,4,0,0,2,1898,5,862
"13503","광양읍","광양읍제10투","대통령선거","전라남도","광양시",1739,1174,796,34,265,31,32,0,0,2,1,3,0,0,2,1166,8,565
"13504","광양읍","광양읍제11투","대통령선거","전라남도","광양시",2416,1701,1082,66,428,37,70,3,0,2,0,8,0,0,1,1697,4,715
"13505","광양읍","광양읍제12투","대통령선거","전라남도","광양시",2918,2152,1491,56,427,58,91,0,0,3,0,21,0,0,1,2148,4,766
"13506","광양읍","광양읍제13투","대통령선거","전라남도","광양시",2685,2143,1488,52,438,51,103,0,0,0,0,7,0,1,2,2142,1,542
"13507","광양읍","광양읍제14투","대통령선거","전라남도","광양시",1520,1199,832,32,253,30,45,1,0,1,0,2,0,2,0,1198,1,321
"13508","봉강면","관내사전투표","대통령선거","전라남도","광양시",349,349,208,8,98,11,18,0,0,1,1,0,0,0,1,346,3,0
"13509","봉강면","봉강면제1투","대통령선거","전라남도","광양시",451,316,183,22,96,7,5,0,0,0,0,0,1,1,1,316,0,135
"13510","봉강면","봉강면제2투","대통령선거","전라남도","광양시",807,527,332,19,144,10,10,0,1,1,3,0,0,0,6,526,1,280
"13511","옥룡면","관내사전투표","대통령선거","전라남도","광양시",579,579,373,18,150,6,20,0,0,2,0,2,0,0,3,574,5,0
"13512","옥룡면","옥룡면제1투","대통령선거","전라남도","광양시",1024,681,411,31,202,12,11,0,0,1,0,1,0,1,6,676,5,343
"13513","옥룡면","옥룡면제2투","대통령선거","전라남도","광양시",829,582,368,22,168,6,8,0,0,0,0,0,0,1,7,580,2,247
"13514","옥곡면","관내사전투표","대통령선거","전라남도","광양시",802,802,541,24,186,18,22,0,0,0,1,1,0,0,3,796,6,0
"13515","옥곡면","옥곡면제1투","대통령선거","전라남도","광양시",676,459,314,9,104,9,5,1,0,0,1,3,3,1,7,457,2,217
"13516","옥곡면","옥곡면제2투","대통령선거","전라남도","광양시",1090,742,495,17,185,17,19,0,0,1,0,0,0,0,4,738,4,348
"13517","진상면","관내사전투표","대통령선거","전라남도","광양시",749,749,559,27,128,8,19,1,0,0,1,1,0,1,3,748,1,0
"13518","진상면","진상면제1투","대통령선거","전라남도","광양시",1143,780,549,28,171,9,13,0,1,0,0,0,1,0,4,776,4,363
"13519","진상면","진상면제2투","대통령선거","전라남도","광양시",648,431,291,13,107,3,8,0,0,0,2,1,0,0,1,426,5,217
"13520","진월면","관내사전투표","대통령선거","전라남도","광양시",607,607,390,21,161,18,12,0,0,0,0,1,0,1,2,606,1,0
"13521","진월면","진월면제1투","대통령선거","전라남도","광양시",1042,630,405,29,162,10,14,0,0,1,0,2,0,0,1,624,6,412
"13522","진월면","진월면제2투","대통령선거","전라남도","광양시",469,319,222,12,72,2,5,0,0,1,1,0,0,0,2,317,2,150
"13523","진월면","진월면제3투","대통령선거","전라남도","광양시",467,327,188,30,85,7,10,0,0,1,1,1,0,0,2,325,2,140
"13524","다압면","관내사전투표","대통령선거","전라남도","광양시",239,239,156,20,44,7,8,1,1,1,0,0,0,0,0,238,1,0
"13525","다압면","다압면제1투","대통령선거","전라남도","광양시",578,434,293,42,78,6,12,0,1,0,0,0,0,1,0,433,1,144
"13526","다압면","다압면제2투","대통령선거","전라남도","광양시",589,404,262,24,94,9,10,0,0,1,0,0,0,1,2,403,1,185
"13527","골약동","관내사전투표","대통령선거","전라남도","광양시",536,536,374,24,115,8,10,0,0,0,0,0,0,1,1,533,3,0
"13528","골약동","골약동제1투","대통령선거","전라남도","광양시",571,412,315,7,66,8,10,0,0,0,0,1,1,0,3,411,1,159
"13529","골약동","골약동제2투","대통령선거","전라남도","광양시",575,370,225,29,96,10,5,0,0,0,0,2,0,1,0,368,2,205
"13530","중마동","관내사전투표","대통령선거","전라남도","광양시",10208,10208,7131,354,1726,383,537,7,0,2,2,28,1,5,9,10185,23,0
"13531","중마동","중마동제1투","대통령선거","전라남도","광양시",3113,2135,1396,93,455,91,86,2,1,1,0,4,1,0,0,2130,5,978
"13532","중마동","중마동제2투","대통령선거","전라남도","광양시",3058,1919,1269,91,388,52,98,0,0,1,1,11,0,0,3,1914,5,1139
"13533","중마동","중마동제3투","대통령선거","전라남도","광양시",3333,2250,1437,113,499,86,96,1,1,1,0,14,0,0,1,2249,1,1083
"13534","중마동","중마동제4투","대통령선거","전라남도","광양시",3226,2279,1467,114,498,67,119,1,0,2,1,5,0,0,1,2275,4,947
"13535","중마동","중마동제5투","대통령선거","전라남도","광양시",3374,2250,1453,103,469,80,129,0,1,0,0,7,1,0,0,2243,7,1124
"13536","중마동","중마동제6투","대통령선거","전라남도","광양시",2952,2066,1411,86,377,64,111,0,0,2,0,5,1,0,0,2057,9,886
"13537","중마동","중마동제7투","대통령선거","전라남도","광양시",2717,2059,1412,83,373,65,117,0,0,1,0,5,0,0,1,2057,2,658
"13538","중마동","중마동제8투","대통령선거","전라남도","광양시",2863,2237,1470,121,455,74,105,0,0,0,0,1,0,4,0,2230,7,626
"13539","중마동","중마동제9투","대통령선거","전라남도","광양시",2827,1863,1245,89,358,57,101,0,0,1,0,3,0,1,2,1857,6,964
"13540","광영동","관내사전투표","대통령선거","전라남도","광양시",2258,2258,1526,93,467,50,100,1,0,4,0,8,1,0,3,2253,5,0
"13541","광영동","광영동제1투","대통령선거","전라남도","광양시",2431,1423,829,91,397,30,53,1,0,3,0,2,1,1,5,1413,10,1008
"13542","광영동","광영동제2투","대통령선거","전라남도","광양시",1719,1151,750,71,248,22,40,0,0,1,0,9,0,0,2,1143,8,568
"13543","광영동","광영동제3투","대통령선거","전라남도","광양시",2774,1843,1139,124,432,54,84,0,0,2,0,4,0,0,1,1840,3,931
"13544","태인동","관내사전투표","대통령선거","전라남도","광양시",660,660,487,15,114,12,26,0,0,1,0,3,0,0,0,658,2,0
"13545","태인동","태인동투표소","대통령선거","전라남도","광양시",1147,729,540,34,120,12,13,0,0,0,0,1,0,0,3,723,6,418
"13546","금호동","관내사전투표","대통령선거","전라남도","광양시",3329,3329,2033,221,682,170,205,4,0,1,2,2,1,0,1,3322,7,0
"13547","금호동","금호동제1투","대통령선거","전라남도","광양시",1352,1042,599,88,230,62,50,3,0,3,0,1,2,0,0,1038,4,310
"13548","금호동","금호동제2투","대통령선거","전라남도","광양시",984,744,402,87,180,34,36,0,0,0,0,1,1,1,0,742,2,240
"13549","금호동","금호동제3투","대통령선거","전라남도","광양시",1101,854,504,74,171,59,38,2,0,0,0,0,0,0,2,850,4,247
"13550","금호동","금호동제4투","대통령선거","전라남도","광양시",1096,821,466,81,181,38,50,1,0,1,0,1,0,0,2,821,0,275
"13551","금호동","금호동제5투","대통령선거","전라남도","광양시",1183,975,503,81,280,60,50,0,0,0,0,0,0,0,0,974,1,208
"13552","잘못 투입·구분된 투표지","잘못 투입·구분된 투표지","대통령선거","전라남도","광양시",0,0,0,0,0,0,0,0,0,0,0,0,0,0,0,0,0,0
"13553","거소·선상투표","거소·선상투표","대통령선거","전라남도","담양군",110,99,50,3,33,1,2,0,0,1,0,0,1,0,1,92,7,11
"13554","관외사전투표","관외사전투표","대통령선거","전라남도","담양군",5802,5800,3592,122,1477,193,357,1,2,6,0,17,1,1,4,5773,27,2
"13555","재외투표","재외투표","대통령선거","전라남도","담양군",202,136,99,1,22,2,11,0,0,0,0,0,0,0,0,135,1,66
"13556","담양읍","관내사전투표","대통령선거","전라남도","담양군",2790,2790,1772,57,775,48,99,0,0,4,3,10,1,3,5,2777,13,0
"13557","담양읍","담양읍제1투","대통령선거","전라남도","담양군",1635,1078,664,20,348,5,29,0,0,0,0,3,0,1,4,1074,4,557
"13558","담양읍","담양읍제2투","대통령선거","전라남도","담양군",1362,953,598,20,286,7,30,0,0,0,0,6,0,0,1,948,5,409
"13559","담양읍","담양읍제3투","대통령선거","전라남도","담양군",2163,1535,915,58,447,29,65,0,0,2,0,9,3,0,3,1531,4,628
"13560","담양읍","담양읍제4투","대통령선거","전라남도","담양군",1069,719,407,15,247,16,30,0,0,1,0,0,0,0,1,717,2,350
"13561","담양읍","담양읍제5투","대통령선거","전라남도","담양군",1670,1137,700,32,364,8,19,0,0,0,0,3,3,2,6,1137,0,533
"13562","봉산면","관내사전투표","대통령선거","전라남도","담양군",567,567,333,12,198,11,7,0,0,0,0,0,0,0,3,564,3,0
"13563","봉산면","봉산면제1투","대통령선거","전라남도","담양군",1096,694,418,10,229,10,13,0,0,0,0,1,2,2,4,689,5,402
"13564","봉산면","봉산면제2투","대통령선거","전라남도","담양군",540,394,214,4,158,3,9,0,0,0,0,2,0,0,1,391,3,146
"13565","고서면","관내사전투표","대통령선거","전라남도","담양군",846,846,497,15,275,13,27,1,0,0,1,3,0,2,5,839,7,0
"13566","고서면","고서면제1투","대통령선거","전라남도","담양군",954,626,376,10,207,9,16,0,1,0,1,2,0,0,2,624,2,328
"13567","고서면","고서면제2투","대통령선거","전라남도","담양군",850,593,339,13,205,11,18,0,1,0,0,0,1,1,3,592,1,257
"13568","남면","관내사전투표","대통령선거","전라남도","담양군",278,278,155,3,99,9,7,0,0,0,0,0,0,1,0,274,4,0
"13569","남면","남면제1투","대통령선거","전라남도","담양군",350,232,130,6,77,6,9,0,1,0,1,0,0,0,1,231,1,118
"13570","남면","남면제2투","대통령선거","전라남도","담양군",332,219,129,2,72,4,4,0,0,0,0,0,2,2,1,216,3,113
"13571","창평면","관내사전투표","대통령선거","전라남도","담양군",902,902,528,13,294,17,37,1,1,0,1,3,0,1,2,898,4,0
"13572","창평면","창평면제1투","대통령선거","전라남도","담양군",1422,907,540,11,291,12,30,0,0,0,0,12,1,0,3,900,7,515
"13573","창평면","창평면제2투","대통령선거","전라남도","담양군",650,444,251,10,160,4,11,0,0,1,0,0,0,0,3,440,4,206
"13574","대덕면","관내사전투표","대통령선거","전라남도","담양군",326,326,174,9,101,7,23,0,1,2,0,3,0,1,0,321,5,0
"13575","대덕면","대덕면제1투","대통령선거","전라남도","담양군",878,572,289,11,237,6,16,0,0,1,2,3,1,0,0,566,6,306
"13576","대덕면","대덕면제2투","대통령선거","전라남도","담양군",230,150,94,3,39,0,5,0,0,0,0,8,1,0,0,150,0,80
"13577","무정면","관내사전투표","대통령선거","전라남도","담양군",491,491,299,14,138,16,15,0,0,1,0,3,0,0,1,487,4,0
"13578","무정면","무정면제1투","대통령선거","전라남도","담양군",991,631,386,15,200,1,19,1,0,0,0,1,0,0,6,629,2,360
"13579","무정면","무정면제2투","대통령선거","전라남도","담양군",544,360,208,9,115,7,9,1,0,2,0,0,1,1,2,355,5,184
"13580","금성면","관내사전투표","대통령선거","전라남도","담양군",625,625,394,15,171,15,19,0,1,0,0,1,1,0,4,621,4,0
"13581","금성면","금성면제1투","대통령선거","전라남도","담양군",1105,715,428,14,236,9,18,0,0,0,0,1,0,1,2,709,6,390
"13582","금성면","금성면제2투","대통령선거","전라남도","담양군",387,275,154,5,107,3,3,1,0,0,0,0,0,2,0,275,0,112
"13583","용면","관내사전투표","대통령선거","전라남도","담양군",429,429,266,8,131,4,14,0,0,0,0,1,0,2,2,428,1,0
"13584","용면","용면제1투","대통령선거","전라남도","담양군",813,573,313,17,214,8,9,0,0,0,0,0,2,2,1,566,7,240
"13585","용면","용면제2투","대통령선거","전라남도","담양군",310,237,139,3,81,4,3,0,0,0,0,1,0,1,4,236,1,73
"13586","월산면","관내사전투표","대통령선거","전라남도","담양군",620,620,362,21,177,13,24,0,3,1,0,2,1,0,5,609,11,0
"13587","월산면","월산면제1투","대통령선거","전라남도","담양군",1019,656,381,21,203,13,24,0,0,0,0,4,0,0,5,651,5,363
"13588","월산면","월산면제2투","대통령선거","전라남도","담양군",388,286,166,6,85,6,9,2,0,2,0,3,2,0,4,285,1,102
"13589","수북면","관내사전투표","대통령선거","전라남도","담양군",978,978,625,14,274,12,34,0,1,0,1,8,1,0,3,973,5,0
"13590","수북면","수북면제1투","대통령선거","전라남도","담양군",1805,1206,718,21,397,13,37,0,0,0,0,8,2,1,3,1200,6,599
"13591","수북면","수북면제2투","대통령선거","전라남도","담양군",578,421,215,8,172,4,14,0,0,0,0,1,2,1,2,419,2,157
"13592","대전면","관내사전투표","대통령선거","전라남도","담양군",835,835,569,16,194,14,31,1,0,0,0,1,0,1,1,828,7,0
"13593","대전면","대전면제1투","대통령선거","전라남도","담양군",1764,1154,736,24,332,17,31,0,0,1,0,1,1,0,4,1147,7,610
"13594","대전면","대전면제2투","대통령선거","전라남도","담양군",728,531,338,7,149,7,25,1,0,0,0,0,0,0,2,529,2,197
"13595","잘못 투입·구분된 투표지","잘못 투입·구분된 투표지","대통령선거","전라남도","담양군",0,0,0,0,0,0,0,0,0,0,0,0,0,0,0,0,0,0
"13596","거소·선상투표","거소·선상투표","대통령선거","전라남도","장성군",135,123,58,8,44,7,2,1,0,1,0,0,0,0,0,121,2,12
"13597","관외사전투표","관외사전투표","대통령선거","전라남도","장성군",5449,5449,3226,142,1494,191,339,4,0,3,1,8,1,1,6,5416,33,0
"13598","재외투표","재외투표","대통령선거","전라남도","장성군",144,105,66,2,17,3,17,0,0,0,0,0,0,0,0,105,0,39
"13599","장성읍","관내사전투표","대통령선거","전라남도","장성군",2742,2742,1594,45,915,44,112,0,1,11,1,4,1,2,1,2731,11,0
"13600","장성읍","장성읍제1투","대통령선거","전라남도","장성군",1771,1152,658,36,403,16,27,0,0,1,0,1,1,0,4,1147,5,619
"13601","장성읍","장성읍제2투","대통령선거","전라남도","장성군",1568,1032,565,22,387,21,29,0,0,2,0,1,0,0,1,1028,4,536
"13602","장성읍","장성읍제3투","대통령선거","전라남도","장성군",1913,1131,650,29,370,11,51,0,0,5,1,2,1,0,2,1122,9,782
"13603","장성읍","장성읍제4투","대통령선거","전라남도","장성군",1823,1227,680,28,447,17,37,0,1,2,0,0,1,0,7,1220,7,596
"13604","진원면","관내사전투표","대통령선거","전라남도","장성군",636,636,393,12,200,4,23,1,0,1,0,0,0,0,2,636,0,0
"13605","진원면","진원면제1투","대통령선거","전라남도","장성군",1098,753,448,17,244,6,30,0,1,0,1,2,0,1,1,751,2,345
"13606","진원면","진원면제2투","대통령선거","전라남도","장성군",722,512,339,11,141,7,8,0,0,1,0,2,1,0,2,512,0,210
"13607","남면","관내사전투표","대통령선거","전라남도","장성군",573,573,322,4,215,2,25,0,0,0,0,0,0,0,1,569,4,0
"13608","남면","남면제1투","대통령선거","전라남도","장성군",901,619,358,10,220,6,16,0,0,2,0,3,0,0,3,618,1,282
"13609","남면","남면제2투","대통령선거","전라남도","장성군",1187,826,466,18,269,8,43,1,2,4,2,1,1,1,5,821,5,361
"13610","동화면","관내사전투표","대통령선거","전라남도","장성군",436,436,246,14,155,3,12,0,0,0,0,0,1,1,1,433,3,0
"13611","동화면","동화면제1투","대통령선거","전라남도","장성군",843,542,285,19,208,8,16,0,0,0,0,0,0,0,1,537,5,301
"13612","동화면","동화면제2투","대통령선거","전라남도","장성군",373,261,117,8,128,3,3,0,0,0,0,0,1,0,1,261,0,112
"13613","삼서면","관내사전투표","대통령선거","전라남도","장성군",809,809,423,39,263,40,30,0,0,1,0,1,1,0,3,801,8,0
"13614","삼서면","삼서면투표소","대통령선거","전라남도","장성군",1731,1125,674,18,370,14,35,0,0,3,0,2,0,0,5,1121,4,606
"13615","삼계면","관내사전투표","대통령선거","전라남도","장성군",1165,1165,625,78,341,64,50,0,0,0,0,4,0,0,1,1163,2,0
"13616","삼계면","삼계면제1투","대통령선거","전라남도","장성군",1242,840,500,21,271,14,21,0,0,1,1,1,2,2,1,835,5,402
"13617","삼계면","삼계면제2투","대통령선거","전라남도","장성군",1107,755,303,72,245,77,47,3,1,0,0,0,1,1,3,753,2,352
"13618","삼계면","삼계면제3투","대통령선거","전라남도","장성군",685,450,257,7,166,6,10,0,0,0,0,1,1,0,0,448,2,235
"13619","황룡면","관내사전투표","대통령선거","전라남도","장성군",956,956,571,28,307,10,27,1,2,2,1,2,0,0,2,953,3,0
"13620","황룡면","황룡면제1투","대통령선거","전라남도","장성군",880,501,276,7,183,5,17,0,0,2,0,1,1,0,4,496,5,379
"13621","황룡면","황룡면제2투","대통령선거","전라남도","장성군",1505,944,517,25,342,12,32,3,2,0,0,1,1,1,5,941,3,561
"13622","서삼면","관내사전투표","대통령선거","전라남도","장성군",248,248,125,5,93,7,16,0,0,0,0,0,0,0,1,247,1,0
"13623","서삼면","서삼면투표소","대통령선거","전라남도","장성군",923,644,314,17,277,7,18,0,0,2,0,1,1,1,2,640,4,279
"13624","북일면","관내사전투표","대통령선거","전라남도","장성군",423,423,251,8,146,6,8,0,0,0,0,2,0,0,2,423,0,0
"13625","북일면","북일면투표소","대통령선거","전라남도","장성군",795,494,288,14,171,4,9,0,0,0,0,1,0,0,4,491,3,301
"13626","북이면","관내사전투표","대통령선거","전라남도","장성군",830,830,462,19,303,19,17,0,0,0,0,3,1,1,3,828,2,0
"13627","북이면","북이면제1투","대통령선거","전라남도","장성군",727,456,267,11,165,5,6,0,0,0,0,0,0,1,0,455,1,271
"13628","북이면","북이면제2투","대통령선거","전라남도","장성군",853,522,299,16,174,9,16,0,0,0,0,0,0,1,2,517,5,331
"13629","북하면","관내사전투표","대통령선거","전라남도","장성군",504,504,260,23,194,6,15,1,0,0,1,0,0,0,2,502,2,0
"13630","북하면","북하면투표소","대통령선거","전라남도","장성군",1386,885,495,18,299,12,26,2,3,2,4,3,5,2,7,878,7,501
"13631","잘못 투입·구분된 투표지","잘못 투입·구분된 투표지","대통령선거","전라남도","장성군",0,0,0,0,0,0,0,0,0,0,0,0,0,0,0,0,0,0
"13632","거소·선상투표","거소·선상투표","대통령선거","전라남도","곡성군",82,79,42,1,26,0,2,0,0,1,0,0,1,0,1,74,5,3
"13633","관외사전투표","관외사전투표","대통령선거","전라남도","곡성군",3440,3440,2056,95,928,108,211,1,0,6,2,13,1,2,3,3426,14,0
"13634","재외투표","재외투표","대통령선거","전라남도","곡성군",123,81,50,3,17,3,8,0,0,0,0,0,0,0,0,81,0,42
"13635","곡성읍","관내사전투표","대통령선거","전라남도","곡성군",2001,2001,1218,59,518,33,77,2,0,2,0,12,4,0,19,1944,57,0
"13636","곡성읍","곡성읍제1투","대통령선거","전라남도","곡성군",1051,709,373,17,275,6,19,0,0,4,0,6,0,0,4,704,5,342
"13637","곡성읍","곡성읍제2투","대통령선거","전라남도","곡성군",1113,771,435,30,259,14,20,0,0,2,0,4,0,1,2,767,4,342
"13638","곡성읍","곡성읍제3투","대통령선거","전라남도","곡성군",1316,922,541,32,298,9,33,0,0,4,0,0,0,0,3,920,2,394
"13639","곡성읍","곡성읍제4투","대통령선거","전라남도","곡성군",878,569,349,9,179,4,14,0,0,2,1,3,1,0,2,564,5,309
"13640","오곡면","관내사전투표","대통령선거","전라남도","곡성군",467,467,277,12,162,4,6,0,0,1,0,1,0,0,2,465,2,0
"13641","오곡면","오곡면투표소","대통령선거","전라남도","곡성군",1098,779,417,36,282,12,21,0,0,2,0,0,1,0,3,774,5,319
"13642","삼기면","관내사전투표","대통령선거","전라남도","곡성군",347,347,188,18,115,6,14,0,0,0,0,0,0,1,1,343,4,0
"13643","삼기면","삼기면투표소","대통령선거","전라남도","곡성군",1036,650,369,24,227,3,12,0,0,0,0,0,1,1,4,641,9,386
"13644","석곡면","관내사전투표","대통령선거","전라남도","곡성군",817,817,527,22,234,2,14,0,1,0,0,1,2,2,5,810,7,0
"13645","석곡면","석곡면투표소","대통령선거","전라남도","곡성군",1362,851,480,23,300,8,19,0,0,2,0,2,3,1,5,843,8,511
"13646","목사동면","관내사전투표","대통령선거","전라남도","곡성군",339,339,174,14,132,3,5,0,0,1,0,2,0,2,1,334,5,0
"13647","목사동면","목사동면투표소","대통령선거","전라남도","곡성군",765,453,231,11,177,7,14,1,0,0,0,0,1,1,2,445,8,312
"13648","죽곡면","관내사전투표","대통령선거","전라남도","곡성군",519,519,314,9,172,9,6,0,0,0,1,1,1,0,1,514,5,0
"13649","죽곡면","죽곡면투표소","대통령선거","전라남도","곡성군",1001,654,381,36,199,10,20,1,0,1,0,0,1,0,2,651,3,347
"13650","고달면","관내사전투표","대통령선거","전라남도","곡성군",230,230,127,7,75,4,10,0,1,0,0,2,1,0,2,229,1,0
"13651","고달면","고달면투표소","대통령선거","전라남도","곡성군",793,558,330,18,167,5,20,1,0,1,0,2,0,1,5,550,8,235
"13652","옥과면","관내사전투표","대통령선거","전라남도","곡성군",1051,1051,576,15,373,20,50,0,0,1,0,6,0,0,5,1046,5,0
"13653","옥과면","옥과면제1투","대통령선거","전라남도","곡성군",1550,991,569,20,316,17,48,0,0,5,0,4,2,1,1,983,8,559
"13654","옥과면","옥과면제2투","대통령선거","전라남도","곡성군",796,543,285,16,207,3,16,1,0,4,0,4,0,0,1,537,6,253
"13655","입면","관내사전투표","대통령선거","전라남도","곡성군",644,644,362,12,224,11,18,0,1,0,0,2,1,1,5,637,7,0
"13656","입면","입면투표소","대통령선거","전라남도","곡성군",1258,832,528,11,220,8,44,0,1,0,1,10,0,0,6,829,3,426
"13657","겸면","관내사전투표","대통령선거","전라남도","곡성군",560,560,286,22,197,10,26,0,2,0,1,3,1,1,3,552,8,0
"13658","겸면","겸면투표소","대통령선거","전라남도","곡성군",882,547,270,23,204,8,25,1,0,4,0,6,1,1,2,545,2,335
"13659","오산면","관내사전투표","대통령선거","전라남도","곡성군",408,408,211,13,160,5,13,1,0,1,0,0,1,0,0,405,3,0
"13660","오산면","오산면투표소","대통령선거","전라남도","곡성군",744,435,186,16,207,8,10,0,0,0,0,2,2,0,4,435,0,309
"13661","잘못 투입·구분된 투표지","잘못 투입·구분된 투표지","대통령선거","전라남도","곡성군",0,0,0,0,0,0,0,0,0,0,0,0,0,0,0,0,0,0
"13662","거소·선상투표","거소·선상투표","대통령선거","전라남도","구례군",75,69,32,9,17,2,3,0,0,0,0,0,1,0,1,65,4,6
"13663","관외사전투표","관외사전투표","대통령선거","전라남도","구례군",2551,2550,1644,70,572,92,143,1,0,3,0,10,0,0,3,2538,12,1
"13664","재외투표","재외투표","대통령선거","전라남도","구례군",102,75,45,5,12,0,10,0,0,0,0,0,0,1,0,73,2,27
"13665","구례읍","관내사전투표","대통령선거","전라남도","구례군",2599,2599,1682,70,666,40,107,0,0,2,0,14,2,1,4,2588,11,0
"13666","구례읍","구례읍제1투","대통령선거","전라남도","구례군",735,549,352,16,152,8,13,0,0,3,0,3,0,0,0,547,2,186
"13667","구례읍","구례읍제2투","대통령선거","전라남도","구례군",1305,932,546,28,308,11,27,1,0,1,0,3,0,1,1,927,5,373
"13668","구례읍","구례읍제3투","대통령선거","전라남도","구례군",1384,905,545,25,286,10,23,0,0,2,0,7,0,0,2,900,5,479
"13669","구례읍","구례읍제4투","대통령선거","전라남도","구례군",975,660,414,17,203,6,17,0,0,0,0,2,0,0,0,659,1,315
"13670","구례읍","구례읍제5투","대통령선거","전라남도","구례군",1420,952,568,35,283,12,38,0,0,0,1,4,0,1,4,946,6,468
"13671","문척면","관내사전투표","대통령선거","전라남도","구례군",278,278,177,5,74,4,11,0,0,0,0,4,1,0,0,276,2,0
"13672","문척면","문척면투표소","대통령선거","전라남도","구례군",760,533,300,25,183,3,11,0,0,1,0,2,2,1,2,530,3,227
"13673","간전면","관내사전투표","대통령선거","전라남도","구례군",348,348,224,11,90,7,10,0,0,0,0,3,0,1,1,347,1,0
"13674","간전면","간전면제1투","대통령선거","전라남도","구례군",451,303,183,12,91,4,4,0,0,1,0,2,0,0,2,299,4,148
"13675","간전면","간전면제2투","대통령선거","전라남도","구례군",270,211,151,6,41,2,6,0,0,0,0,1,1,1,1,210,1,59
"13676","간전면","간전면제3투","대통령선거","전라남도","구례군",230,168,94,10,55,2,2,0,0,0,0,1,1,0,3,168,0,62
"13677","토지면","관내사전투표","대통령선거","전라남도","구례군",696,696,491,19,147,8,16,0,1,0,0,2,0,0,3,687,9,0
"13678","토지면","토지면제1투","대통령선거","전라남도","구례군",769,497,309,20,136,6,14,0,0,0,0,4,0,0,4,493,4,272
"13679","토지면","토지면제2투","대통령선거","전라남도","구례군",287,189,114,13,50,2,7,0,0,0,0,1,0,0,0,187,2,98
"13680","토지면","토지면제3투","대통령선거","전라남도","구례군",320,239,163,12,45,1,11,1,0,0,0,0,0,0,4,237,2,81
"13681","마산면","관내사전투표","대통령선거","전라남도","구례군",678,678,447,21,158,13,25,1,1,1,0,6,0,0,2,675,3,0
"13682","마산면","마산면투표소","대통령선거","전라남도","구례군",1556,1041,623,56,293,14,34,0,1,1,0,6,2,2,2,1034,7,515
"13683","광의면","관내사전투표","대통령선거","전라남도","구례군",376,376,259,8,89,7,7,0,0,0,0,2,0,1,1,374,2,0
"13684","광의면","광의면제1투","대통령선거","전라남도","구례군",872,609,376,15,194,3,12,0,0,0,1,2,1,0,0,604,5,263
"13685","광의면","광의면제2투","대통령선거","전라남도","구례군",642,469,283,15,150,5,7,0,0,1,0,1,0,1,0,463,6,173
"13686","용방면","관내사전투표","대통령선거","전라남도","구례군",448,448,297,11,116,7,9,0,0,2,0,5,0,0,1,448,0,0
"13687","용방면","용방면투표소","대통령선거","전라남도","구례군",851,622,354,13,217,4,23,0,0,2,0,3,0,0,2,618,4,229
"13688","산동면","관내사전투표","대통령선거","전라남도","구례군",512,512,329,23,132,4,20,0,0,0,0,2,0,0,0,510,2,0
"13689","산동면","산동면제1투","대통령선거","전라남도","구례군",984,682,432,18,202,3,16,0,0,0,0,2,2,1,3,679,3,302
"13690","산동면","산동면제2투","대통령선거","전라남도","구례군",670,487,274,30,165,5,9,0,0,0,0,1,0,0,1,485,2,183
"13691","산동면","산동면제3투","대통령선거","전라남도","구례군",343,247,165,10,61,0,4,0,0,0,0,0,0,1,3,244,3,96
"13692","잘못 투입·구분된 투표지","잘못 투입·구분된 투표지","대통령선거","전라남도","구례군",0,0,0,0,0,0,0,0,0,0,0,0,0,0,0,0,0,0
"13693","거소·선상투표","거소·선상투표","대통령선거","전라남도","고흥군",357,326,114,33,136,7,7,3,0,1,0,2,0,0,0,303,23,31
"13694","관외사전투표","관외사전투표","대통령선거","전라남도","고흥군",5275,5274,3323,143,1243,187,295,0,2,25,1,20,0,2,4,5245,29,1
"13695","재외투표","재외투표","대통령선거","전라남도","고흥군",239,130,82,7,24,2,11,0,0,2,0,2,0,0,0,130,0,109
"13696","고흥읍","관내사전투표","대통령선거","전라남도","고흥군",2777,2777,1754,56,736,57,119,0,2,20,2,19,1,0,2,2768,9,0
"13697","고흥읍","고흥읍제1투","대통령선거","전라남도","고흥군",487,358,183,9,148,3,3,0,0,1,0,0,0,0,3,350,8,129
"13698","고흥읍","고흥읍제2투","대통령선거","전라남도","고흥군",652,479,271,16,154,8,14,0,0,5,0,5,0,1,1,475,4,173
"13699","고흥읍","고흥읍제3투","대통령선거","전라남도","고흥군",1694,1151,618,33,437,10,18,0,0,11,0,5,2,3,7,1144,7,543
"13700","고흥읍","고흥읍제4투","대통령선거","전라남도","고흥군",1742,1165,653,39,398,31,31,0,0,3,1,1,0,0,3,1160,5,577
"13701","고흥읍","고흥읍제5투","대통령선거","전라남도","고흥군",1677,1053,581,43,358,16,34,0,0,4,0,5,0,2,5,1048,5,624
"13702","도양읍","관내사전투표","대통령선거","전라남도","고흥군",1909,1909,1120,47,604,52,54,2,0,15,0,6,1,1,2,1904,5,0
"13703","도양읍","도양읍제1투","대통령선거","전라남도","고흥군",1485,1000,534,22,404,10,14,0,0,7,0,1,1,0,1,994,6,485
"13704","도양읍","도양읍제2투","대통령선거","전라남도","고흥군",1561,1055,611,22,374,10,16,0,0,11,0,0,0,0,5,1049,6,506
"13705","도양읍","도양읍제3투","대통령선거","전라남도","고흥군",2295,1556,889,29,539,22,37,0,0,17,1,6,0,1,5,1546,10,739
"13706","도양읍","도양읍제4투","대통령선거","전라남도","고흥군",392,290,162,5,100,1,4,0,0,4,0,5,2,0,4,287,3,102
"13707","도양읍","도양읍제5투","대통령선거","전라남도","고흥군",484,364,178,9,154,2,5,0,0,4,0,0,1,1,4,358,6,120
"13708","도양읍","도양읍제6투","대통령선거","전라남도","고흥군",417,327,87,117,111,2,1,0,0,3,0,0,0,1,0,322,5,90
"13709","도양읍","도양읍제7투","대통령선거","전라남도","고흥군",200,150,110,1,32,1,0,0,0,0,0,0,0,1,4,149,1,50
"13710","풍양면","관내사전투표","대통령선거","전라남도","고흥군",768,768,489,13,222,6,20,0,1,4,0,0,1,2,2,760,8,0
"13711","풍양면","풍양면제1투","대통령선거","전라남도","고흥군",716,447,247,13,169,2,7,0,0,1,0,1,0,1,3,444,3,269
"13712","풍양면","풍양면제2투","대통령선거","전라남도","고흥군",782,587,381,10,171,7,7,0,0,1,0,0,2,2,2,583,4,195
"13713","풍양면","풍양면제3투","대통령선거","전라남도","고흥군",658,449,259,11,159,1,5,1,0,2,0,0,0,0,3,441,8,209
"13714","도덕면","관내사전투표","대통령선거","전라남도","고흥군",681,681,375,6,248,8,16,1,1,16,0,1,2,0,5,679,2,0
"13715","도덕면","도덕면제1투","대통령선거","전라남도","고흥군",1081,725,409,22,252,6,19,0,0,4,0,0,2,2,4,720,5,356
"13716","도덕면","도덕면제2투","대통령선거","전라남도","고흥군",794,580,274,10,236,3,7,0,0,29,0,4,1,1,4,569,11,214
"13717","금산면","관내사전투표","대통령선거","전라남도","고흥군",1214,1214,792,22,344,11,19,0,2,5,0,3,0,3,3,1204,10,0
"13718","금산면","금산면제1투","대통령선거","전라남도","고흥군",1488,914,511,10,354,7,19,0,0,1,0,2,0,0,2,906,8,574
"13719","금산면","금산면제2투","대통령선거","전라남도","고흥군",1176,791,458,19,274,8,10,1,0,2,0,0,1,1,6,780,11,385
"13720","도화면","관내사전투표","대통령선거","전라남도","고흥군",773,773,418,16,271,10,23,0,0,1,0,23,0,0,5,767,6,0
"13721","도화면","도화면제1투","대통령선거","전라남도","고흥군",446,321,165,8,126,1,2,0,0,1,0,4,4,0,4,315,6,125
"13722","도화면","도화면제2투","대통령선거","전라남도","고흥군",1064,696,380,19,253,4,5,0,1,0,0,22,1,1,5,691,5,368
"13723","도화면","도화면제3투","대통령선거","전라남도","고흥군",1239,816,428,27,313,10,14,1,0,1,0,7,2,0,4,807,9,423
"13724","포두면","관내사전투표","대통령선거","전라남도","고흥군",778,778,472,20,237,7,30,0,0,1,0,2,0,1,2,772,6,0
"13725","포두면","포두면제1투","대통령선거","전라남도","고흥군",459,346,176,20,123,5,5,0,0,0,0,5,0,1,4,339,7,113
"13726","포두면","포두면제2투","대통령선거","전라남도","고흥군",665,448,257,6,152,5,7,0,0,2,0,1,2,3,7,442,6,217
"13727","포두면","포두면제3투","대통령선거","전라남도","고흥군",1608,1093,653,25,355,10,21,0,1,3,0,3,1,1,6,1079,14,515
"13728","포두면","포두면제4투","대통령선거","전라남도","고흥군",939,684,363,19,270,4,9,1,0,1,0,6,1,0,4,678,6,255
"13729","봉래면","관내사전투표","대통령선거","전라남도","고흥군",478,478,272,11,154,9,20,0,1,1,0,2,0,1,3,474,4,0
"13730","봉래면","봉래면제1투","대통령선거","전라남도","고흥군",756,459,244,27,154,7,10,0,0,1,0,1,3,0,5,452,7,297
"13731","봉래면","봉래면제2투","대통령선거","전라남도","고흥군",420,266,149,13,91,2,2,0,0,1,0,2,0,0,5,265,1,154
"13732","동일면","관내사전투표","대통령선거","전라남도","고흥군",336,336,187,14,106,4,10,0,0,3,0,0,1,3,2,330,6,0
"13733","동일면","동일면투표소","대통령선거","전라남도","고흥군",974,646,389,23,199,3,8,0,1,3,0,4,0,2,8,640,6,328
"13734","점암면","관내사전투표","대통령선거","전라남도","고흥군",428,428,226,13,153,3,21,0,0,5,0,0,2,0,1,424,4,0
"13735","점암면","점암면제1투","대통령선거","전라남도","고흥군",919,654,362,12,236,6,6,0,0,6,0,6,4,2,7,647,7,265
"13736","점암면","점암면제2투","대통령선거","전라남도","고흥군",506,382,224,11,133,0,3,0,0,0,1,0,0,0,3,375,7,124
"13737","점암면","점암면제3투","대통령선거","전라남도","고흥군",491,351,170,8,146,4,7,0,0,1,0,2,0,0,6,344,7,140
"13738","영남면","관내사전투표","대통령선거","전라남도","고흥군",290,290,169,10,90,2,6,0,0,3,0,0,0,1,5,286,4,0
"13739","영남면","영남면제1투","대통령선거","전라남도","고흥군",421,327,202,11,92,1,6,0,0,2,0,1,0,0,7,322,5,94
"13740","영남면","영남면제2투","대통령선거","전라남도","고흥군",439,270,147,8,95,2,3,0,0,1,0,1,1,2,8,268,2,169
"13741","과역면","관내사전투표","대통령선거","전라남도","고흥군",1142,1142,627,29,415,15,27,0,1,9,0,3,2,3,5,1136,6,0
"13742","과역면","과역면제1투","대통령선거","전라남도","고흥군",1251,816,445,31,299,7,12,1,0,2,1,4,0,2,2,806,10,435
"13743","과역면","과역면제2투","대통령선거","전라남도","고흥군",751,504,276,14,178,8,11,1,1,1,0,0,1,0,4,495,9,247
"13744","남양면","관내사전투표","대통령선거","전라남도","고흥군",440,440,237,12,167,7,9,0,1,1,0,0,0,0,1,435,5,0
"13745","남양면","남양면제1투","대통령선거","전라남도","고흥군",875,547,293,14,215,2,9,0,0,1,0,1,3,1,4,543,4,328
"13746","남양면","남양면제2투","대통령선거","전라남도","고흥군",667,484,237,6,199,10,5,0,2,1,1,2,3,1,11,478,6,183
"13747","동강면","관내사전투표","대통령선거","전라남도","고흥군",794,794,477,24,241,10,24,0,0,3,0,5,1,0,2,787,7,0
"13748","동강면","동강면제1투","대통령선거","전라남도","고흥군",1016,700,389,22,239,11,17,0,0,1,0,1,1,2,9,692,8,316
"13749","동강면","동강면제2투","대통령선거","전라남도","고흥군",957,637,357,20,225,7,11,1,0,0,0,1,1,0,6,629,8,320
"13750","대서면","관내사전투표","대통령선거","전라남도","고흥군",488,488,244,13,205,8,11,0,0,3,0,0,1,0,0,485,3,0
"13751","대서면","대서면제1투","대통령선거","전라남도","고흥군",956,635,380,9,213,4,17,0,0,1,0,2,1,0,5,632,3,321
"13752","대서면","대서면제2투","대통령선거","전라남도","고흥군",591,419,229,10,167,4,2,0,0,1,0,0,0,1,2,416,3,172
"13753","두원면","관내사전투표","대통령선거","전라남도","고흥군",739,739,431,12,253,12,16,0,0,2,0,1,1,0,4,732,7,0
"13754","두원면","두원면제1투","대통령선거","전라남도","고흥군",1079,718,406,28,243,15,8,0,0,2,0,0,3,1,3,709,9,361
"13755","두원면","두원면제2투","대통령선거","전라남도","고흥군",925,611,336,17,225,4,6,1,0,3,0,2,2,0,8,604,7,314
"13756","잘못 투입·구분된 투표지","잘못 투입·구분된 투표지","대통령선거","전라남도","고흥군",0,0,0,0,0,0,0,0,0,0,0,0,0,0,0,0,0,0
"13757","거소·선상투표","거소·선상투표","대통령선거","전라남도","보성군",163,148,80,3,48,1,8,1,0,0,1,2,0,0,1,145,3,15
"13758","관외사전투표","관외사전투표","대통령선거","전라남도","보성군",4339,4339,2650,113,1113,160,253,2,0,5,1,12,0,3,3,4315,24,0
"13759","재외투표","재외투표","대통령선거","전라남도","보성군",199,121,80,4,19,4,12,0,0,1,0,0,0,1,0,121,0,78
"13760","보성읍","관내사전투표","대통령선거","전라남도","보성군",2072,2072,1167,53,680,51,106,0,0,2,0,6,0,0,2,2067,5,0
"13761","보성읍","보성읍제1투","대통령선거","전라남도","보성군",879,551,258,19,243,13,16,0,0,0,0,0,1,0,0,550,1,328
"13762","보성읍","보성읍제2투","대통령선거","전라남도","보성군",840,558,288,6,234,9,11,3,0,0,0,2,0,1,2,556,2,282
"13763","보성읍","보성읍제3투","대통령선거","전라남도","보성군",1229,864,465,18,322,14,31,1,0,3,0,4,0,1,0,859,5,365
"13764","보성읍","보성읍제4투","대통령선거","전라남도","보성군",376,254,145,1,88,7,10,0,0,1,0,0,0,0,2,254,0,122
"13765","보성읍","보성읍제5투","대통령선거","전라남도","보성군",1071,739,379,10,313,12,18,0,0,0,0,2,1,0,2,737,2,332
"13766","보성읍","보성읍제6투","대통령선거","전라남도","보성군",615,414,231,8,155,4,7,0,0,0,0,2,0,1,1,409,5,201
"13767","벌교읍","관내사전투표","대통령선거","전라남도","보성군",1973,1972,1139,45,672,36,56,0,1,2,0,5,1,1,4,1962,10,1
"13768","벌교읍","벌교읍제1투","대통령선거","전라남도","보성군",942,443,228,16,176,5,12,0,0,1,1,0,1,0,2,442,1,499
"13769","벌교읍","벌교읍제2투","대통령선거","전라남도","보성군",951,641,345,13,252,8,14,0,0,0,0,0,1,0,3,636,5,310
"13770","벌교읍","벌교읍제3투","대통령선거","전라남도","보성군",1130,748,372,18,307,13,14,1,1,0,0,2,3,3,3,737,11,382
"13771","벌교읍","벌교읍제4투","대통령선거","전라남도","보성군",950,620,338,21,235,7,9,0,0,1,0,0,0,1,6,618,2,330
"13772","벌교읍","벌교읍제5투","대통령선거","전라남도","보성군",636,450,261,13,148,4,16,0,0,1,0,2,0,1,0,446,4,186
"13773","벌교읍","벌교읍제6투","대통령선거","전라남도","보성군",810,545,315,14,187,2,8,0,0,0,0,1,1,4,6,538,7,265
"13774","벌교읍","벌교읍제7투","대통령선거","전라남도","보성군",302,174,110,4,53,1,1,0,0,0,0,1,1,0,1,172,2,128
"13775","벌교읍","벌교읍제8투","대통령선거","전라남도","보성군",1850,1272,736,47,412,18,41,1,1,3,1,2,0,2,2,1266,6,578
"13776","벌교읍","벌교읍제9투","대통령선거","전라남도","보성군",632,415,248,14,131,2,9,0,0,0,0,1,0,1,6,412,3,217
"13777","벌교읍","벌교읍제10투","대통령선거","전라남도","보성군",258,153,95,0,47,2,2,0,0,1,0,0,2,0,3,152,1,105
"13778","노동면","관내사전투표","대통령선거","전라남도","보성군",256,256,139,6,90,5,9,0,0,0,0,3,1,0,1,254,2,0
"13779","노동면","노동면투표소","대통령선거","전라남도","보성군",663,442,219,10,172,9,9,0,0,3,1,6,4,0,5,438,4,221
"13780","미력면","관내사전투표","대통령선거","전라남도","보성군",363,363,208,12,121,5,11,0,0,0,1,1,0,1,0,360,3,0
"13781","미력면","미력면투표소","대통령선거","전라남도","보성군",817,518,292,10,189,8,8,0,0,0,1,2,1,2,3,516,2,299
"13782","겸백면","관내사전투표","대통령선거","전라남도","보성군",255,255,134,6,104,3,3,0,0,2,0,1,1,1,0,255,0,0
"13783","겸백면","겸백면투표소","대통령선거","전라남도","보성군",780,518,294,15,181,2,9,1,0,0,0,5,1,2,5,515,3,262
"13784","율어면","관내사전투표","대통령선거","전라남도","보성군",254,254,154,4,86,1,7,0,0,2,0,0,0,0,0,254,0,0
"13785","율어면","율어면투표소","대통령선거","전라남도","보성군",731,475,243,12,195,3,6,1,0,2,1,3,1,2,3,472,3,256
"13786","복내면","관내사전투표","대통령선거","전라남도","보성군",431,431,202,5,185,9,11,0,1,4,1,3,1,0,6,428,3,0
"13787","복내면","복내면투표소","대통령선거","전라남도","보성군",1007,672,326,15,290,9,16,0,0,0,1,3,1,2,6,669,3,335
"13788","문덕면","관내사전투표","대통령선거","전라남도","보성군",212,212,118,4,75,3,8,0,0,0,0,1,0,1,1,211,1,0
"13789","문덕면","문덕면투표소","대통령선거","전라남도","보성군",522,355,180,9,141,5,12,0,0,0,0,2,0,2,3,354,1,167
"13790","조성면","관내사전투표","대통령선거","전라남도","보성군",833,833,420,21,331,18,28,0,0,2,1,2,0,1,5,829,4,0
"13791","조성면","조성면제1투","대통령선거","전라남도","보성군",998,655,364,10,248,2,18,0,0,0,0,1,4,2,3,652,3,343
"13792","조성면","조성면제2투","대통령선거","전라남도","보성군",609,432,255,9,132,8,10,1,0,0,0,1,0,3,7,426,6,177
"13793","조성면","조성면제3투","대통령선거","전라남도","보성군",829,540,311,16,184,5,12,0,0,2,0,0,0,1,5,536,4,289
"13794","득량면","관내사전투표","대통령선거","전라남도","보성군",701,701,407,17,239,7,14,0,0,3,1,4,0,1,4,697,4,0
"13795","득량면","득량면제1투","대통령선거","전라남도","보성군",880,582,298,19,228,6,12,0,0,3,0,5,0,1,5,577,5,298
"13796","득량면","득량면제2투","대통령선거","전라남도","보성군",1169,753,438,22,255,12,16,0,0,3,0,1,0,0,2,749,4,416
"13797","득량면","득량면제3투","대통령선거","전라남도","보성군",695,475,234,10,210,3,7,0,0,0,0,2,2,0,2,470,5,220
"13798","회천면","관내사전투표","대통령선거","전라남도","보성군",631,631,339,13,232,8,26,0,1,2,1,2,1,1,1,627,4,0
"13799","회천면","회천면제1투","대통령선거","전라남도","보성군",628,354,175,13,150,7,4,0,0,1,0,0,0,0,0,350,4,274
"13800","회천면","회천면제2투","대통령선거","전라남도","보성군",657,440,274,5,145,1,4,1,0,1,0,0,1,1,3,436,4,217
"13801","회천면","회천면제3투","대통령선거","전라남도","보성군",741,509,264,14,193,9,13,0,0,0,0,2,1,2,5,503,6,232
"13802","웅치면","관내사전투표","대통령선거","전라남도","보성군",281,281,159,3,101,5,10,0,1,0,0,0,0,0,0,279,2,0
"13803","웅치면","웅치면투표소","대통령선거","전라남도","보성군",742,537,289,12,202,11,8,0,0,0,1,0,2,2,3,530,7,205
"13804","잘못 투입·구분된 투표지","잘못 투입·구분된 투표지","대통령선거","전라남도","보성군",0,0,0,0,0,0,0,0,0,0,0,0,0,0,0,0,0,0
"13805","거소·선상투표","거소·선상투표","대통령선거","전라남도","화순군",161,154,75,6,52,7,0,1,1,0,0,1,0,0,3,146,8,7
"13806","관외사전투표","관외사전투표","대통령선거","전라남도","화순군",6638,6635,4161,116,1706,208,388,0,1,4,2,15,0,4,6,6611,24,3
"13807","재외투표","재외투표","대통령선거","전라남도","화순군",199,145,104,7,17,2,14,0,0,0,0,1,0,0,0,145,0,54
"13808","화순읍","관내사전투표","대통령선거","전라남도","화순군",6620,6620,4261,66,1775,121,303,1,0,7,0,32,5,1,13,6585,35,0
"13809","화순읍","화순읍제1투","대통령선거","전라남도","화순군",1498,1176,710,14,374,19,56,0,0,0,0,0,0,0,0,1173,3,322
"13810","화순읍","화순읍제2투","대통령선거","전라남도","화순군",1779,1289,760,16,426,16,56,0,1,1,1,7,0,0,2,1286,3,490
"13811","화순읍","화순읍제3투","대통령선거","전라남도","화순군",2303,1611,958,35,504,27,70,0,0,2,0,6,0,0,0,1602,9,692
"13812","화순읍","화순읍제4투","대통령선거","전라남도","화순군",2267,1605,923,28,553,25,52,1,1,2,0,8,1,1,2,1597,8,662
"13813","화순읍","화순읍제5투","대통령선거","전라남도","화순군",1195,909,472,17,359,14,31,0,0,2,0,7,0,0,3,905,4,286
"13814","화순읍","화순읍제6투","대통령선거","전라남도","화순군",677,492,292,7,162,4,22,1,0,0,0,0,0,0,1,489,3,185
"13815","화순읍","화순읍제7투","대통령선거","전라남도","화순군",521,366,207,6,136,7,8,0,0,0,0,0,0,1,1,366,0,155
"13816","화순읍","화순읍제8투","대통령선거","전라남도","화순군",2124,1461,854,35,479,24,41,0,0,2,0,4,1,0,5,1445,16,663
"13817","화순읍","화순읍제9투","대통령선거","전라남도","화순군",1498,984,559,25,352,13,24,0,0,2,0,3,2,0,0,980,4,514
"13818","화순읍","화순읍제10투","대통령선거","전라남도","화순군",2343,1558,918,20,501,36,63,0,0,2,0,13,0,1,1,1555,3,785
"13819","화순읍","화순읍제11투","대통령선거","전라남도","화순군",1792,1306,722,34,463,26,51,0,1,2,1,1,1,0,3,1305,1,486
"13820","화순읍","화순읍제12투","대통령선거","전라남도","화순군",1066,753,416,17,259,18,34,0,0,0,0,4,0,2,1,751,2,313
"13821","화순읍","화순읍제13투","대통령선거","전라남도","화순군",2359,1823,1109,25,553,27,85,0,0,0,0,14,0,1,4,1818,5,536
"13822","한천면","관내사전투표","대통령선거","전라남도","화순군",235,235,144,8,74,0,5,1,0,0,0,0,2,0,0,234,1,0
"13823","한천면","한천면제1투","대통령선거","전라남도","화순군",487,297,151,7,119,6,6,0,0,0,0,0,2,0,5,296,1,190
"13824","한천면","한천면제2투","대통령선거","전라남도","화순군",348,243,129,7,89,4,4,0,0,0,0,1,1,1,3,239,4,105
"13825","춘양면","관내사전투표","대통령선거","전라남도","화순군",616,616,405,18,165,2,7,0,0,2,0,3,3,0,5,610,6,0
"13826","춘양면","춘양면투표소","대통령선거","전라남도","화순군",975,590,342,15,207,5,12,0,0,0,0,4,0,1,2,588,2,385
"13827","청풍면","관내사전투표","대통령선거","전라남도","화순군",290,290,180,7,90,1,4,0,0,0,0,0,1,0,4,287,3,0
"13828","청풍면","청풍면투표소","대통령선거","전라남도","화순군",555,343,196,10,116,1,2,0,0,0,0,0,2,2,9,338,5,212
"13829","이양면","관내사전투표","대통령선거","전라남도","화순군",638,638,397,11,190,9,16,0,0,0,0,0,2,3,8,636,2,0
"13830","이양면","이양면투표소","대통령선거","전라남도","화순군",929,527,317,10,175,3,9,1,0,0,0,1,0,1,9,526,1,402
"13831","능주면","관내사전투표","대통령선거","전라남도","화순군",918,918,544,22,298,8,33,1,0,0,0,4,1,3,1,915,3,0
"13832","능주면","능주면제1투","대통령선거","전라남도","화순군",1195,798,462,13,281,13,20,0,0,0,0,4,0,0,2,795,3,397
"13833","능주면","능주면제2투","대통령선거","전라남도","화순군",702,479,272,4,175,3,15,0,0,0,2,0,0,3,1,475,4,223
"13834","도곡면","관내사전투표","대통령선거","전라남도","화순군",801,801,460,21,263,10,26,1,1,1,0,5,1,0,4,793,8,0
"13835","도곡면","도곡면제1투","대통령선거","전라남도","화순군",744,481,247,4,197,3,23,0,0,0,0,1,0,3,1,479,2,263
"13836","도곡면","도곡면제2투","대통령선거","전라남도","화순군",794,530,329,7,173,2,10,0,0,0,0,0,0,2,5,528,2,264
"13837","도암면","관내사전투표","대통령선거","전라남도","화순군",404,403,207,4,171,3,12,0,0,0,1,1,1,1,1,402,1,1
"13838","도암면","도암면제1투","대통령선거","전라남도","화순군",577,348,170,9,154,1,5,0,0,0,0,6,1,1,1,348,0,229
"13839","도암면","도암면제2투","대통령선거","전라남도","화순군",234,173,66,4,95,1,0,0,0,0,1,1,2,0,1,171,2,61
"13840","이서면","관내사전투표","대통령선거","전라남도","화순군",212,212,116,6,68,1,10,0,0,1,0,1,0,0,6,209,3,0
"13841","이서면","이서면투표소","대통령선거","전라남도","화순군",509,359,201,7,128,3,11,0,0,1,0,0,3,0,2,356,3,150
"13842","북면","관내사전투표","대통령선거","전라남도","화순군",433,433,293,5,118,2,5,1,1,3,0,0,1,1,1,431,2,0
"13843","북면","북면투표소","대통령선거","전라남도","화순군",847,523,315,6,166,8,12,0,0,0,1,1,0,5,6,520,3,324
"13844","동복면","관내사전투표","대통령선거","전라남도","화순군",356,356,208,6,119,5,8,0,0,0,0,0,2,1,3,352,4,0
"13845","동복면","동복면투표소","대통령선거","전라남도","화순군",1033,708,380,17,271,8,8,2,0,1,0,2,3,2,7,701,7,325
"13846","남면","관내사전투표","대통령선거","전라남도","화순군",647,647,374,14,236,6,9,0,1,0,0,1,0,0,1,642,5,0
"13847","남면","남면제1투","대통령선거","전라남도","화순군",788,472,273,6,161,2,13,0,1,0,0,2,2,3,4,467,5,316
"13848","남면","남면제2투","대통령선거","전라남도","화순군",433,272,119,9,121,2,13,0,1,0,1,0,2,0,1,269,3,161
"13849","동면","관내사전투표","대통령선거","전라남도","화순군",801,801,430,13,303,8,28,1,1,0,0,4,1,0,7,796,5,0
"13850","동면","동면제1투","대통령선거","전라남도","화순군",1291,751,397,20,279,8,26,0,0,0,0,5,3,2,4,744,7,540
"13851","동면","동면제2투","대통령선거","전라남도","화순군",661,441,242,6,159,5,12,0,0,0,0,7,1,0,4,436,5,220
"13852","잘못 투입·구분된 투표지","잘못 투입·구분된 투표지","대통령선거","전라남도","화순군",0,0,0,0,0,0,0,0,0,0,0,0,0,0,0,0,0,0
"13853","거소·선상투표","거소·선상투표","대통령선거","전라남도","장흥군",135,114,53,5,40,4,3,0,0,0,1,1,1,1,2,111,3,21
"13854","관외사전투표","관외사전투표","대통령선거","전라남도","장흥군",3786,3785,2375,88,915,140,230,0,0,1,0,11,2,0,6,3768,17,1
"13855","재외투표","재외투표","대통령선거","전라남도","장흥군",179,114,69,5,29,2,7,0,1,1,0,0,0,0,0,114,0,65
"13856","장흥읍","관내사전투표","대통령선거","전라남도","장흥군",3507,3506,2076,66,1111,72,140,1,0,8,2,15,2,3,3,3499,7,1
"13857","장흥읍","장흥읍제1투","대통령선거","전라남도","장흥군",1380,813,417,33,300,15,27,0,0,1,1,8,1,2,3,808,5,567
"13858","장흥읍","장흥읍제2투","대통령선거","전라남도","장흥군",965,610,368,15,187,9,14,0,0,0,1,3,2,0,7,606,4,355
"13859","장흥읍","장흥읍제3투","대통령선거","전라남도","장흥군",1455,973,510,24,375,17,38,1,0,0,0,3,0,0,2,970,3,482
"13860","장흥읍","장흥읍제4투","대통령선거","전라남도","장흥군",1969,1355,812,23,425,15,69,1,0,1,0,6,0,0,2,1354,1,614
"13861","장흥읍","장흥읍제5투","대통령선거","전라남도","장흥군",1375,910,510,18,324,19,31,0,0,1,0,3,0,0,1,907,3,465
"13862","장흥읍","장흥읍제6투","대통령선거","전라남도","장흥군",532,349,185,6,131,3,7,0,0,0,0,7,0,0,7,346,3,183
"13863","관산읍","관내사전투표","대통령선거","전라남도","장흥군",1060,1060,549,19,409,20,40,0,0,0,0,15,0,1,3,1056,4,0
"13864","관산읍","관산읍제1투","대통령선거","전라남도","장흥군",1321,797,403,15,328,11,18,0,0,1,0,4,0,2,6,788,9,524
"13865","관산읍","관산읍제2투","대통령선거","전라남도","장흥군",954,610,321,14,237,4,15,0,0,0,0,5,2,1,3,602,8,344
"13866","관산읍","관산읍제3투","대통령선거","전라남도","장흥군",1069,750,400,11,300,3,12,0,0,0,0,10,1,0,4,741,9,319
"13867","대덕읍","관내사전투표","대통령선거","전라남도","장흥군",843,843,392,23,376,16,18,0,1,0,0,6,2,0,4,838,5,0
"13868","대덕읍","대덕읍제1투","대통령선거","전라남도","장흥군",1761,1096,462,35,506,26,40,2,1,0,2,4,3,0,7,1088,8,665
"13869","대덕읍","대덕읍제2투","대통령선거","전라남도","장흥군",461,334,159,3,146,3,9,0,0,1,0,0,0,1,8,330,4,127
"13870","용산면","관내사전투표","대통령선거","전라남도","장흥군",578,578,315,11,210,5,12,0,0,5,0,11,2,0,3,574,4,0
"13871","용산면","용산면투표소","대통령선거","전라남도","장흥군",1353,939,510,23,318,9,27,0,0,1,2,27,1,2,7,927,12,414
"13872","안양면","관내사전투표","대통령선거","전라남도","장흥군",798,798,442,11,283,10,29,0,0,4,1,2,2,2,3,789,9,0
"13873","안양면","안양면제1투","대통령선거","전라남도","장흥군",840,506,263,16,187,1,24,0,0,0,0,1,2,0,5,499,7,334
"13874","안양면","안양면제2투","대통령선거","전라남도","장흥군",870,591,321,10,227,8,16,1,0,0,0,0,1,0,3,587,4,279
"13875","장동면","관내사전투표","대통령선거","전라남도","장흥군",290,290,146,7,121,6,8,0,0,0,0,0,0,0,1,289,1,0
"13876","장동면","장동면투표소","대통령선거","전라남도","장흥군",744,524,245,18,221,14,15,0,0,0,1,0,2,2,5,523,1,220
"13877","장평면","관내사전투표","대통령선거","전라남도","장흥군",502,502,266,7,190,9,18,1,0,0,0,5,2,0,2,500,2,0
"13878","장평면","장평면제1투","대통령선거","전라남도","장흥군",969,633,327,17,239,7,15,0,0,1,0,15,0,1,7,629,4,336
"13879","장평면","장평면제2투","대통령선거","전라남도","장흥군",405,305,186,5,90,4,1,0,0,1,0,7,1,2,2,299,6,100
"13880","유치면","관내사전투표","대통령선거","전라남도","장흥군",357,357,194,25,102,13,9,1,0,0,0,6,1,0,4,355,2,0
"13881","유치면","유치면투표소","대통령선거","전라남도","장흥군",561,324,171,24,95,5,15,1,1,0,0,9,1,0,1,323,1,237
"13882","부산면","관내사전투표","대통령선거","전라남도","장흥군",363,363,201,9,138,4,7,1,0,0,1,0,0,0,0,361,2,0
"13883","부산면","부산면투표소","대통령선거","전라남도","장흥군",866,565,309,12,188,10,20,1,0,0,0,15,1,2,4,562,3,301
"13884","회진면","관내사전투표","대통령선거","전라남도","장흥군",715,715,362,9,310,13,12,0,0,0,0,1,1,1,2,711,4,0
"13885","회진면","회진면투표소","대통령선거","전라남도","장흥군",1725,1140,502,29,535,16,29,0,0,2,0,4,4,3,10,1134,6,585
"13886","잘못 투입·구분된 투표지","잘못 투입·구분된 투표지","대통령선거","전라남도","장흥군",0,0,0,0,0,0,0,0,0,0,0,0,0,0,0,0,0,0
"13887","거소·선상투표","거소·선상투표","대통령선거","전라남도","강진군",124,114,49,3,46,3,1,0,0,0,0,0,1,1,1,105,9,10
"13888","관외사전투표","관외사전투표","대통령선거","전라남도","강진군",3638,3636,2194,101,947,139,219,1,0,3,1,10,1,0,2,3618,18,2
"13889","재외투표","재외투표","대통령선거","전라남도","강진군",159,97,64,1,24,2,5,0,0,0,0,0,0,0,0,96,1,62
"13890","강진읍","관내사전투표","대통령선거","전라남도","강진군",3381,3381,1710,90,1288,76,163,3,0,15,1,11,1,1,7,3366,15,0
"13891","강진읍","강진읍제1투","대통령선거","전라남도","강진군",1315,737,325,23,342,14,20,0,0,6,0,0,0,1,2,733,4,578
"13892","강진읍","강진읍제2투","대통령선거","전라남도","강진군",1611,1041,459,33,493,13,32,1,1,1,0,1,1,0,0,1035,6,570
"13893","강진읍","강진읍제3투","대통령선거","전라남도","강진군",1357,950,444,46,397,22,33,0,0,1,1,0,0,1,2,947,3,407
"13894","강진읍","강진읍제4투","대통령선거","전라남도","강진군",758,542,245,13,246,8,14,0,0,0,1,0,1,0,7,535,7,216
"13895","강진읍","강진읍제5투","대통령선거","전라남도","강진군",781,513,250,7,224,4,15,1,0,0,1,1,1,1,2,507,6,268
"13896","강진읍","강진읍제6투","대통령선거","전라남도","강진군",1692,1132,576,30,447,29,38,0,0,0,0,4,0,0,2,1126,6,560
"13897","군동면","관내사전투표","대통령선거","전라남도","강진군",621,621,257,22,299,10,21,0,2,0,0,1,1,1,0,614,7,0
"13898","군동면","군동면제1투","대통령선거","전라남도","강진군",772,471,223,20,193,10,16,1,0,1,0,1,0,1,4,470,1,301
"13899","군동면","군동면제2투","대통령선거","전라남도","강진군",993,675,330,16,275,15,26,1,0,1,0,2,1,1,1,669,6,318
"13900","군동면","군동면제3투","대통령선거","전라남도","강진군",583,381,165,24,173,4,6,1,0,1,2,2,0,0,2,380,1,202
"13901","칠량면","관내사전투표","대통령선거","전라남도","강진군",641,641,319,20,265,14,15,0,0,0,1,0,0,0,2,636,5,0
"13902","칠량면","칠량면투표소","대통령선거","전라남도","강진군",1418,867,356,50,407,15,23,0,0,1,0,3,1,1,4,861,6,551
"13903","대구면","관내사전투표","대통령선거","전라남도","강진군",299,299,151,3,124,6,8,1,0,0,0,1,1,1,2,298,1,0
"13904","대구면","대구면투표소","대통령선거","전라남도","강진군",727,482,246,29,180,7,11,0,1,1,0,1,0,0,3,479,3,245
"13905","마량면","관내사전투표","대통령선거","전라남도","강진군",483,483,208,7,238,8,18,1,0,0,0,0,1,1,0,482,1,0
"13906","마량면","마량면투표소","대통령선거","전라남도","강진군",1146,743,355,17,345,11,9,0,0,1,0,2,0,0,1,741,2,403
"13907","도암면","관내사전투표","대통령선거","전라남도","강진군",487,487,220,9,227,8,13,0,0,1,0,3,1,0,1,483,4,0
"13908","도암면","도암면제1투","대통령선거","전라남도","강진군",1159,720,322,20,336,9,20,0,0,1,0,2,1,0,2,713,7,439
"13909","도암면","도암면제2투","대통령선거","전라남도","강진군",519,364,176,12,153,7,9,0,0,0,0,2,1,1,1,362,2,155
"13910","신전면","관내사전투표","대통령선거","전라남도","강진군",355,355,162,15,158,5,13,0,0,0,0,1,0,0,0,354,1,0
"13911","신전면","신전면제1투","대통령선거","전라남도","강진군",715,497,237,11,215,4,17,0,0,3,0,2,0,1,3,493,4,218
"13912","신전면","신전면제2투","대통령선거","전라남도","강진군",493,365,160,10,178,2,5,0,0,0,0,1,0,0,2,358,7,128
"13913","성전면","관내사전투표","대통령선거","전라남도","강진군",693,693,325,19,309,5,18,1,0,3,0,3,0,1,2,686,7,0
"13914","성전면","성전면투표소","대통령선거","전라남도","강진군",1676,1111,526,27,486,5,41,1,1,0,0,11,0,1,2,1101,10,565
"13915","작천면","관내사전투표","대통령선거","전라남도","강진군",533,533,292,12,203,10,11,0,0,0,0,2,0,2,0,532,1,0
"13916","작천면","작천면투표소","대통령선거","전라남도","강진군",1121,692,345,21,297,7,10,1,0,2,0,2,0,1,3,689,3,429
"13917","병영면","관내사전투표","대통령선거","전라남도","강진군",411,411,211,13,164,7,12,0,0,0,0,0,2,0,0,409,2,0
"13918","병영면","병영면투표소","대통령선거","전라남도","강진군",1098,716,340,26,309,7,18,0,0,2,0,1,1,3,2,709,7,382
"13919","옴천면","관내사전투표","대통령선거","전라남도","강진군",194,194,95,1,86,1,5,0,1,0,1,0,0,0,0,190,4,0
"13920","옴천면","옴천면투표소","대통령선거","전라남도","강진군",346,231,139,2,78,2,5,1,0,1,0,0,0,0,1,229,2,115
"13921","잘못 투입·구분된 투표지","잘못 투입·구분된 투표지","대통령선거","전라남도","강진군",0,0,0,0,0,0,0,0,0,0,0,0,0,0,0,0,0,0
"13922","거소·선상투표","거소·선상투표","대통령선거","전라남도","완도군",787,741,422,16,234,10,15,4,1,2,0,2,1,0,3,710,31,46
"13923","관외사전투표","관외사전투표","대통령선거","전라남도","완도군",4127,4127,2619,114,937,141,264,2,0,4,0,8,2,3,9,4103,24,0
"13924","재외투표","재외투표","대통령선거","전라남도","완도군",138,90,58,5,16,5,6,0,0,0,0,0,0,0,0,90,0,48
"13925","완도읍","관내사전투표","대통령선거","전라남도","완도군",3703,3703,2358,72,1005,75,150,0,1,1,1,17,0,0,4,3684,19,0
"13926","완도읍","완도읍제1투","대통령선거","전라남도","완도군",2888,1839,1126,36,572,32,61,0,0,1,0,6,0,0,2,1836,3,1049
"13927","완도읍","완도읍제2투","대통령선거","전라남도","완도군",2131,1349,784,32,471,16,27,0,0,2,1,5,0,0,4,1342,7,782
"13928","완도읍","완도읍제3투","대통령선거","전라남도","완도군",1145,747,418,23,278,2,16,0,0,1,0,0,0,2,3,743,4,398
"13929","완도읍","완도읍제4투","대통령선거","전라남도","완도군",2463,1628,972,44,519,25,47,1,0,3,0,8,1,0,1,1621,7,835
"13930","완도읍","완도읍제5투","대통령선거","전라남도","완도군",1007,694,376,22,258,15,17,0,0,0,0,0,0,1,2,691,3,313
"13931","완도읍","완도읍제6투","대통령선거","전라남도","완도군",959,619,364,22,208,2,11,1,0,1,0,2,0,0,2,613,6,340
"13932","금일읍","관내사전투표","대통령선거","전라남도","완도군",563,563,398,5,122,8,13,0,0,2,0,2,1,0,9,560,3,0
"13933","금일읍","금일읍제1투","대통령선거","전라남도","완도군",556,326,212,5,96,3,3,0,0,0,0,1,0,0,1,321,5,230
"13934","금일읍","금일읍제2투","대통령선거","전라남도","완도군",852,606,382,16,186,3,9,0,0,1,0,0,2,0,2,601,5,246
"13935","금일읍","금일읍제3투","대통령선거","전라남도","완도군",1014,674,445,11,177,9,7,0,0,0,0,0,4,2,9,664,10,340
"13936","노화읍","관내사전투표","대통령선거","전라남도","완도군",994,994,551,22,364,14,17,0,0,0,0,4,0,1,12,985,9,0
"13937","노화읍","노화읍제1투","대통령선거","전라남도","완도군",1609,1060,637,17,360,7,22,0,0,1,1,5,2,0,3,1055,5,549
"13938","노화읍","노화읍제2투","대통령선거","전라남도","완도군",915,651,376,9,230,1,12,0,0,0,2,1,2,2,11,646,5,264
"13939","노화읍","노화읍제3투","대통령선거","전라남도","완도군",584,394,241,6,130,6,6,0,0,0,0,1,1,1,0,392,2,190
"13940","군외면","관내사전투표","대통령선거","전라남도","완도군",546,546,278,16,223,5,15,0,0,1,0,1,1,1,2,543,3,0
"13941","군외면","군외면제1투","대통령선거","전라남도","완도군",1232,763,349,23,356,8,11,0,0,0,0,1,1,3,2,754,9,469
"13942","군외면","군외면제2투","대통령선거","전라남도","완도군",889,603,296,12,264,7,12,0,0,0,1,1,0,0,4,597,6,286
"13943","신지면","관내사전투표","대통령선거","전라남도","완도군",749,749,465,13,235,10,16,2,0,0,0,1,0,0,0,742,7,0
"13944","신지면","신지면제1투","대통령선거","전라남도","완도군",1079,717,426,16,247,2,15,1,1,0,0,1,0,0,5,714,3,362
"13945","신지면","신지면제2투","대통령선거","전라남도","완도군",1024,638,362,11,236,6,7,0,0,1,0,2,0,0,2,627,11,386
"13946","고금면","관내사전투표","대통령선거","전라남도","완도군",1149,1149,664,19,402,15,23,0,0,1,0,1,2,2,8,1137,12,0
"13947","고금면","고금면제1투","대통령선거","전라남도","완도군",1384,860,477,11,326,11,21,0,0,0,0,3,0,2,3,854,6,524
"13948","고금면","고금면제2투","대통령선거","전라남도","완도군",474,321,188,7,109,3,3,1,0,0,0,1,2,1,3,318,3,153
"13949","고금면","고금면제3투","대통령선거","전라남도","완도군",589,405,224,12,155,3,3,0,0,1,1,0,0,1,3,403,2,184
"13950","약산면","관내사전투표","대통령선거","전라남도","완도군",530,530,340,13,146,6,16,0,1,1,0,1,0,1,2,527,3,0
"13951","약산면","약산면제1투","대통령선거","전라남도","완도군",937,661,336,9,284,6,8,0,0,2,0,2,1,2,5,655,6,276
"13952","약산면","약산면제2투","대통령선거","전라남도","완도군",509,387,238,10,125,1,2,0,0,0,0,2,1,1,0,380,7,122
"13953","청산면","관내사전투표","대통령선거","전라남도","완도군",343,343,222,14,83,5,7,0,0,3,0,0,0,0,1,335,8,0
"13954","청산면","청산면제1투","대통령선거","전라남도","완도군",1019,649,370,19,222,6,13,0,1,1,0,2,1,2,5,642,7,370
"13955","청산면","청산면제2투","대통령선거","전라남도","완도군",408,296,178,16,86,3,6,0,0,0,1,0,0,1,2,293,3,112
"13956","청산면","청산면제3투","대통령선거","전라남도","완도군",155,122,82,3,30,0,1,0,0,0,0,0,0,0,2,118,4,33
"13957","소안면","관내사전투표","대통령선거","전라남도","완도군",487,487,295,10,152,5,16,0,0,1,0,0,1,0,0,480,7,0
"13958","소안면","소안면제1투","대통령선거","전라남도","완도군",934,652,404,8,205,10,6,0,0,0,0,1,2,1,3,640,12,282
"13959","소안면","소안면제2투","대통령선거","전라남도","완도군",579,421,251,8,141,3,8,0,0,0,0,2,0,0,3,416,5,158
"13960","금당면","관내사전투표","대통령선거","전라남도","완도군",338,338,226,5,96,1,6,0,0,0,0,0,1,1,0,336,2,0
"13961","금당면","금당면투표소","대통령선거","전라남도","완도군",478,307,169,5,112,6,6,0,0,1,0,0,0,0,3,302,5,171
"13962","보길면","관내사전투표","대통령선거","전라남도","완도군",556,556,369,6,141,11,17,0,0,0,0,3,1,1,2,551,5,0
"13963","보길면","보길면제1투","대통령선거","전라남도","완도군",762,524,331,8,164,4,11,0,0,0,0,0,0,0,4,522,2,238
"13964","보길면","보길면제2투","대통령선거","전라남도","완도군",804,602,387,7,169,4,18,0,0,0,0,0,0,1,12,598,4,202
"13965","생일면","관내사전투표","대통령선거","전라남도","완도군",177,177,105,3,57,2,1,0,0,0,0,0,1,0,6,175,2,0
"13966","생일면","생일면투표소","대통령선거","전라남도","완도군",423,278,174,1,92,4,4,0,0,0,0,0,0,0,2,277,1,145
"13967","잘못 투입·구분된 투표지","잘못 투입·구분된 투표지","대통령선거","전라남도","완도군",0,0,0,0,0,0,0,0,0,0,0,0,0,0,0,0,0,0
"13968","거소·선상투표","거소·선상투표","대통령선거","전라남도","해남군",272,257,124,10,86,6,9,1,1,2,1,2,1,0,1,244,13,15
"13969","관외사전투표","관외사전투표","대통령선거","전라남도","해남군",6456,6456,3958,156,1640,224,410,2,0,4,1,12,1,0,5,6413,43,0
"13970","재외투표","재외투표","대통령선거","전라남도","해남군",193,133,90,5,30,3,5,0,0,0,0,0,0,0,0,133,0,60
"13971","해남읍","관내사전투표","대통령선거","전라남도","해남군",4915,4915,2904,100,1509,85,227,3,2,14,2,22,2,1,8,4879,36,0
"13972","해남읍","해남읍제1투","대통령선거","전라남도","해남군",1165,681,346,23,276,9,17,0,0,0,0,0,0,1,3,675,6,484
"13973","해남읍","해남읍제2투","대통령선거","전라남도","해남군",877,548,280,17,227,6,11,0,0,1,0,0,0,0,1,543,5,329
"13974","해남읍","해남읍제3투","대통령선거","전라남도","해남군",1473,961,481,24,400,22,26,0,0,1,0,1,1,0,1,957,4,512
"13975","해남읍","해남읍제4투","대통령선거","전라남도","해남군",2427,1662,925,36,592,28,59,0,0,9,0,6,0,0,0,1655,7,765
"13976","해남읍","해남읍제5투","대통령선거","전라남도","해남군",925,607,328,14,214,13,29,0,0,0,0,3,1,0,0,602,5,318
"13977","해남읍","해남읍제6투","대통령선거","전라남도","해남군",1222,831,444,42,303,14,18,0,0,2,0,5,0,0,1,829,2,391
"13978","해남읍","해남읍제7투","대통령선거","전라남도","해남군",1316,830,392,20,362,20,23,0,0,0,0,3,0,1,1,822,8,486
"13979","해남읍","해남읍제8투","대통령선거","전라남도","해남군",2475,1588,894,23,544,40,75,1,0,2,0,4,1,0,3,1587,1,887
"13980","해남읍","해남읍제9투","대통령선거","전라남도","해남군",872,605,270,14,287,8,14,0,1,0,0,0,2,0,2,598,7,267
"13981","삼산면","관내사전투표","대통령선거","전라남도","해남군",676,676,339,11,278,17,26,0,0,2,0,1,0,0,0,674,2,0
"13982","삼산면","삼산면제1투","대통령선거","전라남도","해남군",1209,755,370,26,317,5,26,0,0,1,1,4,1,0,1,752,3,454
"13983","삼산면","삼산면제2투","대통령선거","전라남도","해남군",715,498,259,13,201,4,8,0,0,0,1,2,1,2,2,493,5,217
"13984","화산면","관내사전투표","대통령선거","전라남도","해남군",709,709,336,27,301,14,21,0,0,1,0,2,2,1,0,705,4,0
"13985","화산면","화산면제1투","대통령선거","전라남도","해남군",891,516,260,14,216,10,5,0,0,2,0,0,0,4,4,515,1,375
"13986","화산면","화산면제2투","대통령선거","전라남도","해남군",620,408,189,6,201,1,6,0,0,0,0,1,0,0,1,405,3,212
"13987","화산면","화산면제3투","대통령선거","전라남도","해남군",747,487,255,10,205,2,10,0,0,0,0,2,0,0,3,487,0,260
"13988","현산면","관내사전투표","대통령선거","전라남도","해남군",570,570,285,10,239,7,20,0,0,2,0,1,1,0,3,568,2,0
"13989","현산면","현산면제1투","대통령선거","전라남도","해남군",669,410,168,10,200,8,14,0,0,0,0,3,0,3,1,407,3,259
"13990","현산면","현산면제2투","대통령선거","전라남도","해남군",545,364,183,8,154,0,7,0,0,0,1,0,2,0,4,359,5,181
"13991","현산면","현산면제3투","대통령선거","전라남도","해남군",871,612,321,20,237,6,10,0,0,1,0,2,1,1,7,606,6,259
"13992","송지면","관내사전투표","대통령선거","전라남도","해남군",1323,1323,708,34,507,21,32,0,0,1,0,5,0,1,4,1313,10,0
"13993","송지면","송지면제1투","대통령선거","전라남도","해남군",1377,778,355,23,352,7,19,2,0,0,0,2,3,1,6,770,8,599
"13994","송지면","송지면제2투","대통령선거","전라남도","해남군",900,612,298,21,262,5,7,0,0,1,0,4,1,1,5,605,7,288
"13995","송지면","송지면제3투","대통령선거","전라남도","해남군",880,569,316,9,221,8,9,0,0,0,0,0,1,0,2,566,3,311
"13996","송지면","송지면제4투","대통령선거","전라남도","해남군",849,574,318,5,222,8,10,0,0,0,0,1,2,1,4,571,3,275
"13997","북평면","관내사전투표","대통령선거","전라남도","해남군",688,688,393,14,232,14,21,0,0,1,0,1,2,0,2,680,8,0
"13998","북평면","북평면제1투","대통령선거","전라남도","해남군",1020,631,323,18,247,12,21,0,0,0,0,2,2,1,0,626,5,389
"13999","북평면","북평면제2투","대통령선거","전라남도","해남군",738,551,318,6,197,2,12,0,0,1,0,3,0,0,3,542,9,187
"14000","북일면","관내사전투표","대통령선거","전라남도","해남군",514,514,301,9,177,4,15,0,0,0,1,0,0,2,2,511,3,0
"14001","북일면","북일면제1투","대통령선거","전라남도","해남군",838,542,294,18,201,5,17,0,0,0,0,0,0,0,3,538,4,296
"14002","북일면","북일면제2투","대통령선거","전라남도","해남군",471,315,189,6,111,1,2,0,0,0,0,0,0,0,0,309,6,156
"14003","옥천면","관내사전투표","대통령선거","전라남도","해남군",886,886,514,20,297,15,25,0,0,0,0,4,2,3,1,881,5,0
"14004","옥천면","옥천면제1투","대통령선거","전라남도","해남군",1150,698,363,22,280,8,16,0,0,0,1,3,0,1,1,695,3,452
"14005","옥천면","옥천면제2투","대통령선거","전라남도","해남군",728,471,227,18,202,2,10,0,0,0,0,2,0,2,2,465,6,257
"14006","계곡면","관내사전투표","대통령선거","전라남도","해남군",467,467,225,4,208,5,18,1,0,0,0,0,0,0,2,463,4,0
"14007","계곡면","계곡면제1투","대통령선거","전라남도","해남군",703,407,198,10,179,6,10,0,0,0,0,0,0,0,1,404,3,296
"14008","계곡면","계곡면제2투","대통령선거","전라남도","해남군",749,542,243,14,262,5,8,1,0,0,0,0,2,0,1,536,6,207
"14009","마산면","관내사전투표","대통령선거","전라남도","해남군",391,391,230,8,129,5,13,0,0,1,1,3,0,1,0,391,0,0
"14010","마산면","마산면제1투","대통령선거","전라남도","해남군",915,604,340,14,224,3,14,0,0,1,1,0,0,0,2,599,5,311
"14011","마산면","마산면제2투","대통령선거","전라남도","해남군",779,546,323,13,193,3,8,0,0,0,0,1,0,0,2,543,3,233
"14012","황산면","관내사전투표","대통령선거","전라남도","해남군",699,699,369,12,279,8,24,0,0,1,0,2,0,0,0,695,4,0
"14013","황산면","황산면제1투","대통령선거","전라남도","해남군",1314,813,418,14,350,5,17,0,0,1,0,0,2,0,0,807,6,501
"14014","황산면","황산면제2투","대통령선거","전라남도","해남군",897,595,305,21,247,5,7,0,1,1,0,0,2,0,3,592,3,302
"14015","황산면","황산면제3투","대통령선거","전라남도","해남군",606,444,221,7,204,2,4,0,0,0,0,1,1,0,1,441,3,162
"14016","황산면","황산면제4투","대통령선거","전라남도","해남군",878,601,286,9,270,7,10,0,0,2,1,4,0,0,6,595,6,277
"14017","산이면","관내사전투표","대통령선거","전라남도","해남군",716,716,376,12,295,7,14,0,0,0,0,2,0,3,1,710,6,0
"14018","산이면","산이면제1투","대통령선거","전라남도","해남군",815,471,251,10,184,5,13,0,0,0,0,4,0,1,1,469,2,344
"14019","산이면","산이면제2투","대통령선거","전라남도","해남군",660,434,205,9,205,3,6,0,0,0,0,1,1,0,1,431,3,226
"14020","산이면","산이면제3투","대통령선거","전라남도","해남군",994,631,310,17,274,5,15,0,0,1,1,0,1,1,3,628,3,363
"14021","문내면","관내사전투표","대통령선거","전라남도","해남군",809,809,392,18,352,10,21,0,0,4,0,3,0,0,3,803,6,0
"14022","문내면","문내면제1투","대통령선거","전라남도","해남군",1484,955,460,27,425,7,21,0,0,0,1,1,1,0,1,944,11,529
"14023","문내면","문내면제2투","대통령선거","전라남도","해남군",592,345,163,9,158,3,8,1,0,0,0,0,0,0,3,345,0,247
"14024","문내면","문내면제3투","대통령선거","전라남도","해남군",673,436,248,17,155,2,10,0,0,0,0,1,0,0,1,434,2,237
"14025","화원면","관내사전투표","대통령선거","전라남도","해남군",916,916,442,21,409,9,19,1,0,1,0,4,1,2,2,911,5,0
"14026","화원면","화원면제1투","대통령선거","전라남도","해남군",916,517,249,14,233,2,12,0,1,0,0,1,0,0,1,513,4,399
"14027","화원면","화원면제2투","대통령선거","전라남도","해남군",563,376,146,7,200,6,6,0,0,0,0,2,0,1,5,373,3,187
"14028","화원면","화원면제3투","대통령선거","전라남도","해남군",732,405,183,9,195,1,11,1,0,0,0,1,1,0,2,404,1,327
"14029","잘못 투입·구분된 투표지","잘못 투입·구분된 투표지","대통령선거","전라남도","해남군",0,0,0,0,0,0,0,0,0,0,0,0,0,0,0,0,0,0
"14030","거소·선상투표","거소·선상투표","대통령선거","전라남도","진도군",171,153,63,4,75,2,4,0,0,0,1,0,0,0,0,149,4,18
"14031","관외사전투표","관외사전투표","대통령선거","전라남도","진도군",2749,2748,1672,76,697,83,189,1,1,1,2,5,1,1,1,2730,18,1
"14032","재외투표","재외투표","대통령선거","전라남도","진도군",158,97,64,3,20,2,8,0,0,0,0,0,0,0,0,97,0,61
"14033","진도읍","관내사전투표","대통령선거","전라남도","진도군",2564,2564,1315,51,998,53,114,0,1,4,0,10,1,1,1,2549,15,0
"14034","진도읍","진도읍제1투","대통령선거","전라남도","진도군",2126,1384,637,25,631,24,42,1,0,1,1,10,2,1,1,1376,8,742
"14035","진도읍","진도읍제2투","대통령선거","전라남도","진도군",2363,1603,776,44,683,20,51,1,2,3,0,5,2,1,2,1590,13,760
"14036","진도읍","진도읍제3투","대통령선거","전라남도","진도군",767,520,202,14,279,1,9,0,0,5,0,1,4,1,2,518,2,247
"14037","군내면","관내사전투표","대통령선거","전라남도","진도군",505,505,267,10,197,7,17,0,0,0,0,3,0,0,3,504,1,0
"14038","군내면","군내면제1투","대통령선거","전라남도","진도군",606,411,173,10,208,5,9,0,0,1,0,0,2,0,0,408,3,195
"14039","군내면","군내면제2투","대통령선거","전라남도","진도군",796,536,246,9,239,11,14,1,0,1,1,4,0,1,4,531,5,260
"14040","군내면","군내면제3투","대통령선거","전라남도","진도군",680,481,242,8,213,3,6,0,0,1,0,0,2,0,4,479,2,199
"14041","고군면","관내사전투표","대통령선거","전라남도","진도군",549,549,229,10,267,10,26,0,0,0,0,3,0,0,1,546,3,0
"14042","고군면","고군면제1투","대통령선거","전라남도","진도군",847,528,244,13,250,4,8,0,0,0,0,0,1,0,3,523,5,319
"14043","고군면","고군면제2투","대통령선거","전라남도","진도군",833,597,219,13,335,6,14,0,0,0,1,0,1,1,2,592,5,236
"14044","고군면","고군면제3투","대통령선거","전라남도","진도군",796,549,283,17,235,2,5,0,0,0,0,0,0,1,2,545,4,247
"14045","의신면","관내사전투표","대통령선거","전라남도","진도군",602,602,267,14,281,10,19,1,0,1,0,2,1,1,3,600,2,0
"14046","의신면","의신면제1투","대통령선거","전라남도","진도군",967,622,272,17,302,5,13,1,0,0,0,0,2,1,4,617,5,345
"14047","의신면","의신면제2투","대통령선거","전라남도","진도군",492,333,163,8,140,4,7,0,0,0,0,0,0,1,4,327,6,159
"14048","의신면","의신면제3투","대통령선거","전라남도","진도군",903,600,239,9,324,3,12,0,1,0,0,0,1,0,4,593,7,303
"14049","임회면","관내사전투표","대통령선거","전라남도","진도군",557,557,288,23,214,9,14,0,0,1,0,1,0,1,2,553,4,0
"14050","임회면","임회면제1투","대통령선거","전라남도","진도군",1057,726,346,28,317,2,14,0,0,1,0,3,0,2,3,716,10,331
"14051","임회면","임회면제2투","대통령선거","전라남도","진도군",654,482,185,12,257,7,7,0,2,0,0,0,1,0,6,477,5,172
"14052","임회면","임회면제3투","대통령선거","전라남도","진도군",736,457,206,6,216,4,12,0,0,1,1,0,0,1,2,449,8,279
"14053","지산면","관내사전투표","대통령선거","전라남도","진도군",416,416,227,7,152,8,14,1,0,2,0,2,0,0,1,414,2,0
"14054","지산면","지산면제1투","대통령선거","전라남도","진도군",995,638,278,22,297,4,16,1,1,1,0,2,3,1,4,630,8,357
"14055","지산면","지산면제2투","대통령선거","전라남도","진도군",839,600,291,17,268,6,8,0,0,0,0,0,1,2,2,595,5,239
"14056","지산면","지산면제3투","대통령선거","전라남도","진도군",592,420,189,11,185,7,12,1,0,0,0,1,2,1,4,413,7,172
"14057","조도면","관내사전투표","대통령선거","전라남도","진도군",318,318,172,6,120,8,8,0,0,0,0,0,0,0,0,314,4,0
"14058","조도면","조도면제1투","대통령선거","전라남도","진도군",1096,657,355,13,238,9,14,0,1,0,1,5,0,2,9,647,10,439
"14059","조도면","조도면제2투","대통령선거","전라남도","진도군",97,47,32,0,15,0,0,0,0,0,0,0,0,0,0,47,0,50
"14060","조도면","조도면제3투","대통령선거","전라남도","진도군",92,65,41,2,17,1,0,1,1,0,0,0,0,0,2,65,0,27
"14061","조도면","조도면제4투","대통령선거","전라남도","진도군",194,136,83,5,39,1,0,0,0,0,0,0,1,1,4,134,2,58
"14062","조도면","조도면제5투","대통령선거","전라남도","진도군",113,62,23,0,37,0,0,0,0,0,0,0,1,0,0,61,1,51
"14063","조도면","조도면제6투","대통령선거","전라남도","진도군",141,57,31,0,24,1,0,0,0,0,0,0,0,0,0,56,1,84
"14064","조도면","조도면제7투","대통령선거","전라남도","진도군",28,17,6,3,8,0,0,0,0,0,0,0,0,0,0,17,0,11
"14065","조도면","조도면제8투","대통령선거","전라남도","진도군",215,152,66,1,77,1,0,0,1,1,0,0,0,0,1,148,4,63
"14066","잘못 투입·구분된 투표지","잘못 투입·구분된 투표지","대통령선거","전라남도","진도군",0,0,0,0,0,0,0,0,0,0,0,0,0,0,0,0,0,0
"14067","거소·선상투표","거소·선상투표","대통령선거","전라남도","영암군",211,195,95,10,44,10,7,0,1,1,2,1,0,0,3,174,21,16
"14068","관외사전투표","관외사전투표","대통령선거","전라남도","영암군",6232,6232,3691,154,1699,202,423,3,1,6,1,16,1,1,3,6201,31,0
"14069","재외투표","재외투표","대통령선거","전라남도","영암군",178,102,65,2,30,0,5,0,0,0,0,0,0,0,0,102,0,76
"14070","영암읍","관내사전투표","대통령선거","전라남도","영암군",2039,2039,1081,31,752,41,112,0,0,0,1,5,4,1,2,2030,9,0
"14071","영암읍","영암읍제1투","대통령선거","전라남도","영암군",1085,656,339,16,277,5,13,0,0,1,0,0,0,1,2,654,2,429
"14072","영암읍","영암읍제2투","대통령선거","전라남도","영암군",966,649,295,16,287,13,34,0,0,0,0,1,0,0,1,647,2,317
"14073","영암읍","영암읍제3투","대통령선거","전라남도","영암군",1006,692,329,16,294,19,24,0,0,1,1,1,1,0,0,686,6,314
"14074","영암읍","영암읍제4투","대통령선거","전라남도","영암군",1253,836,411,25,352,12,27,2,0,0,0,0,0,1,0,830,6,417
"14075","삼호읍","관내사전투표","대통령선거","전라남도","영암군",2654,2654,1463,47,850,63,195,1,0,2,5,12,2,2,1,2643,11,0
"14076","삼호읍","삼호읍제1투","대통령선거","전라남도","영암군",2140,1333,639,23,558,24,78,0,0,4,0,2,1,0,0,1329,4,807
"14077","삼호읍","삼호읍제2투","대통령선거","전라남도","영암군",2161,1328,673,17,514,21,95,0,0,1,0,2,2,1,0,1326,2,833
"14078","삼호읍","삼호읍제3투","대통령선거","전라남도","영암군",921,630,276,20,290,7,23,0,0,0,3,0,1,0,3,623,7,291
"14079","삼호읍","삼호읍제4투","대통령선거","전라남도","영암군",1617,965,522,20,337,23,52,1,0,2,1,1,0,0,1,960,5,652
"14080","삼호읍","삼호읍제5투","대통령선거","전라남도","영암군",1284,734,344,39,298,19,21,2,0,0,0,0,0,1,4,728,6,550
"14081","삼호읍","삼호읍제6투","대통령선거","전라남도","영암군",1369,955,612,26,176,20,116,1,0,2,1,0,0,0,0,954,1,414
"14082","삼호읍","삼호읍제7투","대통령선거","전라남도","영암군",1434,969,582,29,204,23,119,0,1,1,3,2,1,0,0,965,4,465
"14083","덕진면","관내사전투표","대통령선거","전라남도","영암군",368,368,182,7,157,6,13,0,0,0,0,0,0,0,0,365,3,0
"14084","덕진면","덕진면제1투","대통령선거","전라남도","영암군",641,415,196,8,197,1,6,0,0,1,0,0,1,0,0,410,5,226
"14085","덕진면","덕진면제2투","대통령선거","전라남도","영암군",578,418,203,8,186,4,8,0,0,0,0,0,0,2,1,412,6,160
"14086","금정면","관내사전투표","대통령선거","전라남도","영암군",597,597,282,16,273,6,15,0,1,0,0,0,1,1,2,597,0,0
"14087","금정면","금정면투표소","대통령선거","전라남도","영암군",1109,690,307,26,320,7,17,0,1,0,0,3,0,3,3,687,3,419
"14088","신북면","관내사전투표","대통령선거","전라남도","영암군",958,958,512,15,382,8,29,0,2,1,0,1,0,3,1,954,4,0
"14089","신북면","신북면제1투","대통령선거","전라남도","영암군",1079,631,321,14,260,10,17,0,0,0,0,0,1,0,1,624,7,448
"14090","신북면","신북면제2투","대통령선거","전라남도","영암군",693,455,214,9,210,5,7,0,0,0,0,0,1,0,4,450,5,238
"14091","신북면","신북면제3투","대통령선거","전라남도","영암군",553,389,221,8,134,6,12,0,0,0,0,0,1,2,1,385,4,164
"14092","시종면","관내사전투표","대통령선거","전라남도","영암군",941,941,456,17,413,13,25,0,0,1,0,1,1,2,3,932,9,0
"14093","시종면","시종면제1투","대통령선거","전라남도","영암군",1317,728,353,19,313,8,18,0,0,0,2,0,0,3,4,720,8,589
"14094","시종면","시종면제2투","대통령선거","전라남도","영암군",907,555,270,13,248,3,13,0,0,0,0,0,0,2,3,552,3,352
"14095","도포면","관내사전투표","대통령선거","전라남도","영암군",431,431,236,6,159,9,9,0,1,6,0,1,0,0,1,428,3,0
"14096","도포면","도포면제1투","대통령선거","전라남도","영암군",816,546,293,18,204,12,12,0,1,1,0,0,2,0,0,543,3,270
"14097","도포면","도포면제2투","대통령선거","전라남도","영암군",737,492,234,10,220,6,10,0,0,1,0,1,2,1,4,489,3,245
"14098","군서면","관내사전투표","대통령선거","전라남도","영암군",589,589,282,6,259,8,28,0,0,0,0,2,0,0,1,586,3,0
"14099","군서면","군서면제1투","대통령선거","전라남도","영암군",764,486,244,8,214,7,6,0,0,1,0,1,1,0,3,485,1,278
"14100","군서면","군서면제2투","대통령선거","전라남도","영암군",852,652,301,7,307,2,24,0,0,4,1,0,0,0,2,648,4,200
"14101","군서면","군서면제3투","대통령선거","전라남도","영암군",491,377,222,3,130,3,12,0,0,0,0,2,1,0,2,375,2,114
"14102","서호면","관내사전투표","대통령선거","전라남도","영암군",366,366,161,5,178,3,15,0,0,0,0,0,0,0,0,362,4,0
"14103","서호면","서호면투표소","대통령선거","전라남도","영암군",1321,852,366,21,427,4,19,0,0,1,1,3,3,0,1,846,6,469
"14104","학산면","관내사전투표","대통령선거","전라남도","영암군",1037,1037,474,24,462,11,40,0,2,6,0,4,0,1,1,1025,12,0
"14105","학산면","학산면제1투","대통령선거","전라남도","영암군",708,465,220,8,210,4,16,0,0,1,1,0,1,0,2,463,2,243
"14106","학산면","학산면제2투","대통령선거","전라남도","영암군",698,499,238,23,203,8,20,0,0,0,0,0,0,0,1,493,6,199
"14107","학산면","학산면제3투","대통령선거","전라남도","영암군",304,222,121,1,85,2,5,0,0,0,1,0,1,2,3,221,1,82
"14108","미암면","관내사전투표","대통령선거","전라남도","영암군",298,298,147,12,115,6,15,0,0,0,0,0,0,0,1,296,2,0
"14109","미암면","미암면제1투","대통령선거","전라남도","영암군",942,604,304,15,253,8,16,0,0,2,0,0,0,0,4,602,2,338
"14110","미암면","미암면제2투","대통령선거","전라남도","영암군",519,372,222,7,129,2,2,0,0,0,2,0,2,0,3,369,3,147
"14111","잘못 투입·구분된 투표지","잘못 투입·구분된 투표지","대통령선거","전라남도","영암군",0,0,0,0,0,0,0,0,0,0,0,0,0,0,0,0,0,0
"14112","거소·선상투표","거소·선상투표","대통령선거","전라남도","무안군",697,658,298,18,193,22,26,6,3,5,6,5,2,2,10,596,62,39
"14113","관외사전투표","관외사전투표","대통령선거","전라남도","무안군",8689,8686,5123,172,2469,295,566,2,2,3,0,11,1,0,8,8652,34,3
"14114","재외투표","재외투표","대통령선거","전라남도","무안군",247,181,132,4,25,1,16,0,0,2,0,1,0,0,0,181,0,66
"14115","무안읍","관내사전투표","대통령선거","전라남도","무안군",2949,2949,1841,50,848,48,132,1,1,1,0,9,2,0,2,2935,14,0
"14116","무안읍","무안읍제1투","대통령선거","전라남도","무안군",1881,1185,592,25,498,10,47,1,0,1,0,1,0,0,4,1179,6,696
"14117","무안읍","무안읍제2투","대통령선거","전라남도","무안군",1978,1264,703,30,440,23,59,0,0,1,0,0,0,0,0,1256,8,714
"14118","무안읍","무안읍제3투","대통령선거","전라남도","무안군",433,311,162,1,134,3,10,0,0,0,0,0,0,0,0,310,1,122
"14119","무안읍","무안읍제4투","대통령선거","전라남도","무안군",1292,869,490,23,309,8,28,1,0,1,0,1,0,0,2,863,6,423
"14120","일로읍","관내사전투표","대통령선거","전라남도","무안군",1596,1596,798,26,688,18,48,1,0,0,0,0,6,2,5,1592,4,0
"14121","일로읍","일로읍제1투","대통령선거","전라남도","무안군",600,368,156,4,188,5,8,0,0,1,1,0,1,1,0,365,3,232
"14122","일로읍","일로읍제2투","대통령선거","전라남도","무안군",495,338,145,2,174,4,10,0,0,0,0,0,1,0,0,336,2,157
"14123","일로읍","일로읍제3투","대통령선거","전라남도","무안군",1182,720,353,11,318,7,27,0,0,0,0,1,1,0,0,718,2,462
"14124","일로읍","일로읍제4투","대통령선거","전라남도","무안군",329,247,106,9,125,0,4,0,0,0,0,0,2,0,0,246,1,82
"14125","일로읍","일로읍제5투","대통령선거","전라남도","무안군",798,529,264,7,235,2,7,0,0,1,0,1,1,1,6,525,4,269
"14126","일로읍","일로읍제6투","대통령선거","전라남도","무안군",533,339,162,10,156,5,6,0,0,0,0,0,0,0,0,339,0,194
"14127","삼향읍","관내사전투표","대통령선거","전라남도","무안군",5162,5162,3389,48,1265,137,303,4,1,0,0,10,0,3,0,5160,2,0
"14128","삼향읍","삼향읍제1투","대통령선거","전라남도","무안군",632,415,183,9,194,13,11,0,0,0,0,0,0,0,1,411,4,217
"14129","삼향읍","삼향읍제2투","대통령선거","전라남도","무안군",1054,759,381,16,321,8,24,0,0,0,1,0,0,2,2,755,4,295
"14130","삼향읍","삼향읍제3투","대통령선거","전라남도","무안군",1258,701,328,10,328,6,20,0,0,3,1,0,1,0,0,697,4,557
"14131","삼향읍","삼향읍제4투","대통령선거","전라남도","무안군",751,516,263,8,222,6,14,0,0,0,0,0,0,0,1,514,2,235
"14132","삼향읍","삼향읍제5투","대통령선거","전라남도","무안군",2169,1515,977,21,389,34,87,0,0,1,0,4,0,0,2,1515,0,654
"14133","삼향읍","삼향읍제6투","대통령선거","전라남도","무안군",1720,1236,732,14,390,25,72,0,0,0,0,0,0,0,1,1234,2,484
"14134","삼향읍","삼향읍제7투","대통령선거","전라남도","무안군",2288,1590,1011,11,433,36,92,0,0,0,1,2,0,0,2,1588,2,698
"14135","삼향읍","삼향읍제8투","대통령선거","전라남도","무안군",1933,1439,899,26,380,35,89,0,0,0,0,5,1,0,1,1436,3,494
"14136","삼향읍","삼향읍제9투","대통령선거","전라남도","무안군",2555,2053,1373,21,493,36,122,0,1,1,0,1,0,1,2,2051,2,502
"14137","삼향읍","삼향읍제10투","대통령선거","전라남도","무안군",2198,1723,1104,25,443,32,116,0,0,0,0,0,1,0,2,1723,0,475
"14138","몽탄면","관내사전투표","대통령선거","전라남도","무안군",535,535,290,16,191,2,18,0,0,0,1,9,0,1,3,531,4,0
"14139","몽탄면","몽탄면제1투","대통령선거","전라남도","무안군",660,443,211,11,197,2,16,0,0,1,0,1,1,1,2,443,0,217
"14140","몽탄면","몽탄면제2투","대통령선거","전라남도","무안군",431,279,141,9,120,2,3,0,1,0,0,1,0,1,0,278,1,152
"14141","몽탄면","몽탄면제3투","대통령선거","전라남도","무안군",480,308,173,8,104,8,7,0,0,0,0,4,1,0,2,307,1,172
"14142","몽탄면","몽탄면제4투","대통령선거","전라남도","무안군",453,334,164,10,149,2,3,0,1,1,0,0,1,0,2,333,1,119
"14143","청계면","관내사전투표","대통령선거","전라남도","무안군",1233,1233,665,30,452,21,41,0,0,2,0,1,1,2,6,1221,12,0
"14144","청계면","청계면제1투","대통령선거","전라남도","무안군",593,415,192,10,193,7,8,0,0,0,0,0,0,0,1,411,4,178
"14145","청계면","청계면제2투","대통령선거","전라남도","무안군",1137,692,373,18,260,6,33,0,0,0,0,1,0,0,0,691,1,445
"14146","청계면","청계면제3투","대통령선거","전라남도","무안군",738,546,224,10,275,7,17,0,0,0,0,0,3,1,3,540,6,192
"14147","청계면","청계면제4투","대통령선거","전라남도","무안군",682,481,212,7,236,3,15,0,0,0,1,0,1,0,3,478,3,201
"14148","청계면","청계면제5투","대통령선거","전라남도","무안군",830,553,267,18,242,8,10,0,0,0,0,1,3,1,1,551,2,277
"14149","현경면","관내사전투표","대통령선거","전라남도","무안군",587,587,323,11,217,8,20,0,0,0,0,3,0,1,0,583,4,0
"14150","현경면","현경면제1투","대통령선거","전라남도","무안군",367,251,120,1,119,5,2,0,0,1,0,0,2,0,0,250,1,116
"14151","현경면","현경면제2투","대통령선거","전라남도","무안군",1052,682,383,19,255,1,15,0,0,1,0,1,1,0,2,678,4,370
"14152","현경면","현경면제3투","대통령선거","전라남도","무안군",717,498,237,28,202,2,17,0,1,1,1,1,0,0,2,492,6,219
"14153","현경면","현경면제4투","대통령선거","전라남도","무안군",696,482,193,11,251,4,11,0,0,3,0,0,0,1,2,476,6,214
"14154","현경면","현경면제5투","대통령선거","전라남도","무안군",577,399,156,8,210,2,11,0,0,3,0,4,3,1,0,398,1,178
"14155","망운면","관내사전투표","대통령선거","전라남도","무안군",338,338,174,9,129,4,19,0,0,0,0,0,1,1,0,337,1,0
"14156","망운면","망운면제1투","대통령선거","전라남도","무안군",1036,708,367,18,303,5,10,1,0,0,0,0,1,0,0,705,3,328
"14157","망운면","망운면제2투","대통령선거","전라남도","무안군",410,280,157,7,106,1,3,0,0,0,0,0,1,0,3,278,2,130
"14158","해제면","관내사전투표","대통령선거","전라남도","무안군",1405,1404,760,32,538,11,37,0,3,0,1,4,2,3,6,1397,7,1
"14159","해제면","해제면제1투","대통령선거","전라남도","무안군",767,433,209,11,190,5,9,0,1,0,0,1,1,1,4,432,1,334
"14160","해제면","해제면제2투","대통령선거","전라남도","무안군",1077,669,324,26,278,8,24,1,0,1,1,0,1,0,2,666,3,408
"14161","해제면","해제면제3투","대통령선거","전라남도","무안군",531,337,180,8,135,3,5,0,0,1,0,1,0,1,1,335,2,194
"14162","해제면","해제면제4투","대통령선거","전라남도","무안군",735,440,197,7,209,5,14,0,0,1,0,0,1,1,2,437,3,295
"14163","운남면","관내사전투표","대통령선거","전라남도","무안군",419,419,226,10,152,9,18,0,0,0,0,0,0,0,2,417,2,0
"14164","운남면","운남면제1투","대통령선거","전라남도","무안군",636,440,216,6,198,6,8,0,0,0,0,0,0,1,3,438,2,196
"14165","운남면","운남면제2투","대통령선거","전라남도","무안군",1104,737,294,20,381,10,22,0,0,1,0,0,1,0,5,734,3,367
"14166","운남면","운남면제3투","대통령선거","전라남도","무안군",352,244,123,3,102,3,6,0,0,0,1,1,1,0,1,241,3,108
"14167","잘못 투입·구분된 투표지","잘못 투입·구분된 투표지","대통령선거","전라남도","무안군",0,0,0,0,0,0,0,0,0,0,0,0,0,0,0,0,0,0
"14168","거소·선상투표","거소·선상투표","대통령선거","전라남도","영광군",199,183,91,4,62,5,4,2,2,0,0,0,0,0,3,173,10,16
"14169","관외사전투표","관외사전투표","대통령선거","전라남도","영광군",5391,5389,3459,131,1222,208,318,1,0,7,2,15,2,1,7,5373,16,2
"14170","재외투표","재외투표","대통령선거","전라남도","영광군",144,112,79,2,16,6,9,0,0,0,0,0,0,0,0,112,0,32
"14171","영광읍","관내사전투표","대통령선거","전라남도","영광군",4218,4218,2540,66,1287,87,189,0,0,9,1,18,0,1,6,4204,14,0
"14172","영광읍","영광읍제1투","대통령선거","전라남도","영광군",1381,772,425,13,281,11,36,0,0,0,0,1,0,0,2,769,3,609
"14173","영광읍","영광읍제2투","대통령선거","전라남도","영광군",1743,1168,641,47,401,25,45,0,0,2,0,2,0,1,1,1165,3,575
"14174","영광읍","영광읍제3투","대통령선거","전라남도","영광군",1742,1114,572,29,433,19,38,0,2,4,1,5,0,2,2,1107,7,628
"14175","영광읍","영광읍제4투","대통령선거","전라남도","영광군",1879,1129,634,27,388,27,32,1,2,1,0,10,0,0,2,1124,5,750
"14176","영광읍","영광읍제5투","대통령선거","전라남도","영광군",814,511,283,6,194,2,18,0,1,0,0,0,1,1,3,509,2,303
"14177","영광읍","영광읍제6투","대통령선거","전라남도","영광군",312,215,100,2,93,2,9,0,0,2,0,3,1,0,1,213,2,97
"14178","영광읍","영광읍제7투","대통령선거","전라남도","영광군",451,318,156,6,135,3,10,0,0,2,0,2,1,0,1,316,2,133
"14179","영광읍","영광읍제8투","대통령선거","전라남도","영광군",1942,1289,774,35,381,17,67,0,0,4,0,3,0,0,4,1285,4,653
"14180","영광읍","영광읍제9투","대통령선거","전라남도","영광군",1056,713,353,17,283,17,27,0,0,1,0,9,2,0,1,710,3,343
"14181","백수읍","관내사전투표","대통령선거","전라남도","영광군",767,767,464,16,235,9,24,0,1,2,0,9,1,0,2,763,4,0
"14182","백수읍","백수읍제1투","대통령선거","전라남도","영광군",625,393,193,12,152,4,8,0,0,2,0,13,2,2,1,389,4,232
"14183","백수읍","백수읍제2투","대통령선거","전라남도","영광군",1053,687,356,16,266,8,20,0,0,0,0,3,4,0,10,683,4,366
"14184","백수읍","백수읍제3투","대통령선거","전라남도","영광군",839,567,297,7,221,9,16,0,0,0,0,6,2,3,3,564,3,272
"14185","백수읍","백수읍제4투","대통령선거","전라남도","영광군",702,452,258,7,157,5,7,0,0,0,0,9,0,0,5,448,4,250
"14186","홍농읍","관내사전투표","대통령선거","전라남도","영광군",1557,1557,983,35,388,27,64,1,2,1,0,43,0,1,4,1549,8,0
"14187","홍농읍","홍농읍제1투","대통령선거","전라남도","영광군",927,546,304,18,182,10,16,2,0,0,0,9,0,0,2,543,3,381
"14188","홍농읍","홍농읍제2투","대통령선거","전라남도","영광군",306,211,114,2,79,2,4,0,0,0,0,5,0,2,1,209,2,95
"14189","홍농읍","홍농읍제3투","대통령선거","전라남도","영광군",413,280,174,10,81,3,2,0,0,0,0,5,0,0,5,280,0,133
"14190","홍농읍","홍농읍제4투","대통령선거","전라남도","영광군",695,450,234,17,173,2,11,0,0,0,1,6,0,0,4,448,2,245
"14191","홍농읍","홍농읍제5투","대통령선거","전라남도","영광군",1226,894,611,13,191,29,34,0,0,0,0,9,0,0,3,890,4,332
"14192","대마면","관내사전투표","대통령선거","전라남도","영광군",281,281,162,7,98,2,9,0,0,0,0,3,0,0,0,281,0,0
"14193","대마면","대마면제1투","대통령선거","전라남도","영광군",722,478,217,14,189,6,11,0,0,2,2,24,2,0,4,471,7,244
"14194","대마면","대마면제2투","대통령선거","전라남도","영광군",363,250,145,2,78,5,4,0,0,1,0,12,0,0,2,249,1,113
"14195","묘량면","관내사전투표","대통령선거","전라남도","영광군",362,362,211,5,124,4,10,0,2,1,0,2,0,1,1,361,1,0
"14196","묘량면","묘량면제1투","대통령선거","전라남도","영광군",609,401,192,20,160,4,13,0,0,2,0,1,0,1,7,400,1,208
"14197","묘량면","묘량면제2투","대통령선거","전라남도","영광군",463,305,149,10,117,7,6,1,1,2,1,0,2,1,6,303,2,158
"14198","불갑면","관내사전투표","대통령선거","전라남도","영광군",351,351,175,7,145,5,11,0,1,0,0,2,1,1,2,350,1,0
"14199","불갑면","불갑면제1투","대통령선거","전라남도","영광군",514,354,170,13,146,4,11,0,0,1,0,0,1,0,3,349,5,160
"14200","불갑면","불갑면제2투","대통령선거","전라남도","영광군",234,161,82,7,60,1,3,0,0,0,0,3,1,1,0,158,3,73
"14201","군서면","관내사전투표","대통령선거","전라남도","영광군",444,444,243,11,146,12,21,0,2,1,0,2,0,0,2,440,4,0
"14202","군서면","군서면제1투","대통령선거","전라남도","영광군",762,496,277,10,183,2,10,0,0,0,1,3,3,0,4,493,3,266
"14203","군서면","군서면제2투","대통령선거","전라남도","영광군",771,524,282,11,182,9,15,0,1,2,0,7,2,2,5,518,6,247
"14204","군남면","관내사전투표","대통령선거","전라남도","영광군",457,457,250,6,167,11,16,0,1,0,0,0,0,0,3,454,3,0
"14205","군남면","군남면제1투","대통령선거","전라남도","영광군",753,480,265,11,176,3,15,1,0,2,0,1,1,0,4,479,1,273
"14206","군남면","군남면제2투","대통령선거","전라남도","영광군",356,257,155,4,83,1,4,1,1,1,0,1,1,2,2,256,1,99
"14207","군남면","군남면제3투","대통령선거","전라남도","영광군",555,399,230,8,140,5,8,0,0,0,1,0,0,1,2,395,4,156
"14208","염산면","관내사전투표","대통령선거","전라남도","영광군",850,850,480,9,316,8,20,0,1,2,0,6,1,0,3,846,4,0
"14209","염산면","염산면제1투","대통령선거","전라남도","영광군",1097,665,352,30,254,9,9,1,0,1,0,1,0,1,1,659,6,432
"14210","염산면","염산면제2투","대통령선거","전라남도","영광군",631,440,231,12,164,2,8,1,0,1,0,10,0,0,7,436,4,191
"14211","염산면","염산면제3투","대통령선거","전라남도","영광군",492,317,190,10,97,0,6,0,0,0,0,4,2,1,3,313,4,175
"14212","염산면","염산면제4투","대통령선거","전라남도","영광군",523,340,153,5,156,5,6,1,0,1,0,1,3,0,5,336,4,183
"14213","법성면","관내사전투표","대통령선거","전라남도","영광군",799,799,442,11,304,9,20,0,0,0,0,3,1,1,5,796,3,0
"14214","법성면","법성면제1투","대통령선거","전라남도","영광군",1576,955,530,11,351,20,29,0,0,0,1,0,0,1,2,945,10,621
"14215","법성면","법성면제2투","대통령선거","전라남도","영광군",517,331,189,9,115,4,5,0,0,0,0,1,0,0,5,328,3,186
"14216","법성면","법성면제3투","대통령선거","전라남도","영광군",469,326,176,11,120,2,6,0,0,0,0,5,1,0,3,324,2,143
"14217","법성면","법성면제4투","대통령선거","전라남도","영광군",696,458,257,8,164,2,14,0,0,0,0,3,0,0,2,450,8,238
"14218","법성면","법성면제5투","대통령선거","전라남도","영광군",419,281,155,12,82,6,14,2,0,0,0,2,1,0,5,279,2,138
"14219","낙월면","관내사전투표","대통령선거","전라남도","영광군",65,65,49,1,9,0,4,1,0,0,0,0,0,0,1,65,0,0
"14220","낙월면","낙월면제1투","대통령선거","전라남도","영광군",160,23,12,1,7,0,2,0,0,0,0,0,0,0,0,22,1,137
"14221","낙월면","낙월면제2투","대통령선거","전라남도","영광군",76,45,23,1,18,1,1,0,0,0,0,0,0,0,0,44,1,31
"14222","낙월면","낙월면제3투","대통령선거","전라남도","영광군",135,89,56,4,23,0,1,0,0,0,0,0,0,2,3,89,0,46
"14223","잘못 투입·구분된 투표지","잘못 투입·구분된 투표지","대통령선거","전라남도","영광군",0,0,0,0,0,0,0,0,0,0,0,0,0,0,0,0,0,0
"14224","거소·선상투표","거소·선상투표","대통령선거","전라남도","함평군",188,171,79,7,51,5,4,3,3,1,1,0,1,2,3,160,11,17
"14225","관외사전투표","관외사전투표","대통령선거","전라남도","함평군",3787,3787,2326,89,1025,110,203,1,1,0,1,6,0,3,2,3767,20,0
"14226","재외투표","재외투표","대통령선거","전라남도","함평군",140,102,67,5,20,1,7,0,0,0,1,1,0,0,0,102,0,38
"14227","함평읍","관내사전투표","대통령선거","전라남도","함평군",2059,2059,1252,40,609,43,99,0,1,1,1,4,0,0,2,2052,7,0
"14228","함평읍","함평읍제1투","대통령선거","전라남도","함평군",968,617,331,16,244,4,16,0,0,0,1,2,0,0,1,615,2,351
"14229","함평읍","함평읍제2투","대통령선거","전라남도","함평군",974,609,351,21,205,7,14,0,0,0,0,0,0,1,7,606,3,365
"14230","함평읍","함평읍제3투","대통령선거","전라남도","함평군",505,332,169,5,137,4,10,0,0,0,0,0,0,1,0,326,6,173
"14231","함평읍","함평읍제4투","대통령선거","전라남도","함평군",1569,1016,607,16,329,17,40,0,0,1,0,4,1,0,1,1016,0,553
"14232","함평읍","함평읍제5투","대통령선거","전라남도","함평군",807,519,286,14,192,6,13,0,0,0,0,0,0,1,2,514,5,288
"14233","손불면","관내사전투표","대통령선거","전라남도","함평군",552,552,296,9,210,8,16,0,0,0,0,0,2,2,2,545,7,0
"14234","손불면","손불면제1투","대통령선거","전라남도","함평군",1408,869,467,13,340,12,20,1,0,0,1,2,0,0,6,862,7,539
"14235","손불면","손불면제2투","대통령선거","전라남도","함평군",876,555,325,19,180,6,8,1,0,0,0,0,1,0,8,548,7,321
"14236","신광면","관내사전투표","대통령선거","전라남도","함평군",301,301,190,6,87,2,9,0,0,0,0,1,0,0,1,296,5,0
"14237","신광면","신광면제1투","대통령선거","전라남도","함평군",888,598,322,11,226,5,16,0,0,0,0,2,4,1,5,592,6,290
"14238","신광면","신광면제2투","대통령선거","전라남도","함평군",284,210,129,1,63,0,10,0,0,0,0,0,0,0,4,207,3,74
"14239","학교면","관내사전투표","대통령선거","전라남도","함평군",535,535,320,7,181,5,9,0,0,1,0,1,1,0,2,527,8,0
"14240","학교면","학교면제1투","대통령선거","전라남도","함평군",785,514,312,6,176,4,8,1,0,0,1,0,3,0,1,512,2,271
"14241","학교면","학교면제2투","대통령선거","전라남도","함평군",442,326,194,5,121,0,1,0,1,0,0,0,0,0,3,325,1,116
"14242","학교면","학교면제3투","대통령선거","전라남도","함평군",234,163,83,4,64,1,6,0,0,1,0,0,0,0,3,162,1,71
"14243","학교면","학교면제4투","대통령선거","전라남도","함평군",1255,806,455,6,305,9,21,1,0,1,2,1,1,0,1,803,3,449
"14244","엄다면","관내사전투표","대통령선거","전라남도","함평군",315,315,172,4,120,6,8,0,0,1,0,1,0,1,0,313,2,0
"14245","엄다면","엄다면투표소","대통령선거","전라남도","함평군",1303,904,497,19,329,15,25,0,0,2,1,0,2,1,6,897,7,399
"14246","대동면","관내사전투표","대통령선거","전라남도","함평군",538,538,293,17,189,8,28,1,0,0,0,1,0,0,0,537,1,0
"14247","대동면","대동면제1투","대통령선거","전라남도","함평군",1123,771,446,24,261,9,18,2,0,1,0,1,1,0,3,766,5,352
"14248","대동면","대동면제2투","대통령선거","전라남도","함평군",727,511,285,13,194,2,8,0,0,0,0,0,1,2,0,505,6,216
"14249","나산면","관내사전투표","대통령선거","전라남도","함평군",645,645,318,17,261,9,24,0,0,2,0,2,3,3,1,640,5,0
"14250","나산면","나산면제1투","대통령선거","전라남도","함평군",1228,775,427,21,286,10,16,0,0,0,0,2,1,0,5,768,7,453
"14251","나산면","나산면제2투","대통령선거","전라남도","함평군",390,275,156,2,107,1,4,0,0,0,0,0,0,0,3,273,2,115
"14252","해보면","관내사전투표","대통령선거","전라남도","함평군",618,618,393,6,178,7,26,0,0,0,0,0,0,0,2,612,6,0
"14253","해보면","해보면제1투","대통령선거","전라남도","함평군",828,470,260,6,166,9,25,0,0,0,0,1,0,1,0,468,2,358
"14254","해보면","해보면제2투","대통령선거","전라남도","함평군",981,682,418,12,226,7,10,0,0,0,0,2,0,1,5,681,1,299
"14255","월야면","관내사전투표","대통령선거","전라남도","함평군",718,718,426,9,232,12,31,0,0,0,0,1,0,0,1,712,6,0
"14256","월야면","월야면제1투","대통령선거","전라남도","함평군",1013,639,395,8,205,8,14,0,1,0,0,1,0,1,4,637,2,374
"14257","월야면","월야면제2투","대통령선거","전라남도","함평군",362,258,144,8,96,1,4,0,0,0,0,2,1,0,1,257,1,104
"14258","월야면","월야면제3투","대통령선거","전라남도","함평군",881,608,348,5,216,6,17,0,0,0,0,1,1,1,2,597,11,273
"14259","잘못 투입·구분된 투표지","잘못 투입·구분된 투표지","대통령선거","전라남도","함평군",0,0,0,0,0,0,0,0,0,0,0,0,0,0,0,0,0,0
"14260","거소·선상투표","거소·선상투표","대통령선거","전라남도","신안군",243,228,105,5,98,2,3,0,0,0,0,1,0,1,0,215,13,15
"14261","관외사전투표","관외사전투표","대통령선거","전라남도","신안군",6866,6866,3847,178,2192,196,386,5,1,12,3,7,1,2,10,6840,26,0
"14262","재외투표","재외투표","대통령선거","전라남도","신안군",139,82,57,1,13,2,9,0,0,0,0,0,0,0,0,82,0,57
"14263","지도읍","관내사전투표","대통령선거","전라남도","신안군",822,822,406,22,353,9,17,0,1,2,0,0,3,3,1,817,5,0
"14264","지도읍","지도읍제1투","대통령선거","전라남도","신안군",1538,934,475,26,390,14,19,0,1,0,0,0,1,0,3,929,5,604
"14265","지도읍","지도읍제2투","대통령선거","전라남도","신안군",80,47,19,3,25,0,0,0,0,0,0,0,0,0,0,47,0,33
"14266","지도읍","지도읍제3투","대통령선거","전라남도","신안군",572,366,175,14,161,2,4,0,0,0,0,0,0,2,4,362,4,206
"14267","지도읍","지도읍제4투","대통령선거","전라남도","신안군",555,340,137,14,168,5,8,0,0,0,2,0,0,1,2,337,3,215
"14268","지도읍","지도읍제5투","대통령선거","전라남도","신안군",189,132,48,5,72,1,2,0,0,0,0,0,0,0,2,130,2,57
"14269","증도면","관내사전투표","대통령선거","전라남도","신안군",248,248,133,5,97,3,5,0,0,0,0,0,0,0,1,244,4,0
"14270","증도면","증도면제1투","대통령선거","전라남도","신안군",486,296,152,8,122,4,9,0,0,0,0,0,0,0,0,295,1,190
"14271","증도면","증도면제2투","대통령선거","전라남도","신안군",554,389,172,9,191,3,10,0,0,0,0,0,1,0,1,387,2,165
"14272","증도면","증도면제3투","대통령선거","전라남도","신안군",248,168,75,3,83,1,2,0,0,0,0,0,0,0,2,166,2,80
"14273","임자면","관내사전투표","대통령선거","전라남도","신안군",460,460,237,9,193,5,12,0,1,1,0,0,0,0,1,459,1,0
"14274","임자면","임자면제1투","대통령선거","전라남도","신안군",1290,776,404,27,307,10,11,0,1,0,0,2,1,4,4,771,5,514
"14275","임자면","임자면제2투","대통령선거","전라남도","신안군",346,234,129,0,97,1,2,0,0,1,0,0,0,0,3,233,1,112
"14276","임자면","임자면제3투","대통령선거","전라남도","신안군",79,39,21,1,15,0,0,0,0,0,0,0,1,0,0,38,1,40
"14277","임자면","임자면제4투","대통령선거","전라남도","신안군",302,185,102,2,70,0,2,1,0,0,0,0,0,0,6,183,2,117
"14278","자은면","관내사전투표","대통령선거","전라남도","신안군",337,337,165,10,134,3,19,0,1,0,0,0,3,0,1,336,1,0
"14279","자은면","자은면제1투","대통령선거","전라남도","신안군",1042,646,274,30,308,11,14,0,0,0,0,0,4,0,2,643,3,396
"14280","자은면","자은면제2투","대통령선거","전라남도","신안군",442,313,196,2,103,0,7,0,0,0,0,0,0,2,2,312,1,129
"14281","비금면","관내사전투표","대통령선거","전라남도","신안군",507,507,290,1,188,7,17,0,0,1,0,0,1,0,0,505,2,0
"14282","비금면","비금면제1투","대통령선거","전라남도","신안군",984,616,320,13,255,11,8,0,0,0,0,0,0,0,5,612,4,368
"14283","비금면","비금면제2투","대통령선거","전라남도","신안군",625,433,165,12,244,1,2,0,1,0,0,0,1,0,2,428,5,192
"14284","비금면","비금면제3투","대통령선거","전라남도","신안군",579,374,191,6,158,7,5,0,0,0,0,0,2,0,3,372,2,205
"14285","비금면","비금면제4투","대통령선거","전라남도","신안군",80,57,17,1,32,1,4,0,0,0,0,0,1,0,1,57,0,23
"14286","도초면","관내사전투표","대통령선거","전라남도","신안군",490,490,234,9,214,11,10,0,0,0,0,2,0,0,2,482,8,0
"14287","도초면","도초면제1투","대통령선거","전라남도","신안군",987,624,284,17,294,5,13,0,0,0,1,1,1,0,6,622,2,363
"14288","도초면","도초면제2투","대통령선거","전라남도","신안군",532,341,166,6,153,4,6,0,0,0,1,0,0,1,3,340,1,191
"14289","도초면","도초면제3투","대통령선거","전라남도","신안군",131,65,37,4,19,0,1,0,0,0,0,0,1,0,2,64,1,66
"14290","흑산면","관내사전투표","대통령선거","전라남도","신안군",498,498,259,17,182,11,15,1,0,2,0,1,2,0,4,494,4,0
"14291","흑산면","흑산면제1투","대통령선거","전라남도","신안군",824,363,196,9,139,7,6,1,0,0,0,0,1,0,1,360,3,461
"14292","흑산면","흑산면제2투","대통령선거","전라남도","신안군",148,92,51,2,31,1,1,0,0,0,0,0,0,0,4,90,2,56
"14293","흑산면","흑산면제3투","대통령선거","전라남도","신안군",224,120,58,1,52,2,3,0,0,0,0,2,0,0,0,118,2,104
"14294","흑산면","흑산면제4투","대통령선거","전라남도","신안군",170,116,56,2,54,0,0,1,0,0,0,0,1,0,1,115,1,54
"14295","흑산면","흑산면제5투","대통령선거","전라남도","신안군",362,214,145,2,59,0,4,0,1,0,0,0,0,0,2,213,1,148
"14296","흑산면","흑산면제6투","대통령선거","전라남도","신안군",134,69,31,0,27,1,3,0,1,0,0,1,0,0,1,65,4,65
"14297","흑산면","흑산면제7투","대통령선거","전라남도","신안군",349,194,118,10,46,6,7,0,0,0,1,1,0,0,4,193,1,155
"14298","흑산면","흑산면제8투","대통령선거","전라남도","신안군",43,32,17,2,9,0,1,0,0,0,0,1,0,0,1,31,1,11
"14299","흑산면","흑산면제9투","대통령선거","전라남도","신안군",63,41,15,1,22,0,1,0,0,0,1,0,0,1,0,41,0,22
"14300","하의면","관내사전투표","대통령선거","전라남도","신안군",244,244,106,5,115,5,8,0,2,2,0,0,0,0,0,243,1,0
"14301","하의면","하의면제1투","대통령선거","전라남도","신안군",541,347,152,3,174,3,7,0,0,0,0,1,0,1,4,345,2,194
"14302","하의면","하의면제2투","대통령선거","전라남도","신안군",499,305,121,10,156,2,5,0,0,3,0,0,2,0,3,302,3,194
"14303","하의면","하의면제3투","대통령선거","전라남도","신안군",90,75,22,0,51,0,2,0,0,0,0,0,0,0,0,75,0,15
"14304","신의면","관내사전투표","대통령선거","전라남도","신안군",263,263,128,7,102,7,14,1,0,1,0,0,0,1,0,261,2,0
"14305","신의면","신의면투표소","대통령선거","전라남도","신안군",926,551,242,15,248,10,19,0,0,1,0,1,2,4,2,544,7,375
"14306","장산면","관내사전투표","대통령선거","전라남도","신안군",259,259,120,6,119,1,10,1,0,0,0,0,0,1,1,259,0,0
"14307","장산면","장산면제1투","대통령선거","전라남도","신안군",588,406,166,10,207,4,10,1,0,0,0,0,1,0,1,400,6,182
"14308","장산면","장산면제2투","대통령선거","전라남도","신안군",422,253,112,13,115,2,7,0,0,0,0,0,0,1,2,252,1,169
"14309","안좌면","관내사전투표","대통령선거","전라남도","신안군",364,364,153,6,172,1,24,0,0,1,0,1,2,0,1,361,3,0
"14310","안좌면","안좌면제1투","대통령선거","전라남도","신안군",917,581,244,17,292,6,13,0,0,1,0,0,1,0,2,576,5,336
"14311","안좌면","안좌면제2투","대통령선거","전라남도","신안군",204,139,90,4,42,1,0,0,0,1,0,0,0,0,1,139,0,65
"14312","안좌면","안좌면제3투","대통령선거","전라남도","신안군",572,388,184,7,179,4,7,0,0,0,0,0,0,1,3,385,3,184
"14313","안좌면","안좌면제4투","대통령선거","전라남도","신안군",359,255,87,8,150,2,1,0,0,0,0,1,0,0,4,253,2,104
"14314","팔금면","관내사전투표","대통령선거","전라남도","신안군",175,175,87,2,70,3,8,0,0,0,1,0,1,1,1,174,1,0
"14315","팔금면","팔금면투표소","대통령선거","전라남도","신안군",678,440,202,10,209,4,6,0,0,1,0,1,2,1,2,438,2,238
"14316","암태면","관내사전투표","대통령선거","전라남도","신안군",445,445,200,11,197,6,19,0,1,0,0,0,3,3,3,443,2,0
"14317","암태면","암태면제1투","대통령선거","전라남도","신안군",774,460,214,6,214,6,13,0,0,0,0,0,0,0,3,456,4,314
"14318","암태면","암태면제2투","대통령선거","전라남도","신안군",238,162,76,2,77,1,3,0,0,0,0,0,0,0,0,159,3,76
"14319","암태면","암태면제3투","대통령선거","전라남도","신안군",127,92,43,0,47,0,0,0,0,0,0,0,1,0,0,91,1,35
"14320","압해읍","관내사전투표","대통령선거","전라남도","신안군",970,970,475,25,408,19,22,0,0,0,3,3,1,1,3,960,10,0
"14321","압해읍","압해읍제1투","대통령선거","전라남도","신안군",1066,641,295,19,291,10,11,0,2,0,0,3,1,0,1,633,8,425
"14322","압해읍","압해읍제2투","대통령선거","전라남도","신안군",620,389,177,9,187,1,9,0,0,3,0,0,0,0,1,387,2,231
"14323","압해읍","압해읍제3투","대통령선거","전라남도","신안군",945,639,278,9,335,2,5,0,2,1,0,0,0,1,1,634,5,306
"14324","압해읍","압해읍제4투","대통령선거","전라남도","신안군",1091,714,298,15,366,12,16,1,0,0,0,0,1,0,2,711,3,377
"14325","압해읍","압해읍제5투","대통령선거","전라남도","신안군",173,128,65,4,56,0,2,0,0,0,0,0,0,1,0,128,0,45
"14326","압해읍","압해읍제6투","대통령선거","전라남도","신안군",187,111,54,1,51,0,1,0,0,0,0,0,0,0,3,110,1,76
"14327","잘못 투입·구분된 투표지","잘못 투입·구분된 투표지","대통령선거","전라남도","신안군",0,0,0,0,0,0,0,0,0,0,0,0,0,0,0,0,0,0
"14328","거소·선상투표","거소·선상투표","대통령선거","강원도","춘천시",647,620,185,128,188,37,28,7,3,2,1,5,3,1,3,591,29,27
"14329","관외사전투표","관외사전투표","대통령선거","강원도","춘천시",15294,15287,7091,2188,2993,1390,1419,20,4,9,7,9,3,8,31,15172,115,7
"14330","재외투표","재외투표","대통령선거","강원도","춘천시",1226,965,588,86,119,33,133,2,0,0,0,1,0,0,0,962,3,261
"14331","신북읍","관내사전투표","대통령선거","강원도","춘천시",1496,1496,589,346,323,100,102,3,1,2,0,2,0,2,3,1473,23,0
"14332","신북읍","신북읍제1투","대통령선거","강원도","춘천시",1384,927,233,332,234,63,54,1,0,1,1,0,0,1,2,922,5,457
"14333","신북읍","신북읍제2투","대통령선거","강원도","춘천시",2206,1478,444,490,334,95,90,4,0,1,0,1,3,2,5,1469,9,728
"14334","신북읍","신북읍제3투","대통령선거","강원도","춘천시",1217,836,207,315,201,51,51,0,0,0,0,0,2,1,1,829,7,381
"14335","신북읍","신북읍제4투","대통령선거","강원도","춘천시",801,522,115,215,137,19,23,0,0,3,0,1,1,2,1,517,5,279
"14336","동면","관내사전투표","대통령선거","강원도","춘천시",1298,1297,570,238,278,89,109,6,0,2,0,0,0,3,1,1296,1,1
"14337","동면","동면제1투","대통령선거","강원도","춘천시",2722,2138,883,441,515,162,131,1,0,1,0,0,0,0,0,2134,4,584
"14338","동면","동면제2투","대통령선거","강원도","춘천시",1106,684,171,247,196,35,26,1,0,0,2,2,0,1,0,681,3,422
"14339","동면","동면제3투","대통령선거","강원도","춘천시",229,143,22,73,36,4,1,1,0,0,1,1,2,0,0,141,2,86
"14340","동면","동면제4투","대통령선거","강원도","춘천시",3186,2269,877,511,542,153,163,4,0,1,1,0,0,2,3,2257,12,917
"14341","동면","동면제5투","대통령선거","강원도","춘천시",3656,2650,986,618,655,194,178,2,0,0,1,0,1,0,3,2638,12,1006
"14342","동산면","관내사전투표","대통령선거","강원도","춘천시",198,198,79,63,27,11,17,0,0,0,1,0,0,0,0,198,0,0
"14343","동산면","동산면제1투","대통령선거","강원도","춘천시",636,420,74,198,109,20,10,3,0,2,0,0,0,2,0,418,2,216
"14344","동산면","동산면제2투","대통령선거","강원도","춘천시",450,312,82,108,80,19,15,0,0,1,0,1,1,2,0,309,3,138
"14345","신동면","관내사전투표","대통령선거","강원도","춘천시",653,653,240,154,145,48,55,2,1,0,1,0,1,0,1,648,5,0
"14346","신동면","신동면투표소","대통령선거","강원도","춘천시",1765,1167,279,446,284,62,70,2,2,2,0,0,0,0,3,1150,17,598
"14347","동내면","관내사전투표","대통령선거","강원도","춘천시",1960,1960,887,412,357,133,148,5,2,1,3,2,0,1,4,1955,5,0
"14348","동내면","동내면제1투","대통령선거","강원도","춘천시",2717,1756,615,515,396,109,104,0,0,2,0,2,0,0,1,1744,12,961
"14349","동내면","동내면제2투","대통령선거","강원도","춘천시",2093,1408,391,482,343,77,97,3,1,1,1,0,1,1,0,1398,10,685
"14350","동내면","동내면제3투","대통령선거","강원도","춘천시",3060,2232,898,487,485,172,176,4,0,0,1,1,1,0,1,2226,6,828
"14351","동내면","동내면제4투","대통령선거","강원도","춘천시",1890,1399,581,305,301,97,105,1,0,2,1,0,2,0,1,1396,3,491
"14352","남면","관내사전투표","대통령선거","강원도","춘천시",192,192,55,65,51,11,8,0,0,1,0,0,0,0,0,191,1,0
"14353","남면","남면투표소","대통령선거","강원도","춘천시",770,523,102,241,135,18,16,1,0,1,0,1,1,2,2,520,3,247
"14354","남산면","관내사전투표","대통령선거","강원도","춘천시",514,514,209,124,110,28,37,2,0,0,0,0,0,1,0,511,3,0
"14355","남산면","남산면제1투","대통령선거","강원도","춘천시",1462,953,234,411,220,44,34,0,0,0,0,0,1,1,2,947,6,509
"14356","남산면","남산면제2투","대통령선거","강원도","춘천시",597,392,96,144,113,18,16,1,0,0,0,0,0,0,2,390,2,205
"14357","남산면","남산면제3투","대통령선거","강원도","춘천시",605,418,88,180,101,23,19,0,0,0,0,1,0,2,3,417,1,187
"14358","서면","관내사전투표","대통령선거","강원도","춘천시",606,606,232,169,112,42,44,1,0,1,0,0,1,1,1,604,2,0
"14359","서면","서면제1투","대통령선거","강원도","춘천시",882,608,160,242,133,41,23,0,0,0,0,0,0,2,1,602,6,274
"14360","서면","서면제2투","대통령선거","강원도","춘천시",1323,860,221,344,208,39,42,1,0,0,0,0,0,0,3,858,2,463
"14361","서면","서면제3투","대통령선거","강원도","춘천시",679,373,65,178,94,19,12,0,0,0,0,0,2,0,0,370,3,306
"14362","사북면","관내사전투표","대통령선거","강원도","춘천시",276,276,99,57,64,34,18,0,0,0,0,0,0,0,0,272,4,0
"14363","사북면","사북면제1투","대통령선거","강원도","춘천시",660,465,103,189,121,26,20,0,0,0,1,0,0,1,1,462,3,195
"14364","사북면","사북면제2투","대통령선거","강원도","춘천시",295,215,40,84,63,8,15,0,0,0,0,2,0,0,0,212,3,80
"14365","사북면","사북면제3투","대통령선거","강원도","춘천시",906,600,140,227,157,36,18,0,0,2,0,4,2,3,3,592,8,306
"14366","북산면","관내사전투표","대통령선거","강원도","춘천시",214,214,61,77,53,13,8,0,0,0,0,0,1,0,0,213,1,0
"14367","북산면","북산면제1투","대통령선거","강원도","춘천시",420,253,46,118,58,13,15,0,0,0,0,0,0,0,2,252,1,167
"14368","북산면","북산면제2투","대통령선거","강원도","춘천시",158,114,14,68,25,1,3,0,0,0,0,0,0,1,1,113,1,44
"14369","소양동","관내사전투표","대통령선거","강원도","춘천시",2054,2054,915,467,362,159,141,2,0,0,0,2,0,0,0,2048,6,0
"14370","소양동","소양동제1투","대통령선거","강원도","춘천시",1705,1145,362,341,283,75,70,2,0,1,0,4,0,1,2,1141,4,560
"14371","소양동","소양동제2투","대통령선거","강원도","춘천시",3748,2679,1031,668,616,177,167,4,0,1,1,0,2,2,2,2671,8,1069
"14372","소양동","소양동제3투","대통령선거","강원도","춘천시",998,498,133,195,123,24,22,0,0,0,0,0,0,0,1,498,0,500
"14373","교동","관내사전투표","대통령선거","강원도","춘천시",1196,1196,467,216,283,117,100,3,0,0,0,3,0,1,0,1190,6,0
"14374","교동","교동투표소","대통령선거","강원도","춘천시",2441,1563,502,502,325,114,103,7,0,1,2,0,0,2,0,1558,5,878
"14375","조운동","관내사전투표","대통령선거","강원도","춘천시",1119,1119,485,226,199,74,127,3,0,0,1,1,0,1,1,1118,1,0
"14376","조운동","조운동투표소","대통령선거","강원도","춘천시",2250,1304,394,461,288,70,74,3,0,0,0,0,0,4,3,1297,7,946
"14377","약사명동","관내사전투표","대통령선거","강원도","춘천시",1140,1140,471,238,245,73,103,0,0,2,0,1,1,2,3,1139,1,0
"14378","약사명동","약사명동투표소","대통령선거","강원도","춘천시",2589,1645,486,597,367,75,96,4,1,0,0,1,0,3,5,1635,10,944
"14379","근화동","관내사전투표","대통령선거","강원도","춘천시",1060,1060,413,246,234,65,88,3,0,0,1,1,1,2,1,1055,5,0
"14380","근화동","근화동제1투","대통령선거","강원도","춘천시",2522,1728,592,525,391,103,109,2,0,0,0,1,0,0,1,1724,4,794
"14381","근화동","근화동제2투","대통령선거","강원도","춘천시",2037,1096,303,382,256,72,69,1,0,2,0,2,1,2,1,1091,5,941
"14382","후평1동","관내사전투표","대통령선거","강원도","춘천시",2981,2981,1210,703,575,214,252,5,1,3,0,1,2,1,2,2969,12,0
"14383","후평1동","후평1동제1투","대통령선거","강원도","춘천시",2705,1719,564,485,402,109,140,2,0,0,1,2,2,2,0,1709,10,986
"14384","후평1동","후평1동제2투","대통령선거","강원도","춘천시",2730,1619,487,538,396,79,107,1,0,2,0,1,1,1,2,1615,4,1111
"14385","후평1동","후평1동제3투","대통령선거","강원도","춘천시",2639,1709,510,543,419,107,111,4,0,3,1,0,1,1,4,1704,5,930
"14386","후평2동","관내사전투표","대통령선거","강원도","춘천시",3526,3526,1470,779,733,284,242,4,0,1,1,1,1,0,3,3519,7,0
"14387","후평2동","후평2동제1투","대통령선거","강원도","춘천시",1652,1019,341,301,230,73,69,1,0,0,0,0,0,1,0,1016,3,633
"14388","후평2동","후평2동제2투","대통령선거","강원도","춘천시",2752,1715,592,455,405,122,125,2,0,2,3,1,1,0,3,1711,4,1037
"14389","후평2동","후평2동제3투","대통령선거","강원도","춘천시",2399,1554,584,349,368,123,122,1,1,0,1,0,0,1,1,1551,3,845
"14390","후평3동","관내사전투표","대통령선거","강원도","춘천시",2258,2258,1011,410,450,182,187,5,0,3,0,3,1,1,1,2254,4,0
"14391","후평3동","후평3동제1투","대통령선거","강원도","춘천시",3396,2368,763,657,580,180,175,3,1,2,1,0,0,1,1,2364,4,1028
"14392","후평3동","후평3동제2투","대통령선거","강원도","춘천시",807,426,125,133,102,33,26,0,0,0,0,0,0,0,0,419,7,381
"14393","후평3동","후평3동제3투","대통령선거","강원도","춘천시",2491,1528,538,395,363,103,115,1,0,0,1,2,0,1,3,1522,6,963
"14394","후평3동","후평3동제4투","대통령선거","강원도","춘천시",1471,980,262,299,239,91,80,1,0,0,1,0,0,0,0,973,7,491
"14395","후평3동","후평3동제5투","대통령선거","강원도","춘천시",3603,2448,837,659,603,155,170,4,0,4,0,0,0,1,1,2434,14,1155
"14396","효자1동","관내사전투표","대통령선거","강원도","춘천시",1570,1570,741,302,264,95,153,0,0,0,0,1,1,1,2,1560,10,0
"14397","효자1동","효자1동투표소","대통령선거","강원도","춘천시",3122,2091,688,642,467,141,134,5,0,3,0,0,0,1,1,2082,9,1031
"14398","효자2동","관내사전투표","대통령선거","강원도","춘천시",1878,1878,857,326,333,163,184,1,0,2,0,0,0,0,1,1867,11,0
"14399","효자2동","효자2동제1투","대통령선거","강원도","춘천시",2056,1236,363,386,321,69,75,6,0,1,1,1,1,3,1,1228,8,820
"14400","효자2동","효자2동제2투","대통령선거","강원도","춘천시",1899,1271,415,398,298,78,72,1,0,1,1,0,1,1,0,1266,5,628
"14401","효자2동","효자2동제3투","대통령선거","강원도","춘천시",2025,1289,415,421,269,74,94,3,0,2,2,2,0,0,0,1282,7,736
"14402","효자2동","효자2동제4투","대통령선거","강원도","춘천시",2232,1359,415,414,330,89,95,2,2,0,1,0,0,0,0,1348,11,873
"14403","효자3동","관내사전투표","대통령선거","강원도","춘천시",1254,1254,534,265,233,98,114,3,0,1,0,0,0,1,2,1251,3,0
"14404","효자3동","효자3동투표소","대통령선거","강원도","춘천시",3177,2016,666,561,515,121,139,3,0,2,2,0,2,1,1,2013,3,1161
"14405","석사동","관내사전투표","대통령선거","강원도","춘천시",4614,4614,2296,749,804,347,386,3,0,1,1,2,0,2,3,4594,20,0
"14406","석사동","석사동제1투","대통령선거","강원도","춘천시",2505,1754,613,508,387,111,122,0,0,3,0,0,1,1,1,1747,7,751
"14407","석사동","석사동제2투","대통령선거","강원도","춘천시",2223,1337,434,396,319,79,93,2,0,0,0,1,0,1,1,1326,11,886
"14408","석사동","석사동제3투","대통령선거","강원도","춘천시",1690,1120,430,258,235,96,94,2,0,1,0,0,0,0,2,1118,2,570
"14409","석사동","석사동제4투","대통령선거","강원도","춘천시",3010,2383,944,517,545,185,174,2,0,1,0,1,1,1,1,2372,11,627
"14410","석사동","석사동제5투","대통령선거","강원도","춘천시",2357,1719,730,337,375,130,132,4,1,2,1,1,0,1,2,1716,3,638
"14411","석사동","석사동제6투","대통령선거","강원도","춘천시",3918,2968,1180,654,681,199,240,5,0,0,1,0,1,0,1,2962,6,950
"14412","석사동","석사동제7투","대통령선거","강원도","춘천시",2017,1277,376,420,323,67,83,1,0,2,0,0,0,1,1,1274,3,740
"14413","석사동","석사동제8투","대통령선거","강원도","춘천시",1810,1434,676,228,310,114,103,0,0,0,0,2,0,0,0,1433,1,376
"14414","석사동","석사동제9투","대통령선거","강원도","춘천시",3250,2335,1030,466,513,175,137,4,1,1,0,1,0,1,0,2329,6,915
"14415","퇴계동","관내사전투표","대통령선거","강원도","춘천시",3951,3951,1810,688,775,297,361,4,0,2,0,2,0,2,4,3945,6,0
"14416","퇴계동","퇴계동제1투","대통령선거","강원도","춘천시",3349,2297,862,538,543,183,161,2,0,0,0,1,0,0,1,2291,6,1052
"14417","퇴계동","퇴계동제2투","대통령선거","강원도","춘천시",1837,1296,454,350,325,87,74,0,1,0,0,1,0,1,0,1293,3,541
"14418","퇴계동","퇴계동제3투","대통령선거","강원도","춘천시",2003,1508,601,336,341,111,108,3,0,1,0,0,0,0,3,1504,4,495
"14419","퇴계동","퇴계동제4투","대통령선거","강원도","춘천시",2306,1842,690,445,426,143,125,1,0,0,0,2,1,0,1,1834,8,464
"14420","퇴계동","퇴계동제5투","대통령선거","강원도","춘천시",1411,1090,431,290,227,62,73,0,0,0,1,0,0,0,1,1085,5,321
"14421","퇴계동","퇴계동제6투","대통령선거","강원도","춘천시",2364,1855,672,490,406,148,131,2,0,0,1,0,1,1,1,1853,2,509
"14422","퇴계동","퇴계동제7투","대통령선거","강원도","춘천시",3501,2501,973,601,575,171,160,5,1,0,1,4,1,0,2,2494,7,1000
"14423","퇴계동","퇴계동제8투","대통령선거","강원도","춘천시",2896,2063,814,420,482,162,174,2,0,0,0,1,1,0,4,2060,3,833
"14424","퇴계동","퇴계동제9투","대통령선거","강원도","춘천시",1834,1454,640,299,336,76,89,0,0,0,0,4,0,2,2,1448,6,380
"14425","퇴계동","퇴계동제10투","대통령선거","강원도","춘천시",2940,2078,799,506,456,135,166,2,0,1,0,5,0,0,3,2073,5,862
"14426","퇴계동","퇴계동제11투","대통령선거","강원도","춘천시",1866,1520,669,326,305,111,92,3,0,2,1,0,1,1,1,1512,8,346
"14427","강남동","관내사전투표","대통령선거","강원도","춘천시",4196,4196,1890,901,773,304,308,4,0,0,3,0,0,1,2,4186,10,0
"14428","강남동","강남동제1투","대통령선거","강원도","춘천시",1934,1209,405,347,273,85,89,3,0,0,0,0,0,2,2,1206,3,725
"14429","강남동","강남동제2투","대통령선거","강원도","춘천시",2870,2039,746,531,475,159,115,3,0,1,0,0,1,0,0,2031,8,831
"14430","강남동","강남동제3투","대통령선거","강원도","춘천시",2512,1813,594,564,403,117,116,2,0,1,2,0,0,2,6,1807,6,699
"14431","강남동","강남동제4투","대통령선거","강원도","춘천시",3417,2486,955,601,530,182,200,6,0,1,0,5,1,1,0,2482,4,931
"14432","신사우동","관내사전투표","대통령선거","강원도","춘천시",3424,3424,1493,666,696,260,277,6,1,4,3,1,1,1,2,3411,13,0
"14433","신사우동","신사우동제1투","대통령선거","강원도","춘천시",2704,1756,670,420,422,130,105,2,0,0,1,1,0,2,0,1753,3,948
"14434","신사우동","신사우동제2투","대통령선거","강원도","춘천시",2438,1823,603,573,449,89,99,2,0,1,0,0,0,1,2,1819,4,615
"14435","신사우동","신사우동제3투","대통령선거","강원도","춘천시",2456,1724,539,563,375,125,106,2,1,1,0,1,0,1,3,1717,7,732
"14436","신사우동","신사우동제4투","대통령선거","강원도","춘천시",1262,819,202,301,192,54,58,2,1,1,1,0,1,0,1,814,5,443
"14437","신사우동","신사우동제5투","대통령선거","강원도","춘천시",2490,1760,659,404,444,140,104,2,0,0,0,0,0,2,0,1755,5,730
"14438","잘못 투입·구분된 투표지","잘못 투입·구분된 투표지","대통령선거","강원도","춘천시",0,0,0,0,0,0,0,0,0,0,0,0,0,0,0,0,0,0
"14439","거소·선상투표","거소·선상투표","대통령선거","강원도","원주시",658,623,229,111,184,46,22,3,3,3,0,1,1,2,2,607,16,35
"14440","관외사전투표","관외사전투표","대통령선거","강원도","원주시",19465,19465,8897,2712,3991,1811,1801,27,6,10,6,18,9,4,39,19331,134,0
"14441","재외투표","재외투표","대통령선거","강원도","원주시",1234,974,626,48,134,42,120,0,0,0,0,1,0,0,0,971,3,260
"14442","문막읍","관내사전투표","대통령선거","강원도","원주시",2451,2451,1089,538,486,133,181,4,1,1,1,6,1,1,2,2444,7,0
"14443","문막읍","문막읍제1투","대통령선거","강원도","원주시",3362,2040,690,550,484,131,166,4,0,0,1,3,0,2,3,2034,6,1322
"14444","문막읍","문막읍제2투","대통령선거","강원도","원주시",1992,1189,278,469,316,55,55,0,1,1,0,2,1,3,2,1183,6,803
"14445","문막읍","문막읍제3투","대통령선거","강원도","원주시",1045,668,154,278,179,22,29,1,0,0,0,1,0,0,0,664,4,377
"14446","문막읍","문막읍제4투","대통령선거","강원도","원주시",2103,1215,392,355,291,76,85,1,0,4,0,0,0,1,2,1207,8,888
"14447","문막읍","문막읍제5투","대통령선거","강원도","원주시",3265,2012,802,379,497,137,187,1,0,1,0,2,2,0,2,2010,2,1253
"14448","소초면","관내사전투표","대통령선거","강원도","원주시",965,965,354,241,235,60,65,4,1,2,0,0,0,0,0,962,3,0
"14449","소초면","소초면제1투","대통령선거","강원도","원주시",1826,1074,277,452,238,46,50,3,0,3,1,2,0,0,1,1073,1,752
"14450","소초면","소초면제2투","대통령선거","강원도","원주시",1315,892,253,326,228,43,33,4,0,1,0,0,0,0,0,888,4,423
"14451","소초면","소초면제3투","대통령선거","강원도","원주시",2291,1377,360,473,372,78,77,5,0,0,1,2,0,0,1,1369,8,914
"14452","소초면","소초면제4투","대통령선거","강원도","원주시",861,575,157,167,156,55,36,2,0,0,1,0,0,1,0,575,0,286
"14453","호저면","관내사전투표","대통령선거","강원도","원주시",485,485,186,132,97,20,34,1,0,0,0,1,0,4,3,478,7,0
"14454","호저면","호저면제1투","대통령선거","강원도","원주시",1951,1269,321,561,258,63,43,3,0,4,1,3,0,3,3,1263,6,682
"14455","호저면","호저면제2투","대통령선거","강원도","원주시",986,673,167,280,153,28,35,1,0,2,1,1,3,0,0,671,2,313
"14456","지정면","관내사전투표","대통령선거","강원도","원주시",402,402,146,115,79,17,34,0,0,0,1,0,1,0,1,394,8,0
"14457","지정면","지정면제1투","대통령선거","강원도","원주시",1233,816,192,328,207,31,37,3,1,2,2,0,0,0,2,805,11,417
"14458","지정면","지정면제2투","대통령선거","강원도","원주시",892,606,160,256,133,25,26,0,0,2,0,0,2,0,1,605,1,286
"14459","부론면","관내사전투표","대통령선거","강원도","원주시",408,408,121,163,93,11,15,0,1,2,0,0,0,0,0,406,2,0
"14460","부론면","부론면투표소","대통령선거","강원도","원주시",1683,1096,223,483,307,44,30,0,1,0,1,1,1,1,0,1092,4,587
"14461","귀래면","관내사전투표","대통령선거","강원도","원주시",461,461,147,167,107,14,20,0,1,1,0,2,1,0,1,461,0,0
"14462","귀래면","귀래면투표소","대통령선거","강원도","원주시",1411,891,172,386,269,25,26,3,0,0,0,0,1,5,1,888,3,520
"14463","흥업면","관내사전투표","대통령선거","강원도","원주시",2316,2316,963,502,498,149,167,6,0,1,1,2,2,1,2,2294,22,0
"14464","흥업면","흥업면제1투","대통령선거","강원도","원주시",3142,1899,636,537,436,139,127,5,0,6,1,1,1,1,0,1890,9,1243
"14465","흥업면","흥업면제2투","대통령선거","강원도","원주시",963,602,153,233,132,36,38,0,0,0,1,3,1,2,0,599,3,361
"14466","흥업면","흥업면제3투","대통령선거","강원도","원주시",1291,823,253,240,204,60,62,0,0,0,0,0,1,0,0,820,3,468
"14467","판부면","관내사전투표","대통령선거","강원도","원주시",401,401,181,91,70,23,30,3,0,0,1,0,0,1,0,400,1,0
"14468","판부면","판부면제1투","대통령선거","강원도","원주시",859,576,166,189,137,37,38,1,1,1,0,0,0,1,3,574,2,283
"14469","판부면","판부면제2투","대통령선거","강원도","원주시",695,458,112,160,133,26,21,0,0,0,0,0,0,0,1,453,5,237
"14470","판부면","판부면제3투","대통령선거","강원도","원주시",2745,1651,606,428,389,110,100,2,0,1,0,3,0,2,4,1645,6,1094
"14471","신림면","관내사전투표","대통령선거","강원도","원주시",667,667,241,215,143,27,32,1,0,0,0,0,0,5,1,665,2,0
"14472","신림면","신림면제1투","대통령선거","강원도","원주시",1933,1228,303,524,273,70,44,2,0,0,1,1,1,0,2,1221,7,705
"14473","신림면","신림면제2투","대통령선거","강원도","원주시",741,501,127,200,115,30,23,1,0,0,0,1,0,2,0,499,2,240
"14474","중앙동","관내사전투표","대통령선거","강원도","원주시",1771,1771,679,522,317,89,147,5,0,0,0,1,0,0,1,1761,10,0
"14475","중앙동","중앙동투표소","대통령선거","강원도","원주시",2280,1192,274,511,282,56,57,4,0,4,1,0,0,1,1,1191,1,1088
"14476","원인동","관내사전투표","대통령선거","강원도","원주시",748,748,291,196,155,44,52,2,0,0,1,0,0,1,1,743,5,0
"14477","원인동","원인동제1투","대통령선거","강원도","원주시",2712,1600,484,481,389,97,126,6,0,1,0,6,0,0,1,1591,9,1112
"14478","원인동","원인동제2투","대통령선거","강원도","원주시",1191,763,219,272,190,38,37,3,0,0,0,0,0,1,2,762,1,428
"14479","개운동","관내사전투표","대통령선거","강원도","원주시",2307,2307,897,585,475,156,172,3,1,3,0,1,1,1,3,2298,9,0
"14480","개운동","개운동제1투","대통령선거","강원도","원주시",2960,1821,483,652,457,107,105,1,1,3,0,3,0,0,3,1815,6,1139
"14481","개운동","개운동제2투","대통령선거","강원도","원주시",3142,2107,610,686,522,153,123,0,1,0,2,2,0,0,1,2100,7,1035
"14482","개운동","개운동제3투","대통령선거","강원도","원주시",2380,1707,616,458,379,123,118,3,0,2,0,0,0,1,2,1702,5,673
"14483","명륜1동","관내사전투표","대통령선거","강원도","원주시",3370,3370,1633,588,556,230,330,5,0,2,0,5,1,4,6,3360,10,0
"14484","명륜1동","명륜1동제1투","대통령선거","강원도","원주시",2173,1411,401,485,370,75,62,3,0,1,0,1,0,3,1,1402,9,762
"14485","명륜1동","명륜1동제2투","대통령선거","강원도","원주시",1750,1161,359,406,272,45,62,5,0,2,0,1,1,1,2,1156,5,589
"14486","명륜1동","명륜1동제3투","대통령선거","강원도","원주시",2301,1674,569,462,392,139,95,2,0,4,0,2,0,0,2,1667,7,627
"14487","명륜2동","관내사전투표","대통령선거","강원도","원주시",2729,2729,1223,558,553,165,206,4,0,0,1,1,2,0,4,2717,12,0
"14488","명륜2동","명륜2동제1투","대통령선거","강원도","원주시",2436,1355,420,429,340,64,71,8,2,2,0,2,4,2,1,1345,10,1081
"14489","명륜2동","명륜2동제2투","대통령선거","강원도","원주시",3333,2581,1023,603,607,174,159,5,0,1,0,3,0,0,1,2576,5,752
"14490","명륜2동","명륜2동제3투","대통령선거","강원도","원주시",2372,1620,571,443,383,103,105,2,0,3,1,0,0,1,1,1613,7,752
"14491","명륜2동","명륜2동제4투","대통령선거","강원도","원주시",2333,1436,431,457,334,89,100,4,1,3,0,2,4,1,3,1429,7,897
"14492","단구동","관내사전투표","대통령선거","강원도","원주시",5409,5409,2489,1039,1003,379,442,5,0,4,2,4,1,2,6,5376,33,0
"14493","단구동","단구동제1투","대통령선거","강원도","원주시",2868,1781,606,511,404,131,115,2,0,2,2,0,0,0,2,1775,6,1087
"14494","단구동","단구동제2투","대통령선거","강원도","원주시",2608,1751,527,535,419,128,124,5,0,4,0,2,0,1,1,1746,5,857
"14495","단구동","단구동제3투","대통령선거","강원도","원주시",2941,1945,775,393,492,128,148,0,0,1,0,3,0,0,1,1941,4,996
"14496","단구동","단구동제4투","대통령선거","강원도","원주시",2116,1394,419,408,366,112,79,3,1,2,0,0,0,0,0,1390,4,722
"14497","단구동","단구동제5투","대통령선거","강원도","원주시",2510,1647,566,480,378,83,126,1,1,0,0,3,0,0,1,1639,8,863
"14498","단구동","단구동제6투","대통령선거","강원도","원주시",2977,2131,842,446,521,146,148,5,2,6,0,6,0,1,3,2126,5,846
"14499","단구동","단구동제7투","대통령선거","강원도","원주시",3134,1912,663,463,477,144,149,1,0,0,1,1,1,0,2,1902,10,1222
"14500","단구동","단구동제8투","대통령선거","강원도","원주시",2692,1776,751,354,380,135,134,2,1,0,0,3,0,1,5,1766,10,916
"14501","단구동","단구동제9투","대통령선거","강원도","원주시",1677,1251,558,227,272,95,95,0,0,0,0,0,0,0,2,1249,2,426
"14502","단구동","단구동제10투","대통령선거","강원도","원주시",2878,2019,886,359,456,161,144,1,0,1,0,3,1,1,1,2014,5,859
"14503","일산동","관내사전투표","대통령선거","강원도","원주시",1557,1557,687,345,283,103,126,0,1,2,0,0,0,1,1,1549,8,0
"14504","일산동","일산동제1투","대통령선거","강원도","원주시",2838,1734,524,593,413,87,102,2,1,0,0,5,0,1,0,1728,6,1104
"14505","일산동","일산동제2투","대통령선거","강원도","원주시",2643,1677,474,563,429,95,98,2,0,3,0,3,0,1,1,1669,8,966
"14506","학성동","관내사전투표","대통령선거","강원도","원주시",1537,1537,617,395,293,98,121,4,0,3,0,1,1,1,1,1535,2,0
"14507","학성동","학성동제1투","대통령선거","강원도","원주시",2532,1656,512,562,386,95,91,1,1,0,0,0,2,1,1,1652,4,876
"14508","학성동","학성동제2투","대통령선거","강원도","원주시",1294,761,202,288,187,44,33,1,0,0,0,0,0,1,2,758,3,533
"14509","단계동","관내사전투표","대통령선거","강원도","원주시",3879,3879,1709,750,737,302,354,3,0,4,0,2,1,0,5,3867,12,0
"14510","단계동","단계동제1투","대통령선거","강원도","원주시",2681,1628,528,459,411,114,104,1,0,1,0,0,1,1,4,1624,4,1053
"14511","단계동","단계동제2투","대통령선거","강원도","원주시",3564,2437,814,693,579,170,157,3,1,4,0,2,1,0,2,2426,11,1127
"14512","단계동","단계동제3투","대통령선거","강원도","원주시",2875,1824,541,533,473,130,128,4,0,1,0,1,0,0,3,1814,10,1051
"14513","단계동","단계동제4투","대통령선거","강원도","원주시",1796,1128,342,356,267,75,76,2,1,0,0,4,0,1,0,1124,4,668
"14514","단계동","단계동제5투","대통령선거","강원도","원주시",3802,2634,989,668,602,212,148,4,1,0,0,0,1,2,3,2630,4,1168
"14515","우산동","관내사전투표","대통령선거","강원도","원주시",2124,2124,878,497,414,136,178,3,0,2,0,3,0,1,4,2116,8,0
"14516","우산동","우산동제1투","대통령선거","강원도","원주시",2725,1715,465,653,407,95,78,1,0,2,0,2,0,2,0,1705,10,1010
"14517","우산동","우산동제2투","대통령선거","강원도","원주시",3415,2423,891,590,582,171,171,2,1,1,1,2,2,1,3,2418,5,992
"14518","우산동","우산동제3투","대통령선거","강원도","원주시",3085,1933,629,528,491,132,140,1,0,3,0,1,1,0,0,1926,7,1152
"14519","태장1동","관내사전투표","대통령선거","강원도","원주시",2039,2039,846,447,423,165,129,3,3,2,0,5,1,1,5,2030,9,0
"14520","태장1동","태장1동제1투","대통령선거","강원도","원주시",2405,1557,459,479,417,96,92,5,0,1,0,0,1,2,2,1554,3,848
"14521","태장1동","태장1동제2투","대통령선거","강원도","원주시",3287,1994,675,535,516,106,142,3,1,2,0,0,1,3,0,1984,10,1293
"14522","태장2동","관내사전투표","대통령선거","강원도","원주시",2744,2744,1098,597,597,205,228,3,1,1,0,1,2,2,0,2735,9,0
"14523","태장2동","태장2동제1투","대통령선거","강원도","원주시",2609,1520,435,443,429,106,90,5,0,0,1,2,1,0,2,1514,6,1089
"14524","태장2동","태장2동제2투","대통령선거","강원도","원주시",3153,2152,741,515,542,178,163,1,0,2,1,0,3,0,5,2151,1,1001
"14525","태장2동","태장2동제3투","대통령선거","강원도","원주시",2772,1850,613,490,463,111,154,3,0,0,2,2,1,0,0,1839,11,922
"14526","태장2동","태장2동제4투","대통령선거","강원도","원주시",1786,1065,264,399,274,51,59,2,0,1,0,2,1,2,2,1057,8,721
"14527","태장2동","태장2동제5투","대통령선거","강원도","원주시",2042,1232,337,420,319,70,70,3,0,1,2,1,2,0,1,1226,6,810
"14528","태장2동","태장2동제6투","대통령선거","강원도","원주시",3137,2042,686,516,538,129,157,1,0,2,0,3,0,1,1,2034,8,1095
"14529","봉산동","관내사전투표","대통령선거","강원도","원주시",1307,1307,500,343,284,68,93,2,2,1,1,7,2,0,0,1303,4,0
"14530","봉산동","봉산동제1투","대통령선거","강원도","원주시",1930,1195,334,442,296,60,50,1,0,1,1,2,0,1,1,1189,6,735
"14531","봉산동","봉산동제2투","대통령선거","강원도","원주시",1766,1091,303,441,234,48,48,7,0,0,0,0,0,2,3,1086,5,675
"14532","봉산동","봉산동제3투","대통령선거","강원도","원주시",2527,1791,633,511,385,118,128,2,1,1,1,4,0,1,2,1787,4,736
"14533","행구동","관내사전투표","대통령선거","강원도","원주시",1534,1534,659,372,294,94,95,3,0,1,1,2,0,1,1,1523,11,0
"14534","행구동","행구동제1투","대통령선거","강원도","원주시",1994,1207,380,448,251,68,49,3,0,0,0,1,1,1,1,1203,4,787
"14535","행구동","행구동제2투","대통령선거","강원도","원주시",2575,1883,714,463,449,119,125,2,0,0,0,4,0,0,2,1878,5,692
"14536","무실동","관내사전투표","대통령선거","강원도","원주시",5578,5578,2729,952,975,400,475,12,0,2,0,9,2,1,4,5561,17,0
"14537","무실동","무실동제1투","대통령선거","강원도","원주시",3181,2033,773,535,439,144,128,3,0,2,0,1,0,0,0,2025,8,1148
"14538","무실동","무실동제2투","대통령선거","강원도","원주시",3300,2180,808,584,511,120,139,8,1,1,0,1,1,1,2,2177,3,1120
"14539","무실동","무실동제3투","대통령선거","강원도","원주시",2493,1994,803,441,450,143,150,2,0,0,0,1,0,0,0,1990,4,499
"14540","무실동","무실동제4투","대통령선거","강원도","원주시",2537,1357,445,379,321,100,96,5,1,0,0,0,2,1,2,1352,5,1180
"14541","무실동","무실동제5투","대통령선거","강원도","원주시",3422,2415,996,481,591,177,152,4,1,1,0,1,2,0,0,2406,9,1007
"14542","무실동","무실동제6투","대통령선거","강원도","원주시",4261,3141,1450,502,740,216,215,0,0,3,0,3,0,1,2,3132,9,1120
"14543","반곡관설동","관내사전투표","대통령선거","강원도","원주시",4780,4780,2610,621,785,367,377,5,0,3,0,2,0,4,1,4775,5,0
"14544","반곡관설동","반곡관설동제1투","대통령선거","강원도","원주시",926,644,154,252,169,29,34,0,0,1,0,1,0,1,0,641,3,282
"14545","반곡관설동","반곡관설동제2투","대통령선거","강원도","원주시",3190,2362,1110,365,540,172,161,4,1,0,0,0,0,0,1,2354,8,828
"14546","반곡관설동","반곡관설동제3투","대통령선거","강원도","원주시",2273,1299,455,327,307,97,101,2,0,1,0,2,1,0,0,1293,6,974
"14547","반곡관설동","반곡관설동제4투","대통령선거","강원도","원주시",2257,1594,715,320,321,106,127,1,0,0,0,0,3,0,1,1594,0,663
"14548","반곡관설동","반곡관설동제5투","대통령선거","강원도","원주시",3097,2297,1008,461,503,170,143,4,0,0,0,2,0,2,1,2294,3,800
"14549","반곡관설동","반곡관설동제6투","대통령선거","강원도","원주시",1681,1139,506,191,264,82,86,3,0,1,0,0,0,0,1,1134,5,542
"14550","반곡관설동","반곡관설동제7투","대통령선거","강원도","원주시",2897,2012,973,303,465,127,140,0,0,0,0,0,0,0,1,2009,3,885
"14551","반곡관설동","반곡관설동제8투","대통령선거","강원도","원주시",3435,2440,1082,404,565,187,185,2,0,1,0,1,0,2,2,2431,9,995
"14552","잘못 투입·구분된 투표지","잘못 투입·구분된 투표지","대통령선거","강원도","원주시",0,0,0,0,0,0,0,0,0,0,0,0,0,0,0,0,0,0
"14553","거소·선상투표","거소·선상투표","대통령선거","강원도","강릉시",376,348,124,81,98,22,10,2,0,0,2,0,0,1,0,340,8,28
"14554","관외사전투표","관외사전투표","대통령선거","강원도","강릉시",11415,11415,4857,1866,2204,1185,1143,19,1,8,6,8,5,2,13,11317,98,0
"14555","재외투표","재외투표","대통령선거","강원도","강릉시",776,609,363,37,85,31,86,1,0,0,0,0,0,0,1,604,5,167
"14556","주문진읍","관내사전투표","대통령선거","강원도","강릉시",1660,1660,556,609,309,85,79,0,0,5,1,4,0,3,2,1653,7,0
"14557","주문진읍","주문진읍제1투","대통령선거","강원도","강릉시",2744,1512,294,784,299,67,41,2,0,5,0,3,1,1,2,1499,13,1232
"14558","주문진읍","주문진읍제2투","대통령선거","강원도","강릉시",2754,1472,308,727,283,86,50,1,1,1,0,0,1,4,2,1464,8,1282
"14559","주문진읍","주문진읍제3투","대통령선거","강원도","강릉시",2577,1629,315,816,338,89,58,6,0,1,0,0,0,1,1,1625,4,948
"14560","주문진읍","주문진읍제4투","대통령선거","강원도","강릉시",876,585,116,308,110,24,18,2,0,2,0,1,0,2,0,583,2,291
"14561","주문진읍","주문진읍제5투","대통령선거","강원도","강릉시",2004,1195,271,500,273,77,60,1,1,0,0,1,0,3,3,1190,5,809
"14562","주문진읍","주문진읍제6투","대통령선거","강원도","강릉시",2056,1266,383,459,248,82,76,3,0,1,1,4,1,0,2,1260,6,790
"14563","성산면","관내사전투표","대통령선거","강원도","강릉시",643,643,215,198,119,61,42,1,0,0,0,0,1,1,1,639,4,0
"14564","성산면","성산면제1투","대통령선거","강원도","강릉시",1796,1169,239,566,235,65,47,2,0,3,3,1,0,3,1,1165,4,627
"14565","성산면","성산면제2투","대통령선거","강원도","강릉시",533,384,107,153,91,15,13,0,0,0,0,0,1,0,2,382,2,149
"14566","왕산면","관내사전투표","대통령선거","강원도","강릉시",197,197,48,73,49,9,16,0,0,0,0,0,0,0,0,195,2,0
"14567","왕산면","왕산면제1투","대통령선거","강원도","강릉시",587,395,53,205,95,20,11,3,0,0,0,0,1,2,1,391,4,192
"14568","왕산면","왕산면제2투","대통령선거","강원도","강릉시",315,233,51,104,57,11,5,0,0,0,0,0,0,1,2,231,2,82
"14569","왕산면","왕산면제3투","대통령선거","강원도","강릉시",298,215,55,97,42,13,6,0,0,1,0,0,0,0,0,214,1,83
"14570","구정면","관내사전투표","대통령선거","강원도","강릉시",574,574,183,174,114,48,47,1,0,0,0,1,0,1,0,569,5,0
"14571","구정면","구정면제1투","대통령선거","강원도","강릉시",1887,1300,304,565,281,62,71,3,0,1,1,1,2,1,2,1294,6,587
"14572","구정면","구정면제2투","대통령선거","강원도","강릉시",949,599,128,292,113,31,26,1,0,0,1,0,0,1,2,595,4,350
"14573","강동면","관내사전투표","대통령선거","강원도","강릉시",813,813,212,339,134,57,51,6,0,1,1,0,2,1,1,805,8,0
"14574","강동면","강동면제1투","대통령선거","강원도","강릉시",2258,1372,257,715,239,95,52,0,0,0,1,0,1,0,1,1361,11,886
"14575","강동면","강동면제2투","대통령선거","강원도","강릉시",1095,663,116,327,142,34,28,0,0,1,2,0,2,1,2,655,8,432
"14576","옥계면","관내사전투표","대통령선거","강원도","강릉시",685,685,175,279,145,35,39,0,0,1,0,3,1,3,0,681,4,0
"14577","옥계면","옥계면제1투","대통령선거","강원도","강릉시",1623,998,211,489,181,57,47,3,1,1,1,0,1,2,0,994,4,625
"14578","옥계면","옥계면제2투","대통령선거","강원도","강릉시",1089,710,128,339,158,38,35,0,1,0,0,0,2,1,1,703,7,379
"14579","사천면","관내사전투표","대통령선거","강원도","강릉시",811,811,326,229,126,57,53,1,1,2,2,0,2,3,1,803,8,0
"14580","사천면","사천면제1투","대통령선거","강원도","강릉시",2029,1299,281,545,316,73,64,0,0,1,0,3,1,2,0,1286,13,730
"14581","사천면","사천면제2투","대통령선거","강원도","강릉시",1132,783,181,321,177,53,26,4,0,1,0,2,0,5,3,773,10,349
"14582","연곡면","관내사전투표","대통령선거","강원도","강릉시",1096,1096,418,339,193,82,57,0,0,1,0,0,0,1,2,1093,3,0
"14583","연곡면","연곡면제1투","대통령선거","강원도","강릉시",3139,2049,622,693,453,138,129,1,1,1,0,1,0,2,5,2046,3,1090
"14584","연곡면","연곡면제2투","대통령선거","강원도","강릉시",1427,947,189,523,155,42,30,1,1,0,0,0,0,2,1,944,3,480
"14585","홍제동","관내사전투표","대통령선거","강원도","강릉시",1649,1649,644,436,304,144,102,4,1,0,0,4,0,0,3,1642,7,0
"14586","홍제동","홍제동제1투","대통령선거","강원도","강릉시",3037,2037,591,751,414,152,116,1,0,2,0,0,1,2,0,2030,7,1000
"14587","홍제동","홍제동제2투","대통령선거","강원도","강릉시",3168,2181,654,758,470,144,136,2,1,1,0,3,1,2,3,2175,6,987
"14588","중앙동","관내사전투표","대통령선거","강원도","강릉시",1905,1905,689,590,305,142,159,2,0,1,0,1,1,2,3,1895,10,0
"14589","중앙동","중앙동제1투","대통령선거","강원도","강릉시",1546,1019,223,444,231,61,55,1,0,0,1,2,0,1,0,1019,0,527
"14590","중앙동","중앙동제2투","대통령선거","강원도","강릉시",2403,1436,304,729,260,74,60,1,0,0,0,0,1,0,1,1430,6,967
"14591","옥천동","관내사전투표","대통령선거","강원도","강릉시",1039,1039,328,370,187,72,73,0,0,0,0,2,0,0,1,1033,6,0
"14592","옥천동","옥천동투표소","대통령선거","강원도","강릉시",2737,1693,355,841,367,68,45,2,0,2,0,1,1,3,1,1686,7,1044
"14593","교1동","관내사전투표","대통령선거","강원도","강릉시",4581,4581,2062,896,818,398,375,2,0,0,2,6,1,1,4,4565,16,0
"14594","교1동","교1동제1투","대통령선거","강원도","강릉시",2554,1767,445,641,422,159,88,3,1,0,0,0,3,0,0,1762,5,787
"14595","교1동","교1동제2투","대통령선거","강원도","강릉시",2716,1845,440,802,387,103,93,2,0,3,2,0,1,1,2,1836,9,871
"14596","교1동","교1동제3투","대통령선거","강원도","강릉시",2272,1781,651,505,359,145,111,1,0,1,0,0,0,2,1,1776,5,491
"14597","교1동","교1동제4투","대통령선거","강원도","강릉시",3178,2144,728,569,459,191,173,4,0,2,0,3,0,1,1,2131,13,1034
"14598","교1동","교1동제5투","대통령선거","강원도","강릉시",2638,1810,621,501,411,128,137,1,0,1,1,0,1,0,1,1803,7,828
"14599","교1동","교1동제6투","대통령선거","강원도","강릉시",2523,1803,635,523,390,135,109,2,1,1,0,1,2,1,0,1800,3,720
"14600","교2동","관내사전투표","대통령선거","강원도","강릉시",1596,1596,619,433,284,129,117,2,2,1,0,1,0,1,2,1591,5,0
"14601","교2동","교2동제1투","대통령선거","강원도","강릉시",1940,1057,242,490,203,64,42,4,0,0,0,0,0,2,0,1047,10,883
"14602","교2동","교2동제2투","대통령선거","강원도","강릉시",1646,1048,252,440,219,67,57,0,0,2,0,0,0,1,2,1040,8,598
"14603","교2동","교2동제3투","대통령선거","강원도","강릉시",2073,1512,464,538,297,116,88,2,0,1,0,0,0,3,2,1511,1,561
"14604","포남1동","관내사전투표","대통령선거","강원도","강릉시",1371,1371,469,436,264,100,88,0,0,0,0,2,1,0,0,1360,11,0
"14605","포남1동","포남1동제1투","대통령선거","강원도","강릉시",2750,1838,451,761,390,118,99,2,0,0,0,0,1,3,3,1828,10,912
"14606","포남1동","포남1동제2투","대통령선거","강원도","강릉시",2508,1612,392,737,336,87,50,2,0,1,1,0,0,0,1,1607,5,896
"14607","포남1동","포남1동제3투","대통령선거","강원도","강릉시",2616,1747,427,690,386,123,98,7,0,2,0,2,3,0,1,1739,8,869
"14608","포남2동","관내사전투표","대통령선거","강원도","강릉시",2286,2286,883,594,399,177,200,5,0,0,3,2,0,4,2,2269,17,0
"14609","포남2동","포남2동제1투","대통령선거","강원도","강릉시",2647,1569,411,630,319,103,87,4,0,0,1,2,1,0,3,1561,8,1078
"14610","포남2동","포남2동제2투","대통령선거","강원도","강릉시",2453,1648,452,561,402,123,98,4,0,0,1,0,1,0,1,1643,5,805
"14611","포남2동","포남2동제3투","대통령선거","강원도","강릉시",2164,1410,403,487,315,102,91,2,0,0,1,1,0,0,2,1404,6,754
"14612","포남2동","포남2동제4투","대통령선거","강원도","강릉시",2104,1486,399,547,321,116,92,3,0,2,0,1,2,1,1,1485,1,618
"14613","초당동","관내사전투표","대통령선거","강원도","강릉시",1025,1025,434,231,181,92,78,2,0,0,0,1,0,1,1,1021,4,0
"14614","초당동","초당동제1투","대통령선거","강원도","강릉시",1297,857,242,334,160,68,41,2,0,1,0,0,0,1,0,849,8,440
"14615","초당동","초당동제2투","대통령선거","강원도","강릉시",1816,1267,440,353,302,82,83,0,0,0,0,3,0,1,3,1267,0,549
"14616","송정동","관내사전투표","대통령선거","강원도","강릉시",1352,1352,577,347,231,89,100,2,0,1,0,0,0,0,1,1348,4,0
"14617","송정동","송정동제1투","대통령선거","강원도","강릉시",1833,1224,288,508,266,92,57,1,0,0,0,1,0,1,1,1215,9,609
"14618","송정동","송정동제2투","대통령선거","강원도","강릉시",2270,1572,525,470,361,115,85,6,1,2,0,0,0,1,1,1567,5,698
"14619","내곡동","관내사전투표","대통령선거","강원도","강릉시",2078,2078,859,456,374,184,182,2,0,2,0,3,0,1,4,2067,11,0
"14620","내곡동","내곡동제1투","대통령선거","강원도","강릉시",4005,2815,857,926,610,223,182,3,0,3,0,0,1,2,4,2811,4,1190
"14621","내곡동","내곡동제2투","대통령선거","강원도","강릉시",4478,2897,896,915,600,237,217,4,0,1,0,2,1,4,1,2878,19,1581
"14622","강남동","관내사전투표","대통령선거","강원도","강릉시",2669,2669,991,768,480,215,181,6,0,1,2,5,1,1,5,2656,13,0
"14623","강남동","강남동제1투","대통령선거","강원도","강릉시",2810,1836,481,749,401,102,88,1,1,2,0,2,0,1,3,1831,5,974
"14624","강남동","강남동제2투","대통령선거","강원도","강릉시",2565,1687,400,678,384,102,95,3,0,2,0,2,2,2,0,1670,17,878
"14625","강남동","강남동제3투","대통령선거","강원도","강릉시",2939,1863,462,762,418,120,90,4,0,0,1,2,0,0,2,1861,2,1076
"14626","강남동","강남동제4투","대통령선거","강원도","강릉시",2656,1795,552,600,390,129,109,2,0,3,0,0,0,1,5,1791,4,861
"14627","강남동","강남동제5투","대통령선거","강원도","강릉시",1048,690,143,318,144,48,24,3,1,0,0,0,0,3,2,686,4,358
"14628","강남동","강남동제6투","대통령선거","강원도","강릉시",756,483,88,232,100,29,23,1,0,0,1,0,0,4,3,481,2,273
"14629","성덕동","관내사전투표","대통령선거","강원도","강릉시",3189,3189,1395,702,534,284,247,4,0,2,0,5,0,0,7,3180,9,0
"14630","성덕동","성덕동제1투","대통령선거","강원도","강릉시",2964,1928,600,600,463,131,119,3,0,0,0,1,2,1,1,1921,7,1036
"14631","성덕동","성덕동제2투","대통령선거","강원도","강릉시",3372,2291,707,711,531,164,161,1,0,2,1,0,0,2,0,2280,11,1081
"14632","성덕동","성덕동제3투","대통령선거","강원도","강릉시",3786,2405,664,866,507,176,146,6,1,3,2,3,6,0,2,2382,23,1381
"14633","성덕동","성덕동제4투","대통령선거","강원도","강릉시",3016,2103,710,621,436,175,148,2,0,0,0,0,1,0,1,2094,9,913
"14634","성덕동","성덕동제5투","대통령선거","강원도","강릉시",3017,2233,944,450,483,177,160,3,0,0,0,1,1,3,1,2223,10,784
"14635","성덕동","성덕동제6투","대통령선거","강원도","강릉시",1271,876,226,304,198,75,58,1,0,1,1,0,0,1,2,867,9,395
"14636","경포동","관내사전투표","대통령선거","강원도","강릉시",408,408,147,112,76,43,28,0,0,0,0,0,0,0,0,406,2,0
"14637","경포동","경포동제1투","대통령선거","강원도","강릉시",2111,1372,378,533,287,95,61,2,0,3,0,1,0,0,1,1361,11,739
"14638","경포동","경포동제2투","대통령선거","강원도","강릉시",1416,984,239,423,197,58,50,2,1,1,0,0,1,1,4,977,7,432
"14639","잘못 투입·구분된 투표지","잘못 투입·구분된 투표지","대통령선거","강원도","강릉시",0,0,0,0,0,0,0,0,0,0,0,0,0,0,0,0,0,0
"14640","거소·선상투표","거소·선상투표","대통령선거","강원도","동해시",874,854,241,129,274,103,38,6,0,2,0,1,0,0,16,810,44,20
"14641","관외사전투표","관외사전투표","대통령선거","강원도","동해시",5311,5310,2161,939,1097,535,503,7,1,2,3,8,3,3,6,5268,42,1
"14642","재외투표","재외투표","대통령선거","강원도","동해시",228,168,90,20,26,9,22,0,0,0,0,0,0,0,0,167,1,60
"14643","천곡동","관내사전투표","대통령선거","강원도","동해시",4618,4618,1856,1200,828,358,336,7,2,2,1,5,2,0,10,4607,11,0
"14644","천곡동","천곡동제1투","대통령선거","강원도","동해시",1964,1267,319,490,283,83,78,4,0,2,0,0,2,1,0,1262,5,697
"14645","천곡동","천곡동제2투","대통령선거","강원도","동해시",1691,1025,247,392,221,85,61,2,0,2,3,3,0,0,1,1017,8,666
"14646","천곡동","천곡동제3투","대통령선거","강원도","동해시",2063,1214,346,430,273,103,56,3,0,0,0,1,0,0,0,1212,2,849
"14647","천곡동","천곡동제4투","대통령선거","강원도","동해시",1859,1172,290,476,243,86,60,5,1,1,2,4,0,1,1,1170,2,687
"14648","천곡동","천곡동제5투","대통령선거","강원도","동해시",1678,1094,257,467,224,87,49,1,1,1,0,0,0,0,3,1090,4,584
"14649","천곡동","천곡동제6투","대통령선거","강원도","동해시",1514,1105,306,408,231,82,66,2,0,1,1,2,0,0,3,1102,3,409
"14650","천곡동","천곡동제7투","대통령선거","강원도","동해시",1895,1110,313,434,208,74,63,4,1,2,2,0,1,0,3,1105,5,785
"14651","천곡동","천곡동제8투","대통령선거","강원도","동해시",2768,1988,763,456,479,161,120,2,0,2,0,3,0,0,0,1986,2,780
"14652","천곡동","천곡동제9투","대통령선거","강원도","동해시",2109,1456,496,394,362,103,89,5,0,0,1,0,0,1,0,1451,5,653
"14653","송정동","관내사전투표","대통령선거","강원도","동해시",807,807,278,230,141,82,60,2,0,1,0,1,2,1,4,802,5,0
"14654","송정동","송정동제1투","대통령선거","강원도","동해시",2089,1238,256,598,245,61,52,0,0,3,1,4,3,4,2,1229,9,851
"14655","송정동","송정동제2투","대통령선거","강원도","동해시",984,667,166,294,132,35,35,1,0,0,0,0,0,0,2,665,2,317
"14656","북삼동","관내사전투표","대통령선거","강원도","동해시",3146,3146,1432,629,538,265,253,2,0,0,1,10,1,1,3,3135,11,0
"14657","북삼동","북삼동제1투","대통령선거","강원도","동해시",1178,723,132,348,165,32,40,1,0,0,0,1,0,0,2,721,2,455
"14658","북삼동","북삼동제2투","대통령선거","강원도","동해시",1060,685,160,287,159,29,37,2,0,0,0,3,0,1,2,680,5,375
"14659","북삼동","북삼동제3투","대통령선거","강원도","동해시",1861,1222,372,440,267,68,65,2,0,0,0,1,1,2,3,1221,1,639
"14660","북삼동","북삼동제4투","대통령선거","강원도","동해시",2300,1517,537,367,353,118,131,2,0,2,0,2,0,1,2,1515,2,783
"14661","북삼동","북삼동제5투","대통령선거","강원도","동해시",2283,1553,528,472,320,124,93,2,0,3,1,1,0,0,1,1545,8,730
"14662","북삼동","북삼동제6투","대통령선거","강원도","동해시",2718,1891,726,436,439,141,130,3,0,2,1,3,2,1,1,1885,6,827
"14663","부곡동","관내사전투표","대통령선거","강원도","동해시",877,877,274,297,155,71,66,0,0,1,1,1,1,1,2,870,7,0
"14664","부곡동","부곡동제1투","대통령선거","강원도","동해시",1742,1090,242,490,236,48,65,0,0,0,0,2,1,1,0,1085,5,652
"14665","부곡동","부곡동제2투","대통령선거","강원도","동해시",1232,746,178,312,171,43,32,3,0,0,0,0,2,1,1,743,3,486
"14666","부곡동","부곡동제3투","대통령선거","강원도","동해시",1136,666,127,307,148,47,32,2,0,1,0,1,0,1,0,666,0,470
"14667","동호동","관내사전투표","대통령선거","강원도","동해시",489,489,182,172,78,29,21,0,0,1,0,1,0,0,3,487,2,0
"14668","동호동","동호동제1투","대통령선거","강원도","동해시",1332,765,148,393,145,36,31,1,0,1,1,1,1,0,0,758,7,567
"14669","동호동","동호동제2투","대통령선거","강원도","동해시",1767,1053,215,517,204,54,46,3,1,2,1,1,2,3,1,1050,3,714
"14670","발한동","관내사전투표","대통령선거","강원도","동해시",691,691,234,266,107,37,41,1,0,2,0,1,0,0,1,690,1,0
"14671","발한동","발한동제1투","대통령선거","강원도","동해시",1399,793,162,415,148,36,21,1,0,1,1,0,3,1,0,789,4,606
"14672","발한동","발한동제2투","대통령선거","강원도","동해시",1687,1022,197,510,223,35,42,1,1,1,0,0,0,2,3,1015,7,665
"14673","묵호동","관내사전투표","대통령선거","강원도","동해시",379,379,127,162,52,20,13,0,0,0,0,0,0,0,2,376,3,0
"14674","묵호동","묵호동제1투","대통령선거","강원도","동해시",2038,1183,249,610,213,50,48,3,0,0,0,2,1,1,1,1178,5,855
"14675","묵호동","묵호동제2투","대통령선거","강원도","동해시",736,458,85,244,91,20,16,0,0,0,1,0,0,0,0,457,1,278
"14676","북평동","관내사전투표","대통령선거","강원도","동해시",1481,1481,506,516,253,96,88,3,0,1,0,1,1,2,2,1469,12,0
"14677","북평동","북평동제1투","대통령선거","강원도","동해시",1842,1147,297,491,230,61,56,3,0,1,1,0,3,2,0,1145,2,695
"14678","북평동","북평동제2투","대통령선거","강원도","동해시",1715,1097,244,515,224,56,47,1,0,0,0,2,3,0,0,1092,5,618
"14679","북평동","북평동제3투","대통령선거","강원도","동해시",2347,1614,471,588,347,111,86,1,0,2,0,2,1,0,1,1610,4,733
"14680","망상동","관내사전투표","대통령선거","강원도","동해시",486,486,152,160,102,34,36,0,0,0,0,0,0,1,0,485,1,0
"14681","망상동","망상동제1투","대통령선거","강원도","동해시",1083,694,140,362,129,34,23,2,0,1,0,0,1,1,1,694,0,389
"14682","망상동","망상동제2투","대통령선거","강원도","동해시",1821,1048,251,478,210,55,39,4,0,3,0,0,0,1,4,1045,3,773
"14683","삼화동","관내사전투표","대통령선거","강원도","동해시",511,511,142,221,68,40,35,0,0,0,1,0,1,1,0,509,2,0
"14684","삼화동","삼화동제1투","대통령선거","강원도","동해시",1350,838,166,370,186,50,56,0,1,0,0,1,0,1,0,831,7,512
"14685","삼화동","삼화동제2투","대통령선거","강원도","동해시",920,584,123,277,117,30,29,1,0,1,0,0,0,1,1,580,4,336
"14686","잘못 투입·구분된 투표지","잘못 투입·구분된 투표지","대통령선거","강원도","동해시",0,0,0,0,0,0,0,0,0,0,0,0,0,0,0,0,0,0
"14687","거소·선상투표","거소·선상투표","대통령선거","강원도","삼척시",203,182,51,50,47,12,6,1,0,1,2,1,1,2,1,175,7,21
"14688","관외사전투표","관외사전투표","대통령선거","강원도","삼척시",5482,5482,2283,909,975,590,634,7,1,3,5,5,0,2,12,5426,56,0
"14689","재외투표","재외투표","대통령선거","강원도","삼척시",189,140,91,10,14,4,15,2,0,0,0,0,0,0,0,136,4,49
"14690","도계읍","관내사전투표","대통령선거","강원도","삼척시",1377,1377,402,523,252,82,96,3,1,1,0,1,0,1,0,1362,15,0
"14691","도계읍","도계읍제1투","대통령선거","강원도","삼척시",341,227,35,104,66,7,8,0,0,0,1,0,1,1,2,225,2,114
"14692","도계읍","도계읍제2투","대통령선거","강원도","삼척시",873,384,66,214,65,25,8,1,0,0,0,0,0,0,2,381,3,489
"14693","도계읍","도계읍제3투","대통령선거","강원도","삼척시",1068,732,137,374,114,39,52,0,0,0,0,2,3,5,1,727,5,336
"14694","도계읍","도계읍제4투","대통령선거","강원도","삼척시",1584,1028,215,472,199,65,66,1,0,1,0,0,2,0,1,1022,6,556
"14695","도계읍","도계읍제5투","대통령선거","강원도","삼척시",528,298,68,133,56,17,19,2,0,0,0,0,0,1,1,297,1,230
"14696","도계읍","도계읍제6투","대통령선거","강원도","삼척시",1609,1033,242,371,219,99,91,0,0,0,0,0,0,2,3,1027,6,576
"14697","도계읍","도계읍제7투","대통령선거","강원도","삼척시",129,106,16,57,22,2,5,0,0,0,1,0,0,2,0,105,1,23
"14698","도계읍","도계읍제8투","대통령선거","강원도","삼척시",1522,983,301,299,197,75,101,0,0,0,0,1,0,2,1,977,6,539
"14699","원덕읍","관내사전투표","대통령선거","강원도","삼척시",891,891,290,348,132,55,53,1,0,1,1,4,0,0,2,887,4,0
"14700","원덕읍","원덕읍제1투","대통령선거","강원도","삼척시",1434,926,204,472,154,44,34,0,1,0,0,2,2,6,2,921,5,508
"14701","원덕읍","원덕읍제2투","대통령선거","강원도","삼척시",568,358,78,159,73,23,18,0,0,1,0,0,1,1,1,355,3,210
"14702","원덕읍","원덕읍제3투","대통령선거","강원도","삼척시",1168,708,113,380,133,28,30,3,0,3,0,1,0,5,1,697,11,460
"14703","원덕읍","원덕읍제4투","대통령선거","강원도","삼척시",414,279,79,136,49,1,8,0,0,0,0,0,4,1,1,279,0,135
"14704","원덕읍","원덕읍제5투","대통령선거","강원도","삼척시",197,126,21,80,16,4,3,0,0,0,0,0,0,1,0,125,1,71
"14705","근덕면","관내사전투표","대통령선거","강원도","삼척시",680,680,197,260,126,39,48,0,2,0,2,0,2,0,2,678,2,0
"14706","근덕면","근덕면제1투","대통령선거","강원도","삼척시",520,358,102,161,63,14,8,0,0,0,0,1,2,2,1,354,4,162
"14707","근덕면","근덕면제2투","대통령선거","강원도","삼척시",1512,902,172,472,174,44,21,0,0,0,1,0,2,2,2,890,12,610
"14708","근덕면","근덕면제3투","대통령선거","강원도","삼척시",771,518,99,268,103,18,16,1,1,0,0,1,2,2,2,513,5,253
"14709","근덕면","근덕면제4투","대통령선거","강원도","삼척시",684,454,80,247,73,26,15,1,1,1,0,1,0,3,2,450,4,230
"14710","근덕면","근덕면제5투","대통령선거","강원도","삼척시",574,440,96,217,91,26,8,0,0,0,0,0,0,1,0,439,1,134
"14711","하장면","관내사전투표","대통령선거","강원도","삼척시",148,148,46,48,30,7,13,0,1,0,0,0,1,1,1,148,0,0
"14712","하장면","하장면제1투","대통령선거","강원도","삼척시",440,287,89,107,72,7,9,0,0,0,0,0,1,0,1,286,1,153
"14713","하장면","하장면제2투","대통령선거","강원도","삼척시",240,169,33,58,54,6,11,2,0,2,0,1,0,0,1,168,1,71
"14714","하장면","하장면제3투","대통령선거","강원도","삼척시",351,243,90,86,42,11,8,0,0,0,0,0,1,0,1,239,4,108
"14715","노곡면","관내사전투표","대통령선거","강원도","삼척시",103,103,45,35,14,1,6,0,0,0,0,0,0,1,1,103,0,0
"14716","노곡면","노곡면제1투","대통령선거","강원도","삼척시",335,240,47,107,64,13,4,0,0,0,0,0,1,1,1,238,2,95
"14717","노곡면","노곡면제2투","대통령선거","강원도","삼척시",227,159,42,87,25,0,2,0,0,0,0,1,0,2,0,159,0,68
"14718","미로면","관내사전투표","대통령선거","강원도","삼척시",291,291,86,106,57,17,21,0,0,0,0,1,1,2,0,291,0,0
"14719","미로면","미로면제1투","대통령선거","강원도","삼척시",763,518,100,241,113,21,32,2,0,2,0,0,0,3,2,516,2,245
"14720","미로면","미로면제2투","대통령선거","강원도","삼척시",382,259,55,111,72,8,7,0,0,0,0,0,0,0,3,256,3,123
"14721","미로면","미로면제3투","대통령선거","강원도","삼척시",252,168,40,91,27,2,5,0,0,0,0,0,0,1,1,167,1,84
"14722","가곡면","관내사전투표","대통령선거","강원도","삼척시",142,142,48,51,30,4,8,0,0,0,0,0,1,0,0,142,0,0
"14723","가곡면","가곡면제1투","대통령선거","강원도","삼척시",248,140,31,67,21,5,10,0,0,0,0,0,0,2,0,136,4,108
"14724","가곡면","가곡면제2투","대통령선거","강원도","삼척시",255,195,46,97,39,6,3,1,0,0,1,0,0,2,0,195,0,60
"14725","신기면","관내사전투표","대통령선거","강원도","삼척시",145,145,54,55,20,5,7,1,0,0,1,0,1,1,0,145,0,0
"14726","신기면","신기면투표소","대통령선거","강원도","삼척시",477,302,57,164,43,13,16,0,0,0,0,1,0,2,2,298,4,175
"14727","남양동","관내사전투표","대통령선거","강원도","삼척시",1289,1289,499,394,202,96,83,0,0,1,0,1,2,0,0,1278,11,0
"14728","남양동","남양동제1투","대통령선거","강원도","삼척시",968,613,124,308,118,36,25,0,0,0,0,0,0,0,0,611,2,355
"14729","남양동","남양동제2투","대통령선거","강원도","삼척시",1108,744,172,377,122,39,30,1,0,1,0,1,0,0,0,743,1,364
"14730","남양동","남양동제3투","대통령선거","강원도","삼척시",1576,1114,289,489,207,60,58,4,0,0,0,1,0,0,3,1111,3,462
"14731","남양동","남양동제4투","대통령선거","강원도","삼척시",1592,1082,266,442,241,49,68,0,0,1,0,1,3,0,4,1075,7,510
"14732","남양동","남양동제5투","대통령선거","강원도","삼척시",690,451,87,234,88,14,18,1,0,1,0,1,0,4,1,449,2,239
"14733","성내동","관내사전투표","대통령선거","강원도","삼척시",1961,1961,865,460,321,145,148,3,0,4,0,2,1,3,4,1956,5,0
"14734","성내동","성내동제1투","대통령선거","강원도","삼척시",1545,1031,264,452,201,48,53,1,1,2,0,1,0,1,2,1026,5,514
"14735","성내동","성내동제2투","대통령선거","강원도","삼척시",1075,726,199,281,140,50,48,1,0,0,0,1,0,0,0,720,6,349
"14736","성내동","성내동제3투","대통령선거","강원도","삼척시",1779,1175,313,517,198,68,55,5,1,3,2,2,0,0,3,1167,8,604
"14737","성내동","성내동제4투","대통령선거","강원도","삼척시",1112,679,211,289,97,34,37,1,0,0,0,0,1,2,1,673,6,433
"14738","교동","관내사전투표","대통령선거","강원도","삼척시",2546,2546,1165,541,408,218,198,1,0,1,0,1,0,1,1,2535,11,0
"14739","교동","교동제1투","대통령선거","강원도","삼척시",2227,1572,528,473,323,133,100,0,0,1,1,1,1,3,2,1566,6,655
"14740","교동","교동제2투","대통령선거","강원도","삼척시",958,596,168,213,132,31,38,1,0,0,0,1,1,1,2,588,8,362
"14741","교동","교동제3투","대통령선거","강원도","삼척시",2704,1867,638,586,358,124,144,0,0,3,1,1,0,1,3,1859,8,837
"14742","정라동","관내사전투표","대통령선거","강원도","삼척시",405,405,117,166,69,28,22,0,0,1,0,0,0,0,0,403,2,0
"14743","정라동","정라동제1투","대통령선거","강원도","삼척시",1402,831,142,464,168,27,24,0,0,0,0,0,0,1,1,827,4,571
"14744","정라동","정라동제2투","대통령선거","강원도","삼척시",2238,1377,397,534,252,87,90,0,3,0,0,0,1,0,4,1368,9,861
"14745","정라동","정라동제3투","대통령선거","강원도","삼척시",1847,1242,488,308,253,88,93,3,0,1,1,1,0,0,1,1237,5,605
"14746","정라동","정라동제4투","대통령선거","강원도","삼척시",941,675,217,216,151,38,41,1,0,2,1,1,3,0,0,671,4,266
"14747","잘못 투입·구분된 투표지","잘못 투입·구분된 투표지","대통령선거","강원도","삼척시",0,0,0,0,0,0,0,0,0,0,0,0,0,0,0,0,0,0
"14748","거소·선상투표","거소·선상투표","대통령선거","강원도","태백시",87,81,33,23,18,3,1,0,1,0,0,0,0,0,0,79,2,6
"14749","관외사전투표","관외사전투표","대통령선거","강원도","태백시",3044,3044,1352,546,539,244,321,4,2,0,0,3,4,1,2,3018,26,0
"14750","재외투표","재외투표","대통령선거","강원도","태백시",113,89,59,7,12,0,10,0,0,0,0,0,0,1,0,89,0,24
"14751","황지동","관내사전투표","대통령선거","강원도","태백시",1765,1765,819,377,268,116,167,0,0,1,1,2,1,0,3,1755,10,0
"14752","황지동","황지동제1투","대통령선거","강원도","태백시",1890,1125,280,529,230,33,46,1,0,0,0,0,1,1,0,1121,4,765
"14753","황지동","황지동제2투","대통령선거","강원도","태백시",1627,1048,356,354,214,58,58,1,0,0,1,1,1,0,0,1044,4,579
"14754","황지동","황지동제3투","대통령선거","강원도","태백시",728,498,145,211,83,28,26,1,0,1,0,2,0,0,0,497,1,230
"14755","황연동","관내사전투표","대통령선거","강원도","태백시",895,895,321,313,160,40,45,2,0,0,1,6,0,2,1,891,4,0
"14756","황연동","황연동제1투","대통령선거","강원도","태백시",1379,819,226,324,186,39,29,0,1,2,0,2,0,2,2,813,6,560
"14757","황연동","황연동제2투","대통령선거","강원도","태백시",819,505,110,243,106,19,17,0,1,0,0,0,1,1,0,498,7,314
"14758","황연동","황연동제3투","대통령선거","강원도","태백시",1264,757,155,386,150,24,31,0,0,2,0,0,2,2,0,752,5,507
"14759","삼수동","관내사전투표","대통령선거","강원도","태백시",602,602,236,202,82,34,45,0,0,0,0,0,0,0,0,599,3,0
"14760","삼수동","삼수동제1투","대통령선거","강원도","태백시",2271,1217,374,469,229,54,76,2,0,0,1,2,0,0,2,1209,8,1054
"14761","삼수동","삼수동제2투","대통령선거","강원도","태백시",1573,985,263,414,197,48,51,1,0,3,1,1,0,2,0,981,4,588
"14762","삼수동","삼수동제3투","대통령선거","강원도","태백시",435,267,75,116,44,9,20,0,0,0,0,0,0,1,1,266,1,168
"14763","상장동","관내사전투표","대통령선거","강원도","태백시",1412,1412,652,360,201,81,111,1,0,2,0,0,0,0,1,1409,3,0
"14764","상장동","상장동제1투","대통령선거","강원도","태백시",1327,766,179,334,162,48,31,3,0,1,0,0,0,2,0,760,6,561
"14765","상장동","상장동제2투","대통령선거","강원도","태백시",2572,1780,757,469,308,104,132,2,0,1,1,1,0,0,0,1775,5,792
"14766","상장동","상장동제3투","대통령선거","강원도","태백시",1143,764,318,232,121,32,53,1,0,0,0,0,0,1,3,761,3,379
"14767","상장동","상장동제4투","대통령선거","강원도","태백시",998,606,178,258,106,34,25,0,0,2,0,0,0,3,0,606,0,392
"14768","상장동","상장동제5투","대통령선거","강원도","태백시",2055,1284,512,374,222,77,90,0,0,1,0,1,0,2,4,1283,1,771
"14769","문곡소도동","관내사전투표","대통령선거","강원도","태백시",353,353,147,105,51,26,24,0,0,0,0,0,0,0,0,353,0,0
"14770","문곡소도동","문곡소도동제1투","대통령선거","강원도","태백시",729,402,92,194,78,14,14,1,0,0,0,1,1,1,1,397,5,327
"14771","문곡소도동","문곡소도동제2투","대통령선거","강원도","태백시",967,668,186,297,114,27,35,1,2,1,1,2,0,0,0,666,2,299
"14772","문곡소도동","문곡소도동제3투","대통령선거","강원도","태백시",1090,745,224,307,139,36,34,2,0,0,2,0,0,0,0,744,1,345
"14773","장성동","관내사전투표","대통령선거","강원도","태백시",1006,1006,306,422,183,37,43,0,0,2,1,0,0,2,1,997,9,0
"14774","장성동","장성동제1투","대통령선거","강원도","태백시",604,311,68,163,59,8,8,0,0,0,0,0,0,1,0,307,4,293
"14775","장성동","장성동제2투","대통령선거","강원도","태백시",916,585,175,234,109,30,33,1,0,0,0,1,0,1,1,585,0,331
"14776","장성동","장성동제3투","대통령선거","강원도","태백시",756,500,148,220,80,21,24,2,0,0,0,1,0,2,1,499,1,256
"14777","구문소동","관내사전투표","대통령선거","강원도","태백시",523,523,185,203,70,30,32,0,0,0,0,0,0,2,1,523,0,0
"14778","구문소동","구문소동제1투","대통령선거","강원도","태백시",1219,751,184,358,116,42,40,2,0,1,0,1,0,0,1,745,6,468
"14779","구문소동","구문소동제2투","대통령선거","강원도","태백시",680,446,82,263,76,8,9,0,0,1,0,0,1,1,0,441,5,234
"14780","철암동","관내사전투표","대통령선거","강원도","태백시",411,411,139,169,56,24,16,1,1,0,0,1,0,2,0,409,2,0
"14781","철암동","철암동제1투","대통령선거","강원도","태백시",958,604,135,317,102,18,23,0,0,1,0,0,0,0,1,597,7,354
"14782","철암동","철암동제2투","대통령선거","강원도","태백시",790,487,86,253,100,22,16,1,0,2,0,0,0,2,1,483,4,303
"14783","잘못 투입·구분된 투표지","잘못 투입·구분된 투표지","대통령선거","강원도","태백시",0,0,0,0,0,0,0,0,0,0,0,0,0,0,0,0,0,0
"14784","거소·선상투표","거소·선상투표","대통령선거","강원도","정선군",89,79,26,29,18,1,4,0,0,0,0,0,0,0,0,78,1,10
"14785","관외사전투표","관외사전투표","대통령선거","강원도","정선군",2684,2684,1190,523,499,203,235,2,1,1,1,2,1,2,7,2667,17,0
"14786","재외투표","재외투표","대통령선거","강원도","정선군",82,60,32,6,9,5,7,0,0,0,0,0,0,0,0,59,1,22
"14787","정선읍","관내사전투표","대통령선거","강원도","정선군",1766,1766,820,401,267,122,131,1,1,2,1,1,0,2,6,1755,11,0
"14788","정선읍","정선읍제1투","대통령선거","강원도","정선군",1611,955,313,362,194,44,27,2,0,1,0,3,0,0,1,947,8,656
"14789","정선읍","정선읍제2투","대통령선거","강원도","정선군",1517,1011,332,408,190,37,32,1,0,0,0,3,0,1,2,1006,5,506
"14790","정선읍","정선읍제3투","대통령선거","강원도","정선군",1491,1000,403,267,206,61,50,1,4,0,0,2,0,1,1,996,4,491
"14791","정선읍","정선읍제4투","대통령선거","강원도","정선군",965,564,187,204,100,42,20,0,1,1,0,0,1,2,3,561,3,401
"14792","정선읍","정선읍제5투","대통령선거","강원도","정선군",617,429,106,204,87,13,11,0,1,0,0,1,0,2,0,425,4,188
"14793","정선읍","정선읍제6투","대통령선거","강원도","정선군",268,180,52,69,47,6,3,0,0,0,0,0,0,0,1,178,2,88
"14794","정선읍","정선읍제7투","대통령선거","강원도","정선군",286,200,69,70,39,9,5,0,0,0,0,3,0,1,0,196,4,86
"14795","고한읍","관내사전투표","대통령선거","강원도","정선군",798,798,383,189,131,43,48,0,0,0,0,0,0,1,1,796,2,0
"14796","고한읍","고한읍제1투","대통령선거","강원도","정선군",1101,450,158,148,94,19,27,0,0,0,0,0,0,0,0,446,4,651
"14797","고한읍","고한읍제2투","대통령선거","강원도","정선군",1303,781,263,287,126,47,50,0,0,0,0,2,1,0,0,776,5,522
"14798","고한읍","고한읍제3투","대통령선거","강원도","정선군",653,390,124,154,71,15,18,1,0,1,0,1,0,0,1,386,4,263
"14799","사북읍","관내사전투표","대통령선거","강원도","정선군",727,727,344,177,104,37,58,1,1,0,0,2,1,1,0,726,1,0
"14800","사북읍","사북읍제1투","대통령선거","강원도","정선군",2234,1312,403,480,265,68,80,0,0,1,1,1,1,0,1,1301,11,922
"14801","사북읍","사북읍제2투","대통령선거","강원도","정선군",1121,655,148,328,111,30,30,0,0,0,0,1,0,1,3,652,3,466
"14802","신동읍","관내사전투표","대통령선거","강원도","정선군",359,359,162,85,75,18,14,0,1,0,0,0,0,0,0,355,4,0
"14803","신동읍","신동읍제1투","대통령선거","강원도","정선군",1044,695,208,270,141,23,33,4,0,0,1,1,1,3,3,688,7,349
"14804","신동읍","신동읍제2투","대통령선거","강원도","정선군",931,566,147,216,130,31,26,3,1,4,1,2,0,1,0,562,4,365
"14805","신동읍","신동읍제3투","대통령선거","강원도","정선군",368,243,54,117,49,12,4,0,1,1,0,0,2,0,1,241,2,125
"14806","신동읍","신동읍제4투","대통령선거","강원도","정선군",364,249,82,95,54,4,8,0,0,1,0,2,0,0,0,246,3,115
"14807","화암면","관내사전투표","대통령선거","강원도","정선군",175,175,62,71,22,10,8,0,0,0,0,0,0,1,1,175,0,0
"14808","화암면","화암면제1투","대통령선거","강원도","정선군",967,613,185,270,103,19,27,0,0,0,0,0,1,4,0,609,4,354
"14809","화암면","화암면제2투","대통령선거","강원도","정선군",223,137,40,61,20,5,7,0,0,0,0,0,1,3,0,137,0,86
"14810","남면","관내사전투표","대통령선거","강원도","정선군",363,363,158,112,57,12,21,0,0,0,0,0,1,0,1,362,1,0
"14811","남면","남면제1투","대통령선거","강원도","정선군",657,382,123,149,68,7,21,1,0,0,0,3,0,4,3,379,3,275
"14812","남면","남면제2투","대통령선거","강원도","정선군",1381,883,241,387,179,30,31,1,0,1,0,0,2,3,1,876,7,498
"14813","남면","남면제3투","대통령선거","강원도","정선군",363,241,85,80,51,12,8,0,0,0,0,1,1,1,1,240,1,122
"14814","여량면","관내사전투표","대통령선거","강원도","정선군",287,287,118,97,40,12,12,1,0,1,0,3,0,2,1,287,0,0
"14815","여량면","여량면제1투","대통령선거","강원도","정선군",1229,823,170,431,156,28,18,1,0,3,0,1,1,1,7,817,6,406
"14816","여량면","여량면제2투","대통령선거","강원도","정선군",218,144,32,84,22,4,0,0,0,0,0,0,0,0,1,143,1,74
"14817","북평면","관내사전투표","대통령선거","강원도","정선군",363,363,142,107,81,15,16,0,0,0,0,0,0,0,1,362,1,0
"14818","북평면","북평면제1투","대통령선거","강원도","정선군",1213,781,215,329,170,36,23,1,3,0,0,0,2,0,0,779,2,432
"14819","북평면","북평면제2투","대통령선거","강원도","정선군",518,321,89,131,67,7,14,3,0,1,1,0,0,2,3,318,3,197
"14820","임계면","관내사전투표","대통령선거","강원도","정선군",481,481,165,167,87,25,29,1,0,0,0,0,0,1,3,478,3,0
"14821","임계면","임계면제1투","대통령선거","강원도","정선군",953,641,185,276,112,28,23,5,0,1,0,0,0,4,5,639,2,312
"14822","임계면","임계면제2투","대통령선거","강원도","정선군",310,207,55,79,56,6,8,1,0,0,0,0,1,0,1,207,0,103
"14823","임계면","임계면제3투","대통령선거","강원도","정선군",658,428,116,191,85,12,11,0,0,1,1,0,1,1,3,422,6,230
"14824","임계면","임계면제4투","대통령선거","강원도","정선군",341,229,38,123,51,8,7,1,0,1,0,0,0,0,0,229,0,112
"14825","임계면","임계면제5투","대통령선거","강원도","정선군",329,207,45,89,55,4,10,0,0,0,0,0,0,1,1,205,2,122
"14826","잘못 투입·구분된 투표지","잘못 투입·구분된 투표지","대통령선거","강원도","정선군",0,0,0,0,0,0,0,0,0,0,0,0,0,0,0,0,0,0
"14827","거소·선상투표","거소·선상투표","대통령선거","강원도","속초시",269,254,91,41,75,16,19,2,1,0,2,0,0,1,0,248,6,15
"14828","관외사전투표","관외사전투표","대통령선거","강원도","속초시",5138,5138,2081,851,1091,494,535,7,5,1,1,9,2,4,16,5097,41,0
"14829","재외투표","재외투표","대통령선거","강원도","속초시",261,200,109,21,22,15,31,0,0,0,0,0,0,0,1,199,1,61
"14830","영랑동","관내사전투표","대통령선거","강원도","속초시",938,938,368,278,157,65,63,1,0,0,0,0,1,0,2,935,3,0
"14831","영랑동","영랑동제1투","대통령선거","강원도","속초시",1376,857,216,355,195,46,40,1,0,0,0,0,0,2,0,855,2,519
"14832","영랑동","영랑동제2투","대통령선거","강원도","속초시",2308,1400,371,555,314,80,61,4,0,2,3,1,0,2,1,1394,6,908
"14833","동명동","관내사전투표","대통령선거","강원도","속초시",393,393,146,127,61,30,22,0,0,0,0,0,1,1,0,388,5,0
"14834","동명동","동명동제1투","대통령선거","강원도","속초시",1424,818,206,292,212,59,38,4,0,0,0,2,0,2,2,817,1,606
"14835","동명동","동명동제2투","대통령선거","강원도","속초시",1018,621,151,287,123,32,24,0,0,1,0,1,0,0,1,620,1,397
"14836","금호동","관내사전투표","대통령선거","강원도","속초시",914,914,271,319,201,56,62,1,0,0,0,0,1,0,1,912,2,0
"14837","금호동","금호동제1투","대통령선거","강원도","속초시",1282,691,147,297,170,42,29,1,0,1,0,0,0,0,1,688,3,591
"14838","금호동","금호동제2투","대통령선거","강원도","속초시",942,535,126,240,108,38,17,1,0,0,0,0,0,0,1,531,4,407
"14839","금호동","금호동제3투","대통령선거","강원도","속초시",1165,711,180,290,167,32,36,0,0,1,0,1,0,3,0,710,1,454
"14840","금호동","금호동제4투","대통령선거","강원도","속초시",1374,944,299,302,212,74,48,5,0,2,1,0,0,0,0,943,1,430
"14841","교동","관내사전투표","대통령선거","강원도","속초시",1757,1757,675,399,361,134,173,3,0,0,0,0,0,0,4,1749,8,0
"14842","교동","교동제1투","대통령선거","강원도","속초시",1277,648,153,274,140,49,23,1,0,0,0,1,2,1,1,645,3,629
"14843","교동","교동제2투","대통령선거","강원도","속초시",2332,1483,480,408,377,110,100,2,0,0,0,0,0,0,2,1479,4,849
"14844","교동","교동제3투","대통령선거","강원도","속초시",1701,1019,287,314,269,70,71,1,0,0,0,0,0,0,2,1014,5,682
"14845","교동","교동제4투","대통령선거","강원도","속초시",1489,880,191,364,224,61,35,0,0,2,0,0,0,0,0,877,3,609
"14846","노학동","관내사전투표","대통령선거","강원도","속초시",2751,2751,1065,690,576,216,177,4,0,2,1,1,0,1,4,2737,14,0
"14847","노학동","노학동제1투","대통령선거","강원도","속초시",2865,1723,537,508,429,146,91,1,0,0,0,0,0,1,1,1714,9,1142
"14848","노학동","노학동제2투","대통령선거","강원도","속초시",2286,1430,403,532,305,97,81,4,0,0,0,0,1,1,1,1425,5,856
"14849","노학동","노학동제3투","대통령선거","강원도","속초시",2635,1482,444,443,374,117,89,4,0,3,0,2,1,0,2,1479,3,1153
"14850","노학동","노학동제4투","대통령선거","강원도","속초시",1545,921,273,312,213,59,57,2,0,0,1,1,0,0,0,918,3,624
"14851","노학동","노학동제5투","대통령선거","강원도","속초시",1853,1060,256,443,259,54,41,0,0,1,0,0,0,1,1,1056,4,793
"14852","노학동","노학동제6투","대통령선거","강원도","속초시",2579,1763,580,412,481,156,121,3,0,1,1,0,0,0,2,1757,6,816
"14853","조양동","관내사전투표","대통령선거","강원도","속초시",2576,2576,1177,445,485,196,249,3,2,1,0,1,1,3,2,2565,11,0
"14854","조양동","조양동제1투","대통령선거","강원도","속초시",1127,664,163,253,174,35,28,3,0,1,0,1,1,1,0,660,4,463
"14855","조양동","조양동제2투","대통령선거","강원도","속초시",2278,1429,486,328,394,105,110,1,0,2,0,0,0,0,0,1426,3,849
"14856","조양동","조양동제3투","대통령선거","강원도","속초시",2092,1163,338,319,316,86,89,0,0,2,2,0,1,1,1,1155,8,929
"14857","조양동","조양동제4투","대통령선거","강원도","속초시",3062,1866,572,479,519,133,147,4,0,2,1,2,0,1,1,1861,5,1196
"14858","조양동","조양동제5투","대통령선거","강원도","속초시",2496,1624,525,457,436,116,86,1,0,0,0,0,1,0,0,1622,2,872
"14859","조양동","조양동제6투","대통령선거","강원도","속초시",2481,1596,496,491,405,101,100,1,0,0,0,0,0,0,0,1594,2,885
"14860","조양동","조양동제7투","대통령선거","강원도","속초시",1533,938,300,212,258,81,82,0,0,0,0,0,2,1,0,936,2,595
"14861","청호동","관내사전투표","대통령선거","강원도","속초시",484,484,137,157,112,46,29,1,0,0,0,0,0,0,0,482,2,0
"14862","청호동","청호동제1투","대통령선거","강원도","속초시",1807,957,185,419,236,48,45,3,0,2,0,0,4,0,1,943,14,850
"14863","청호동","청호동제2투","대통령선거","강원도","속초시",894,520,139,185,133,37,17,2,0,1,1,0,1,2,0,518,2,374
"14864","대포동","관내사전투표","대통령선거","강원도","속초시",300,300,107,87,62,19,24,0,0,0,0,0,0,0,0,299,1,0
"14865","대포동","대포동제1투","대통령선거","강원도","속초시",987,632,136,287,152,34,19,1,0,0,0,0,0,2,0,631,1,355
"14866","대포동","대포동제2투","대통령선거","강원도","속초시",1482,905,178,410,233,37,34,1,1,0,0,0,0,2,1,897,8,577
"14867","잘못 투입·구분된 투표지","잘못 투입·구분된 투표지","대통령선거","강원도","속초시",0,0,0,0,0,0,0,0,0,0,0,0,0,0,0,0,0,0
"14868","거소·선상투표","거소·선상투표","대통령선거","강원도","고성군",289,283,93,48,58,48,13,0,0,0,0,0,0,0,2,262,21,6
"14869","관외사전투표","관외사전투표","대통령선거","강원도","고성군",2312,2311,996,367,456,211,243,2,1,3,0,4,0,1,5,2289,22,1
"14870","재외투표","재외투표","대통령선거","강원도","고성군",59,44,27,5,8,2,2,0,0,0,0,0,0,0,0,44,0,15
"14871","간성읍","관내사전투표","대통령선거","강원도","고성군",1357,1357,527,299,254,140,115,3,0,0,0,2,1,0,7,1348,9,0
"14872","간성읍","간성읍제1투","대통령선거","강원도","고성군",1134,698,211,256,145,39,32,1,0,2,0,0,1,0,3,690,8,436
"14873","간성읍","간성읍제2투","대통령선거","강원도","고성군",1815,1114,337,411,209,82,55,5,0,2,1,1,0,1,5,1109,5,701
"14874","간성읍","간성읍제3투","대통령선거","강원도","고성군",873,576,178,232,108,23,27,0,0,0,0,1,1,2,1,573,3,297
"14875","간성읍","간성읍제4투","대통령선거","강원도","고성군",238,169,44,76,39,2,2,0,0,1,0,1,0,0,0,165,4,69
"14876","간성읍","간성읍제5투","대통령선거","강원도","고성군",187,136,34,61,25,8,5,0,1,1,0,0,0,1,0,136,0,51
"14877","거진읍","관내사전투표","대통령선거","강원도","고성군",654,654,231,183,131,59,37,1,0,1,0,0,0,1,2,646,8,0
"14878","거진읍","거진읍제1투","대통령선거","강원도","고성군",1245,819,197,369,175,35,29,0,0,1,0,0,2,2,3,813,6,426
"14879","거진읍","거진읍제2투","대통령선거","강원도","고성군",1060,678,146,313,164,32,10,0,0,1,0,1,0,1,3,671,7,382
"14880","거진읍","거진읍제3투","대통령선거","강원도","고성군",701,395,120,148,85,25,11,0,0,2,0,1,0,0,1,393,2,306
"14881","거진읍","거진읍제4투","대통령선거","강원도","고성군",324,228,69,108,30,9,9,0,0,0,0,0,1,0,0,226,2,96
"14882","거진읍","거진읍제5투","대통령선거","강원도","고성군",541,340,104,122,75,22,11,0,0,0,0,0,1,0,1,336,4,201
"14883","거진읍","거진읍제6투","대통령선거","강원도","고성군",1144,743,190,306,178,38,20,1,0,0,0,3,1,3,0,740,3,401
"14884","현내면","관내사전투표","대통령선거","강원도","고성군",234,234,124,36,42,18,10,0,0,0,0,0,0,0,0,230,4,0
"14885","현내면","현내면제1투","대통령선거","강원도","고성군",656,434,126,167,103,17,11,3,0,1,0,0,0,0,3,431,3,222
"14886","현내면","현내면제2투","대통령선거","강원도","고성군",707,472,98,245,95,12,14,2,0,2,0,0,0,0,1,469,3,235
"14887","현내면","현내면제3투","대통령선거","강원도","고성군",347,258,70,99,63,16,7,0,0,0,0,0,0,2,0,257,1,89
"14888","현내면","현내면제4투","대통령선거","강원도","고성군",266,198,55,100,27,6,5,0,1,0,1,1,0,1,0,197,1,68
"14889","죽왕면","관내사전투표","대통령선거","강원도","고성군",475,475,174,126,102,34,30,1,0,0,1,0,0,1,1,470,5,0
"14890","죽왕면","죽왕면제1투","대통령선거","강원도","고성군",810,498,117,223,110,29,13,1,0,1,0,0,0,0,0,494,4,312
"14891","죽왕면","죽왕면제2투","대통령선거","강원도","고성군",540,331,80,132,79,22,11,0,1,1,0,1,0,0,1,328,3,209
"14892","죽왕면","죽왕면제3투","대통령선거","강원도","고성군",987,697,169,313,123,37,43,0,1,5,0,0,0,2,1,694,3,290
"14893","죽왕면","죽왕면제4투","대통령선거","강원도","고성군",447,287,70,145,53,9,7,0,0,0,0,0,1,2,0,287,0,160
"14894","토성면","관내사전투표","대통령선거","강원도","고성군",1091,1091,329,325,263,91,55,1,1,1,1,0,1,2,4,1074,17,0
"14895","토성면","토성면제1투","대통령선거","강원도","고성군",2028,1206,274,461,319,63,73,2,0,2,1,0,1,0,1,1197,9,822
"14896","토성면","토성면제2투","대통령선거","강원도","고성군",1023,680,126,321,162,41,21,0,0,0,0,0,1,1,0,673,7,343
"14897","토성면","토성면제3투","대통령선거","강원도","고성군",928,608,155,248,144,35,18,0,0,0,0,0,0,2,1,603,5,320
"14898","토성면","토성면제4투","대통령선거","강원도","고성군",1165,678,193,266,139,34,40,0,2,0,0,0,0,1,1,676,2,487
"14899","잘못 투입·구분된 투표지","잘못 투입·구분된 투표지","대통령선거","강원도","고성군",0,0,0,0,0,0,0,0,0,0,0,0,0,0,0,0,0,0
"14900","거소·선상투표","거소·선상투표","대통령선거","강원도","양양군",56,54,24,11,13,0,3,0,1,0,0,0,0,0,1,53,1,2
"14901","관외사전투표","관외사전투표","대통령선거","강원도","양양군",1909,1908,798,384,402,145,159,2,0,2,1,1,0,0,2,1896,12,1
"14902","재외투표","재외투표","대통령선거","강원도","양양군",73,55,33,4,10,1,6,0,0,0,0,0,0,0,0,54,1,18
"14903","양양읍","관내사전투표","대통령선거","강원도","양양군",1909,1909,709,568,359,118,133,1,0,2,0,2,3,3,3,1901,8,0
"14904","양양읍","양양읍제1투","대통령선거","강원도","양양군",2652,1708,463,632,364,116,107,2,5,2,1,1,1,1,2,1697,11,944
"14905","양양읍","양양읍제2투","대통령선거","강원도","양양군",1959,1254,338,496,275,71,63,2,0,0,0,1,1,1,2,1250,4,705
"14906","양양읍","양양읍제3투","대통령선거","강원도","양양군",1157,772,158,386,152,42,30,0,0,0,0,0,0,1,0,769,3,385
"14907","양양읍","양양읍제4투","대통령선거","강원도","양양군",719,484,131,190,102,32,22,1,0,0,0,2,0,0,0,480,4,235
"14908","양양읍","양양읍제5투","대통령선거","강원도","양양군",650,475,102,189,131,25,17,3,1,0,1,0,1,0,0,470,5,175
"14909","서면","관내사전투표","대통령선거","강원도","양양군",378,378,113,129,77,24,27,1,0,0,0,1,1,0,3,376,2,0
"14910","서면","서면제1투","대통령선거","강원도","양양군",962,643,129,284,139,35,20,3,2,2,3,1,1,2,2,623,20,319
"14911","서면","서면제2투","대통령선거","강원도","양양군",527,362,73,162,76,27,18,0,0,1,0,0,0,1,0,358,4,165
"14912","서면","서면제3투","대통령선거","강원도","양양군",355,244,47,100,69,10,10,0,0,0,1,0,2,0,1,240,4,111
"14913","서면","서면제4투","대통령선거","강원도","양양군",326,222,43,125,38,12,2,0,0,0,0,0,0,1,0,221,1,104
"14914","손양면","관내사전투표","대통령선거","강원도","양양군",229,229,88,59,51,13,16,0,0,0,0,0,0,0,0,227,2,0
"14915","손양면","손양면제1투","대통령선거","강원도","양양군",991,702,173,273,165,43,34,2,1,1,4,2,0,1,1,700,2,289
"14916","손양면","손양면제2투","대통령선거","강원도","양양군",748,513,128,237,96,24,23,1,0,0,0,0,0,1,0,510,3,235
"14917","현북면","관내사전투표","대통령선거","강원도","양양군",284,284,105,71,61,22,20,0,0,0,0,2,1,0,0,282,2,0
"14918","현북면","현북면제1투","대통령선거","강원도","양양군",906,612,126,266,156,32,26,0,0,2,0,0,0,1,1,610,2,294
"14919","현북면","현북면제2투","대통령선거","강원도","양양군",377,287,86,99,74,11,11,1,0,0,0,0,0,0,2,284,3,90
"14920","현북면","현북면제3투","대통령선거","강원도","양양군",383,270,61,110,76,10,9,1,0,0,0,0,0,1,0,268,2,113
"14921","현북면","현북면제4투","대통령선거","강원도","양양군",290,208,39,89,56,7,11,0,0,0,0,0,4,0,1,207,1,82
"14922","현남면","관내사전투표","대통령선거","강원도","양양군",431,431,109,193,71,18,34,2,1,1,0,0,2,0,0,431,0,0
"14923","현남면","현남면제1투","대통령선거","강원도","양양군",801,501,116,244,105,16,9,5,0,0,0,0,0,3,0,498,3,300
"14924","현남면","현남면제2투","대통령선거","강원도","양양군",857,588,132,269,138,25,14,3,0,1,2,1,0,1,1,587,1,269
"14925","현남면","현남면제3투","대통령선거","강원도","양양군",529,352,78,181,66,7,11,2,1,0,1,0,0,2,1,350,2,177
"14926","강현면","관내사전투표","대통령선거","강원도","양양군",437,437,142,133,96,28,32,0,0,0,0,0,0,0,1,432,5,0
"14927","강현면","강현면제1투","대통령선거","강원도","양양군",1150,720,162,293,168,51,37,3,0,1,0,0,0,0,0,715,5,430
"14928","강현면","강현면제2투","대통령선거","강원도","양양군",669,469,133,168,94,39,28,0,0,4,0,0,0,0,0,466,3,200
"14929","강현면","강현면제3투","대통령선거","강원도","양양군",327,200,57,84,39,10,6,0,0,0,0,0,1,0,0,197,3,127
"14930","강현면","강현면제4투","대통령선거","강원도","양양군",812,582,121,258,149,30,16,2,0,3,0,0,0,2,0,581,1,230
"14931","잘못 투입·구분된 투표지","잘못 투입·구분된 투표지","대통령선거","강원도","양양군",0,0,0,0,0,0,0,0,0,0,0,0,0,0,0,0,0,0
"14932","거소·선상투표","거소·선상투표","대통령선거","강원도","인제군",251,242,75,26,63,32,14,0,0,2,1,0,2,1,6,222,20,9
"14933","관외사전투표","관외사전투표","대통령선거","강원도","인제군",2601,2600,1035,496,498,264,261,5,0,3,2,4,3,1,4,2576,24,1
"14934","재외투표","재외투표","대통령선거","강원도","인제군",73,62,37,2,16,0,7,0,0,0,0,0,0,0,0,62,0,11
"14935","인제읍","관내사전투표","대통령선거","강원도","인제군",1648,1648,663,378,297,153,124,2,0,1,1,1,1,2,4,1627,21,0
"14936","인제읍","인제읍제1투","대통령선거","강원도","인제군",968,609,177,216,120,55,35,0,0,0,0,0,1,0,1,605,4,359
"14937","인제읍","인제읍제2투","대통령선거","강원도","인제군",1698,1154,368,346,281,82,60,5,0,1,0,2,0,1,1,1147,7,544
"14938","인제읍","인제읍제3투","대통령선거","강원도","인제군",1882,1200,348,372,285,104,76,0,1,2,0,2,0,1,3,1194,6,682
"14939","인제읍","인제읍제4투","대통령선거","강원도","인제군",548,382,77,174,95,13,15,0,1,1,0,0,0,0,1,377,5,166
"14940","인제읍","인제읍제5투","대통령선거","강원도","인제군",423,310,78,114,73,16,25,0,0,0,0,1,0,0,1,308,2,113
"14941","남면","관내사전투표","대통령선거","강원도","인제군",687,687,254,163,151,69,35,2,0,0,0,0,2,1,3,680,7,0
"14942","남면","남면제1투","대통령선거","강원도","인제군",1623,999,282,379,227,55,38,2,0,0,0,0,2,2,2,989,10,624
"14943","남면","남면제2투","대통령선거","강원도","인제군",776,493,141,114,128,64,35,0,0,2,0,1,1,2,0,488,5,283
"14944","북면","관내사전투표","대통령선거","강원도","인제군",1336,1336,486,297,330,98,98,3,1,1,1,0,2,2,7,1326,10,0
"14945","북면","북면제1투","대통령선거","강원도","인제군",1349,812,264,239,189,54,52,0,0,1,0,1,2,0,3,805,7,537
"14946","북면","북면제2투","대통령선거","강원도","인제군",1912,1232,363,361,337,87,71,0,0,0,1,0,2,0,4,1226,6,680
"14947","북면","북면제3투","대통령선거","강원도","인제군",578,377,117,121,102,13,20,1,0,0,0,0,1,1,0,376,1,201
"14948","북면","북면제4투","대통령선거","강원도","인제군",483,318,59,143,85,15,12,0,3,0,0,0,0,0,0,317,1,165
"14949","북면","북면제5투","대통령선거","강원도","인제군",887,605,174,200,155,40,24,0,0,2,0,2,1,1,0,599,6,282
"14950","기린면","관내사전투표","대통령선거","강원도","인제군",674,674,218,155,168,72,48,1,1,1,1,0,0,2,2,669,5,0
"14951","기린면","기린면제1투","대통령선거","강원도","인제군",911,607,163,241,137,38,21,1,0,0,0,0,1,0,3,605,2,304
"14952","기린면","기린면제2투","대통령선거","강원도","인제군",346,239,39,109,60,15,13,0,0,0,0,0,0,0,1,237,2,107
"14953","기린면","기린면제3투","대통령선거","강원도","인제군",310,227,45,120,38,12,10,0,0,1,0,0,0,0,0,226,1,83
"14954","기린면","기린면제4투","대통령선거","강원도","인제군",263,177,42,67,50,8,6,0,0,1,0,0,1,1,1,177,0,86
"14955","기린면","기린면제5투","대통령선거","강원도","인제군",429,322,79,104,71,9,17,5,4,0,5,2,1,1,5,303,19,107
"14956","기린면","기린면제6투","대통령선거","강원도","인제군",962,675,170,190,181,82,39,0,1,0,0,1,2,0,4,670,5,287
"14957","서화면","관내사전투표","대통령선거","강원도","인제군",637,637,218,147,123,79,44,2,0,0,0,1,0,2,8,624,13,0
"14958","서화면","서화면제1투","대통령선거","강원도","인제군",1039,702,188,217,174,62,47,2,0,0,0,0,2,1,0,693,9,337
"14959","서화면","서화면제2투","대통령선거","강원도","인제군",394,277,81,87,74,10,13,1,1,3,1,0,1,0,1,273,4,117
"14960","서화면","서화면제3투","대통령선거","강원도","인제군",253,172,44,75,35,10,4,0,0,0,0,2,0,0,1,171,1,81
"14961","상남면","관내사전투표","대통령선거","강원도","인제군",272,272,86,79,59,25,17,0,0,0,0,0,0,1,3,270,2,0
"14962","상남면","상남면제1투","대통령선거","강원도","인제군",615,403,114,162,85,20,18,0,0,0,0,0,0,1,0,400,3,212
"14963","상남면","상남면제2투","대통령선거","강원도","인제군",423,301,89,115,72,9,12,0,0,1,0,1,0,0,0,299,2,122
"14964","잘못 투입·구분된 투표지","잘못 투입·구분된 투표지","대통령선거","강원도","인제군",0,0,0,0,0,0,0,0,0,0,0,0,0,0,0,0,0,0
"14965","거소·선상투표","거소·선상투표","대통령선거","강원도","홍천군",180,170,52,48,33,9,9,2,1,1,2,0,2,1,2,162,8,10
"14966","관외사전투표","관외사전투표","대통령선거","강원도","홍천군",4812,4811,1914,1025,916,440,450,12,0,1,0,9,4,1,9,4781,30,1
"14967","재외투표","재외투표","대통령선거","강원도","홍천군",233,185,110,20,23,11,18,2,0,0,0,0,0,0,1,185,0,48
"14968","홍천읍","관내사전투표","대통령선거","강원도","홍천군",5276,5276,2015,1251,1042,459,448,9,4,2,1,5,0,1,9,5246,30,0
"14969","홍천읍","홍천읍제1투","대통령선거","강원도","홍천군",1051,667,224,193,148,55,42,0,0,0,0,0,2,1,0,665,2,384
"14970","홍천읍","홍천읍제2투","대통령선거","강원도","홍천군",1005,637,151,243,162,36,32,0,0,1,0,0,0,5,1,631,6,368
"14971","홍천읍","홍천읍제3투","대통령선거","강원도","홍천군",1631,900,272,330,177,63,46,2,1,0,1,0,0,0,0,892,8,731
"14972","홍천읍","홍천읍제4투","대통령선거","강원도","홍천군",1791,1101,347,369,247,67,57,0,0,0,3,2,1,1,2,1096,5,690
"14973","홍천읍","홍천읍제5투","대통령선거","강원도","홍천군",1517,901,250,334,211,47,47,2,0,1,0,0,0,1,0,893,8,616
"14974","홍천읍","홍천읍제6투","대통령선거","강원도","홍천군",609,395,91,166,93,20,14,1,1,0,0,1,1,1,2,391,4,214
"14975","홍천읍","홍천읍제7투","대통령선거","강원도","홍천군",2367,1607,581,389,374,116,132,1,2,1,0,0,0,0,0,1596,11,760
"14976","홍천읍","홍천읍제8투","대통령선거","강원도","홍천군",1653,1142,401,249,310,77,93,2,0,0,1,0,0,1,2,1136,6,511
"14977","홍천읍","홍천읍제9투","대통령선거","강원도","홍천군",2155,1276,375,427,300,91,64,1,0,2,0,2,1,0,2,1265,11,879
"14978","홍천읍","홍천읍제10투","대통령선거","강원도","홍천군",3022,1921,689,478,470,126,138,4,0,1,1,0,0,0,1,1908,13,1101
"14979","홍천읍","홍천읍제11투","대통령선거","강원도","홍천군",1463,898,285,286,208,55,58,0,0,1,0,1,0,0,1,895,3,565
"14980","홍천읍","홍천읍제12투","대통령선거","강원도","홍천군",2755,1813,620,454,437,171,118,1,0,3,0,1,0,1,1,1807,6,942
"14981","화촌면","관내사전투표","대통령선거","강원도","홍천군",691,691,216,208,156,46,48,0,0,1,1,2,1,1,2,682,9,0
"14982","화촌면","화촌면제1투","대통령선거","강원도","홍천군",1508,948,277,345,231,48,32,0,0,2,0,0,2,3,2,942,6,560
"14983","화촌면","화촌면제2투","대통령선거","강원도","홍천군",576,359,86,130,103,13,20,0,0,1,0,1,1,0,1,356,3,217
"14984","화촌면","화촌면제3투","대통령선거","강원도","홍천군",474,299,71,116,88,8,9,0,1,1,1,0,0,1,0,296,3,175
"14985","화촌면","화촌면제4투","대통령선거","강원도","홍천군",617,371,102,130,91,19,18,0,0,0,0,3,1,3,0,367,4,246
"14986","두촌면","관내사전투표","대통령선거","강원도","홍천군",340,340,94,129,72,24,13,1,0,0,0,0,1,1,2,337,3,0
"14987","두촌면","두촌면제1투","대통령선거","강원도","홍천군",1188,781,196,329,187,33,25,2,1,0,1,1,0,1,1,777,4,407
"14988","두촌면","두촌면제2투","대통령선거","강원도","홍천군",529,347,98,137,79,20,6,1,0,0,0,0,1,0,0,342,5,182
"14989","내촌면","관내사전투표","대통령선거","강원도","홍천군",337,337,99,118,81,9,27,0,0,0,0,1,0,0,0,335,2,0
"14990","내촌면","내촌면제1투","대통령선거","강원도","홍천군",719,443,98,193,106,16,23,1,0,1,0,0,0,0,2,440,3,276
"14991","내촌면","내촌면제2투","대통령선거","강원도","홍천군",512,343,76,157,87,10,11,0,0,0,0,0,0,0,0,341,2,169
"14992","내촌면","내촌면제3투","대통령선거","강원도","홍천군",418,278,70,95,71,15,9,1,1,0,0,1,0,4,0,267,11,140
"14993","서석면","관내사전투표","대통령선거","강원도","홍천군",568,568,191,197,116,24,33,0,0,1,0,2,2,1,0,567,1,0
"14994","서석면","서석면제1투","대통령선거","강원도","홍천군",1124,736,189,320,160,28,27,1,0,2,0,0,3,3,0,733,3,388
"14995","서석면","서석면제2투","대통령선거","강원도","홍천군",776,496,128,187,125,19,26,0,0,3,0,3,0,1,1,493,3,280
"14996","서석면","서석면제3투","대통령선거","강원도","홍천군",422,269,80,101,62,17,6,0,0,0,0,2,0,0,1,269,0,153
"14997","서석면","서석면제4투","대통령선거","강원도","홍천군",378,251,74,105,46,8,11,0,0,0,0,2,0,2,0,248,3,127
"14998","동면","관내사전투표","대통령선거","강원도","홍천군",535,535,181,169,114,25,36,0,0,2,0,4,0,1,1,533,2,0
"14999","동면","동면제1투","대통령선거","강원도","홍천군",1820,1173,314,436,283,48,57,3,2,1,1,11,2,3,1,1162,11,647
"15000","동면","동면제2투","대통령선거","강원도","홍천군",525,362,103,125,98,15,16,0,0,2,0,3,0,0,0,362,0,163
"15001","동면","동면제3투","대통령선거","강원도","홍천군",333,242,74,95,47,12,11,0,0,0,0,2,0,0,0,241,1,91
"15002","남면","관내사전투표","대통령선거","강원도","홍천군",1108,1108,379,285,251,104,62,0,0,4,0,4,2,0,5,1096,12,0
"15003","남면","남면제1투","대통령선거","강원도","홍천군",1453,876,219,295,251,46,52,0,0,1,0,2,1,1,2,870,6,577
"15004","남면","남면제2투","대통령선거","강원도","홍천군",882,509,152,176,125,28,20,0,0,1,0,0,1,0,2,505,4,373
"15005","남면","남면제3투","대통령선거","강원도","홍천군",1561,1023,278,373,262,48,47,0,1,0,0,7,1,0,0,1017,6,538
"15006","서면","관내사전투표","대통령선거","강원도","홍천군",327,327,88,108,85,23,19,2,1,0,0,0,0,0,0,326,1,0
"15007","서면","서면제1투","대통령선거","강원도","홍천군",981,625,102,288,163,34,31,1,0,1,0,2,0,2,0,624,1,356
"15008","서면","서면제2투","대통령선거","강원도","홍천군",466,305,67,130,71,17,16,0,0,0,0,1,1,1,0,304,1,161
"15009","서면","서면제3투","대통령선거","강원도","홍천군",1219,769,134,334,230,33,24,2,0,1,0,4,1,2,0,765,4,450
"15010","북방면","관내사전투표","대통령선거","강원도","홍천군",603,603,214,158,137,48,36,1,0,1,3,1,0,0,2,601,2,0
"15011","북방면","북방면제1투","대통령선거","강원도","홍천군",1549,1009,250,412,227,57,50,0,0,2,1,0,2,2,2,1005,4,540
"15012","북방면","북방면제2투","대통령선거","강원도","홍천군",693,464,115,203,103,24,13,1,0,0,0,0,1,0,2,462,2,229
"15013","북방면","북방면제3투","대통령선거","강원도","홍천군",468,317,86,107,96,13,12,0,0,0,0,0,0,0,0,314,3,151
"15014","내면","관내사전투표","대통령선거","강원도","홍천군",363,363,137,90,78,25,24,1,1,6,0,0,0,0,0,362,1,0
"15015","내면","내면제1투","대통령선거","강원도","홍천군",1213,774,252,231,201,45,29,1,2,1,0,1,1,0,1,765,9,439
"15016","내면","내면제2투","대통령선거","강원도","홍천군",601,377,98,149,103,12,13,1,1,0,0,0,0,0,0,377,0,224
"15017","내면","내면제3투","대통령선거","강원도","홍천군",485,330,86,126,86,22,9,1,0,0,0,0,0,0,0,330,0,155
"15018","잘못 투입·구분된 투표지","잘못 투입·구분된 투표지","대통령선거","강원도","홍천군",0,0,0,0,0,0,0,0,0,0,0,0,0,0,0,0,0,0
"15019","거소·선상투표","거소·선상투표","대통령선거","강원도","횡성군",89,82,34,16,24,4,1,1,0,0,0,0,0,0,1,81,1,7
"15020","관외사전투표","관외사전투표","대통령선거","강원도","횡성군",3742,3741,1532,739,765,324,329,11,1,3,1,3,2,0,6,3716,25,1
"15021","재외투표","재외투표","대통령선거","강원도","횡성군",190,147,88,11,19,5,22,1,0,0,0,0,0,0,0,146,1,43
"15022","횡성읍","관내사전투표","대통령선거","강원도","횡성군",3163,3163,1214,912,542,208,242,7,2,4,2,5,0,2,5,3145,18,0
"15023","횡성읍","횡성읍제1투","대통령선거","강원도","횡성군",3322,2035,603,715,471,116,99,4,1,1,0,4,3,2,7,2026,9,1287
"15024","횡성읍","횡성읍제2투","대통령선거","강원도","횡성군",565,364,98,142,84,19,14,1,0,1,0,0,2,1,2,364,0,201
"15025","횡성읍","횡성읍제3투","대통령선거","강원도","횡성군",550,332,81,131,86,14,13,3,1,1,0,0,0,0,1,331,1,218
"15026","횡성읍","횡성읍제4투","대통령선거","강원도","횡성군",960,626,125,299,121,38,32,5,0,0,0,0,1,0,1,622,4,334
"15027","횡성읍","횡성읍제5투","대통령선거","강원도","횡성군",2934,1769,486,670,393,99,107,5,0,1,0,0,0,0,1,1762,7,1165
"15028","횡성읍","횡성읍제6투","대통령선거","강원도","횡성군",1871,1265,406,429,246,88,82,1,0,2,0,1,0,2,0,1257,8,606
"15029","횡성읍","횡성읍제7투","대통령선거","강원도","횡성군",1947,1257,365,434,266,103,80,1,0,0,0,1,1,1,0,1252,5,690
"15030","우천면","관내사전투표","대통령선거","강원도","횡성군",530,530,170,161,130,32,29,3,0,0,0,2,0,1,0,528,2,0
"15031","우천면","우천면제1투","대통령선거","강원도","횡성군",1166,733,192,291,161,35,30,1,0,2,1,4,0,4,1,722,11,433
"15032","우천면","우천면제2투","대통령선거","강원도","횡성군",1069,689,134,309,177,26,33,0,1,0,0,1,2,1,1,685,4,380
"15033","우천면","우천면제3투","대통령선거","강원도","횡성군",957,631,192,247,139,26,17,3,0,0,0,0,1,0,1,626,5,326
"15034","안흥면","관내사전투표","대통령선거","강원도","횡성군",384,384,120,147,74,19,20,0,0,0,0,0,0,0,1,381,3,0
"15035","안흥면","안흥면제1투","대통령선거","강원도","횡성군",1507,998,242,436,217,56,39,0,0,0,0,0,1,3,0,994,4,509
"15036","안흥면","안흥면제2투","대통령선거","강원도","횡성군",350,234,50,113,49,9,10,0,1,0,0,0,0,1,1,234,0,116
"15037","둔내면","관내사전투표","대통령선거","강원도","횡성군",794,794,275,256,188,41,26,0,0,0,0,0,1,0,0,787,7,0
"15038","둔내면","둔내면제1투","대통령선거","강원도","횡성군",1401,873,219,314,260,35,34,3,0,0,0,0,1,1,3,870,3,528
"15039","둔내면","둔내면제2투","대통령선거","강원도","횡성군",412,286,56,113,94,11,5,1,0,0,0,1,1,0,0,282,4,126
"15040","둔내면","둔내면제3투","대통령선거","강원도","횡성군",1531,928,227,355,246,43,46,0,0,1,1,0,0,1,1,921,7,603
"15041","둔내면","둔내면제4투","대통령선거","강원도","횡성군",438,316,73,137,78,10,12,0,1,0,0,0,1,0,0,312,4,122
"15042","갑천면","관내사전투표","대통령선거","강원도","횡성군",297,297,91,103,68,16,18,0,0,1,0,0,0,0,0,297,0,0
"15043","갑천면","갑천면제1투","대통령선거","강원도","횡성군",1017,673,123,338,152,29,17,1,0,1,0,3,1,2,0,667,6,344
"15044","갑천면","갑천면제2투","대통령선거","강원도","횡성군",549,400,92,184,89,11,16,1,0,0,1,1,0,2,0,397,3,149
"15045","청일면","관내사전투표","대통령선거","강원도","횡성군",330,330,108,130,56,17,12,0,0,2,0,1,1,1,2,330,0,0
"15046","청일면","청일면제1투","대통령선거","강원도","횡성군",472,300,61,156,64,9,8,0,0,0,0,0,1,1,0,300,0,172
"15047","청일면","청일면제2투","대통령선거","강원도","횡성군",493,303,57,137,80,13,9,0,0,1,0,2,0,1,2,302,1,190
"15048","청일면","청일면제3투","대통령선거","강원도","횡성군",688,461,103,239,80,12,21,0,0,0,0,0,0,2,2,459,2,227
"15049","공근면","관내사전투표","대통령선거","강원도","횡성군",559,559,178,171,135,36,31,0,0,3,0,2,0,2,1,559,0,0
"15050","공근면","공근면제1투","대통령선거","강원도","횡성군",1592,1009,257,382,261,46,43,1,0,3,1,3,1,4,1,1003,6,583
"15051","공근면","공근면제2투","대통령선거","강원도","횡성군",845,578,145,240,132,31,22,0,0,2,0,2,1,2,0,577,1,267
"15052","서원면","관내사전투표","대통령선거","강원도","횡성군",282,282,85,111,56,11,14,2,0,1,0,0,0,0,0,280,2,0
"15053","서원면","서원면제1투","대통령선거","강원도","횡성군",864,584,149,251,121,22,33,2,0,0,0,1,0,0,2,581,3,280
"15054","서원면","서원면제2투","대통령선거","강원도","횡성군",657,459,141,163,118,16,11,1,0,1,0,0,4,0,0,455,4,198
"15055","강림면","관내사전투표","대통령선거","강원도","횡성군",285,285,91,97,61,16,16,1,0,0,0,0,1,1,1,285,0,0
"15056","강림면","강림면투표소","대통령선거","강원도","횡성군",1083,750,170,344,176,29,19,4,0,0,0,0,0,3,0,745,5,333
"15057","잘못 투입·구분된 투표지","잘못 투입·구분된 투표지","대통령선거","강원도","횡성군",0,0,0,0,0,0,0,0,0,0,0,0,0,0,0,0,0,0
"15058","거소·선상투표","거소·선상투표","대통령선거","강원도","영월군",173,147,41,32,45,5,1,3,0,3,1,3,0,1,2,137,10,26
"15059","관외사전투표","관외사전투표","대통령선거","강원도","영월군",3376,3376,1413,652,665,308,298,2,2,2,2,4,2,0,5,3355,21,0
"15060","재외투표","재외투표","대통령선거","강원도","영월군",118,82,40,5,18,4,15,0,0,0,0,0,0,0,0,82,0,36
"15061","영월읍","관내사전투표","대통령선거","강원도","영월군",3387,3387,1415,815,620,229,278,6,0,1,1,7,1,0,1,3374,13,0
"15062","영월읍","영월읍제1투","대통령선거","강원도","영월군",1616,916,253,368,189,63,37,2,0,1,0,0,0,0,0,913,3,700
"15063","영월읍","영월읍제2투","대통령선거","강원도","영월군",1839,1194,374,418,249,78,63,3,0,1,0,0,2,2,1,1191,3,645
"15064","영월읍","영월읍제3투","대통령선거","강원도","영월군",2682,1725,641,454,382,112,112,0,0,0,1,2,2,3,1,1710,15,957
"15065","영월읍","영월읍제4투","대통령선거","강원도","영월군",1648,1096,335,381,252,80,36,2,1,1,0,3,0,3,1,1095,1,552
"15066","영월읍","영월읍제5투","대통령선거","강원도","영월군",1199,826,248,323,170,41,40,0,0,0,0,1,0,1,0,824,2,373
"15067","영월읍","영월읍제6투","대통령선거","강원도","영월군",550,368,98,138,90,15,16,3,0,0,0,1,1,0,1,363,5,182
"15068","영월읍","영월읍제7투","대통령선거","강원도","영월군",315,196,44,89,47,6,6,0,0,0,0,0,0,3,0,195,1,119
"15069","영월읍","영월읍제8투","대통령선거","강원도","영월군",1322,849,255,299,192,55,37,2,0,3,0,0,0,3,0,846,3,473
"15070","영월읍","영월읍제9투","대통령선거","강원도","영월군",1584,1007,286,384,244,37,42,1,0,3,1,2,0,0,0,1000,7,577
"15071","상동읍","관내사전투표","대통령선거","강원도","영월군",186,186,58,63,40,4,13,0,0,1,0,0,0,0,2,181,5,0
"15072","상동읍","상동읍제1투","대통령선거","강원도","영월군",235,133,44,52,21,7,8,0,0,0,0,0,0,0,1,133,0,102
"15073","상동읍","상동읍제2투","대통령선거","강원도","영월군",284,188,38,94,35,13,6,0,0,0,0,0,1,0,1,188,0,96
"15074","상동읍","상동읍제3투","대통령선거","강원도","영월군",309,215,49,99,43,4,10,1,0,1,0,0,2,1,3,213,2,94
"15075","중동면","관내사전투표","대통령선거","강원도","영월군",198,198,59,72,39,15,8,0,0,1,0,0,1,0,0,195,3,0
"15076","중동면","중동면제1투","대통령선거","강원도","영월군",645,400,92,178,90,15,21,0,0,0,1,0,0,1,0,398,2,245
"15077","중동면","중동면제2투","대통령선거","강원도","영월군",498,334,71,163,64,19,10,0,0,0,0,1,1,1,1,331,3,164
"15078","김삿갓면","관내사전투표","대통령선거","강원도","영월군",243,243,86,65,62,12,13,0,0,0,1,0,1,0,0,240,3,0
"15079","김삿갓면","김삿갓면제1투","대통령선거","강원도","영월군",686,444,120,151,130,19,14,0,1,1,0,0,1,3,3,443,1,242
"15080","김삿갓면","김삿갓면제2투","대통령선거","강원도","영월군",524,353,80,167,82,8,9,1,0,0,0,0,1,1,0,349,4,171
"15081","북면","관내사전투표","대통령선거","강원도","영월군",266,266,79,86,65,12,19,1,0,0,0,2,0,1,0,265,1,0
"15082","북면","북면제1투","대통령선거","강원도","영월군",635,381,95,166,85,19,13,1,0,1,0,0,0,0,0,380,1,254
"15083","북면","북면제2투","대통령선거","강원도","영월군",580,374,85,177,78,14,18,0,0,0,0,0,0,0,0,372,2,206
"15084","북면","북면제3투","대통령선거","강원도","영월군",441,276,68,100,88,6,12,0,0,0,0,1,0,0,1,276,0,165
"15085","남면","관내사전투표","대통령선거","강원도","영월군",376,376,132,101,91,18,24,3,0,1,0,0,1,0,1,372,4,0
"15086","남면","남면제1투","대통령선거","강원도","영월군",964,634,129,268,183,28,17,1,0,1,0,2,0,4,1,634,0,330
"15087","남면","남면제2투","대통령선거","강원도","영월군",439,301,84,134,63,8,8,0,0,0,1,1,1,0,1,301,0,138
"15088","남면","남면제3투","대통령선거","강원도","영월군",214,165,55,51,39,12,5,1,0,0,0,0,0,1,0,164,1,49
"15089","한반도면","관내사전투표","대통령선거","강원도","영월군",252,252,82,80,43,20,25,1,0,0,1,0,0,0,0,252,0,0
"15090","한반도면","한반도면제1투","대통령선거","강원도","영월군",796,529,130,214,130,25,26,0,0,0,0,0,1,1,0,527,2,267
"15091","한반도면","한반도면제2투","대통령선거","강원도","영월군",1485,1051,208,487,264,42,31,1,1,1,0,2,0,4,2,1043,8,434
"15092","주천면","관내사전투표","대통령선거","강원도","영월군",574,574,173,219,124,23,30,2,1,0,0,0,0,1,0,573,1,0
"15093","주천면","주천면제1투","대통령선거","강원도","영월군",1654,1034,209,464,243,61,39,0,1,0,2,0,0,4,4,1027,7,620
"15094","주천면","주천면제2투","대통령선거","강원도","영월군",323,218,42,102,50,9,13,1,0,0,0,0,0,0,0,217,1,105
"15095","주천면","주천면제3투","대통령선거","강원도","영월군",746,520,130,194,138,27,16,0,1,1,0,0,1,3,5,516,4,226
"15096","무릉도원면","관내사전투표","대통령선거","강원도","영월군",192,192,41,70,52,12,15,1,0,0,0,0,1,0,0,192,0,0
"15097","무릉도원면","무릉도원면제1투","대통령선거","강원도","영월군",772,491,110,200,139,21,16,0,0,0,0,1,2,1,0,490,1,281
"15098","무릉도원면","무릉도원면제2투","대통령선거","강원도","영월군",579,428,75,204,109,26,4,1,0,0,0,1,2,4,1,427,1,151
"15099","잘못 투입·구분된 투표지","잘못 투입·구분된 투표지","대통령선거","강원도","영월군",0,0,0,0,0,0,0,0,0,0,0,0,0,0,0,0,0,0
"15100","거소·선상투표","거소·선상투표","대통령선거","강원도","평창군",92,87,36,14,28,5,0,0,1,0,0,1,1,0,0,86,1,5
"15101","관외사전투표","관외사전투표","대통령선거","강원도","평창군",3534,3534,1384,822,682,300,310,5,2,0,1,0,1,4,3,3514,20,0
"15102","재외투표","재외투표","대통령선거","강원도","평창군",166,125,71,8,20,8,17,1,0,0,0,0,0,0,0,125,0,41
"15103","평창읍","관내사전투표","대통령선거","강원도","평창군",1476,1476,602,396,236,105,122,2,0,0,0,3,1,1,2,1470,6,0
"15104","평창읍","평창읍제1투","대통령선거","강원도","평창군",1418,872,252,333,171,51,57,1,1,0,1,0,1,0,0,868,4,546
"15105","평창읍","평창읍제2투","대통령선거","강원도","평창군",1879,1203,387,417,251,72,59,0,0,0,0,0,3,3,3,1195,8,676
"15106","평창읍","평창읍제3투","대통령선거","강원도","평창군",255,171,24,94,36,9,7,0,0,0,0,0,0,0,1,171,0,84
"15107","평창읍","평창읍제4투","대통령선거","강원도","평창군",477,343,79,126,111,8,14,0,1,0,0,0,0,0,2,341,2,134
"15108","평창읍","평창읍제5투","대통령선거","강원도","평창군",454,319,65,147,75,14,8,0,0,1,0,3,1,1,0,315,4,135
"15109","평창읍","평창읍제6투","대통령선거","강원도","평창군",480,328,69,126,108,9,11,0,0,0,0,0,0,3,0,326,2,152
"15110","평창읍","평창읍제7투","대통령선거","강원도","평창군",386,260,67,107,61,14,5,0,0,0,0,1,0,1,1,257,3,126
"15111","미탄면","관내사전투표","대통령선거","강원도","평창군",277,277,104,86,52,8,23,0,1,0,0,1,0,0,0,275,2,0
"15112","미탄면","미탄면제1투","대통령선거","강원도","평창군",989,677,194,297,118,26,29,2,0,2,0,0,1,0,4,673,4,312
"15113","미탄면","미탄면제2투","대통령선거","강원도","평창군",147,101,24,46,25,4,1,0,0,0,0,0,0,1,0,101,0,46
"15114","방림면","관내사전투표","대통령선거","강원도","평창군",255,255,96,73,47,15,15,0,0,1,1,1,0,1,1,251,4,0
"15115","방림면","방림면제1투","대통령선거","강원도","평창군",627,421,114,179,93,19,13,0,0,2,0,0,0,0,0,420,1,206
"15116","방림면","방림면제2투","대통령선거","강원도","평창군",372,275,67,115,70,10,10,1,0,0,0,0,0,1,1,275,0,97
"15117","방림면","방림면제3투","대통령선거","강원도","평창군",822,555,151,206,146,21,18,2,0,2,0,1,1,2,2,552,3,267
"15118","대화면","관내사전투표","대통령선거","강원도","평창군",836,836,295,244,187,42,56,1,0,4,0,0,0,1,1,831,5,0
"15119","대화면","대화면제1투","대통령선거","강원도","평창군",1661,1053,328,396,226,46,35,0,0,3,1,0,5,5,0,1045,8,608
"15120","대화면","대화면제2투","대통령선거","강원도","평창군",708,446,136,154,114,17,17,1,0,2,0,0,2,1,1,445,1,262
"15121","대화면","대화면제3투","대통령선거","강원도","평창군",1003,654,217,219,134,36,34,2,0,0,0,0,0,1,1,644,10,349
"15122","대화면","대화면제4투","대통령선거","강원도","평창군",264,180,44,88,37,5,4,0,0,0,0,0,1,0,0,179,1,84
"15123","봉평면","관내사전투표","대통령선거","강원도","평창군",766,766,304,204,156,34,60,0,0,0,0,0,2,1,1,762,4,0
"15124","봉평면","봉평면제1투","대통령선거","강원도","평창군",1761,1166,285,448,290,69,58,1,0,1,0,0,2,0,4,1158,8,595
"15125","봉평면","봉평면제2투","대통령선거","강원도","평창군",807,513,141,202,105,31,28,2,0,1,0,0,0,0,1,511,2,294
"15126","봉평면","봉평면제3투","대통령선거","강원도","평창군",1125,695,206,230,182,38,35,0,0,0,0,1,1,1,0,694,1,430
"15127","용평면","관내사전투표","대통령선거","강원도","평창군",312,312,114,83,70,19,24,0,0,0,0,1,1,0,0,312,0,0
"15128","용평면","용평면제1투","대통령선거","강원도","평창군",490,331,101,121,82,7,14,1,0,1,0,3,1,0,0,331,0,159
"15129","용평면","용평면제2투","대통령선거","강원도","평창군",557,388,94,161,95,16,17,0,1,0,0,0,1,2,0,387,1,169
"15130","용평면","용평면제3투","대통령선거","강원도","평창군",1109,729,166,303,175,39,37,0,1,0,0,0,0,2,1,724,5,380
"15131","진부면","관내사전투표","대통령선거","강원도","평창군",1260,1260,494,334,247,82,84,3,0,2,1,1,2,1,2,1253,7,0
"15132","진부면","진부면제1투","대통령선거","강원도","평창군",1220,734,172,280,189,38,47,0,1,0,1,0,1,1,1,731,3,486
"15133","진부면","진부면제2투","대통령선거","강원도","평창군",1636,1021,299,341,237,73,56,3,0,1,1,1,2,0,1,1015,6,615
"15134","진부면","진부면제3투","대통령선거","강원도","평창군",1704,1016,275,400,231,54,48,0,0,0,0,0,0,0,1,1009,7,688
"15135","진부면","진부면제4투","대통령선거","강원도","평창군",419,270,46,123,74,9,11,1,0,0,0,0,2,0,1,267,3,149
"15136","진부면","진부면제5투","대통령선거","강원도","평창군",451,275,57,140,57,7,10,2,0,0,0,0,0,0,1,274,1,176
"15137","진부면","진부면제6투","대통령선거","강원도","평창군",383,285,75,105,78,14,9,1,0,0,0,0,1,0,1,284,1,98
"15138","진부면","진부면제7투","대통령선거","강원도","평창군",284,191,39,67,63,10,8,0,0,0,0,1,0,0,1,189,2,93
"15139","대관령면","관내사전투표","대통령선거","강원도","평창군",755,755,282,240,121,46,59,0,0,1,0,1,0,1,1,752,3,0
"15140","대관령면","대관령면제1투","대통령선거","강원도","평창군",1709,974,246,401,228,53,40,1,0,1,0,0,0,0,0,970,4,735
"15141","대관령면","대관령면제2투","대통령선거","강원도","평창군",1787,1073,325,383,228,57,64,0,0,0,0,2,0,3,1,1063,10,714
"15142","대관령면","대관령면제3투","대통령선거","강원도","평창군",365,242,64,89,62,7,14,0,0,1,1,0,0,0,1,239,3,123
"15143","잘못 투입·구분된 투표지","잘못 투입·구분된 투표지","대통령선거","강원도","평창군",0,0,0,0,0,0,0,0,0,0,0,0,0,0,0,0,0,0
"15144","거소·선상투표","거소·선상투표","대통령선거","강원도","화천군",370,331,112,43,86,43,16,0,0,2,0,0,0,0,4,306,25,39
"15145","관외사전투표","관외사전투표","대통령선거","강원도","화천군",2389,2389,920,447,522,238,216,3,1,0,0,2,3,1,6,2359,30,0
"15146","재외투표","재외투표","대통령선거","강원도","화천군",84,60,34,3,14,1,7,1,0,0,0,0,0,0,0,60,0,24
"15147","화천읍","관내사전투표","대통령선거","강원도","화천군",1420,1420,511,373,272,129,111,0,1,0,0,1,1,3,3,1405,15,0
"15148","화천읍","화천읍제1투","대통령선거","강원도","화천군",1568,952,245,349,240,71,40,0,0,1,0,0,0,2,1,949,3,616
"15149","화천읍","화천읍제2투","대통령선거","강원도","화천군",1989,1323,368,387,338,136,73,5,0,0,1,0,1,1,3,1313,10,666
"15150","화천읍","화천읍제3투","대통령선거","강원도","화천군",639,418,86,171,102,32,19,0,1,2,0,0,3,1,0,417,1,221
"15151","화천읍","화천읍제4투","대통령선거","강원도","화천군",694,447,116,160,110,32,26,1,0,0,0,1,0,0,0,446,1,247
"15152","간동면","관내사전투표","대통령선거","강원도","화천군",383,383,132,93,92,23,34,3,0,0,0,0,0,0,0,377,6,0
"15153","간동면","간동면제1투","대통령선거","강원도","화천군",638,430,81,172,116,20,30,2,1,1,0,0,0,2,0,425,5,208
"15154","간동면","간동면제2투","대통령선거","강원도","화천군",579,394,80,172,101,17,17,0,0,1,0,1,1,1,0,391,3,185
"15155","간동면","간동면제3투","대통령선거","강원도","화천군",470,344,101,131,73,12,18,0,0,2,0,0,1,2,1,341,3,126
"15156","간동면","간동면제4투","대통령선거","강원도","화천군",155,110,20,57,21,2,6,2,0,1,0,0,0,0,0,109,1,45
"15157","하남면","관내사전투표","대통령선거","강원도","화천군",699,699,250,150,140,72,75,0,1,0,0,0,0,0,4,692,7,0
"15158","하남면","하남면제1투","대통령선거","강원도","화천군",804,533,125,213,110,48,32,0,0,0,0,0,0,2,1,531,2,271
"15159","하남면","하남면제2투","대통령선거","강원도","화천군",618,430,142,137,99,15,24,0,1,1,0,0,1,1,1,422,8,188
"15160","하남면","하남면제3투","대통령선거","강원도","화천군",296,219,40,93,49,12,19,0,0,2,0,0,0,0,0,215,4,77
"15161","상서면","관내사전투표","대통령선거","강원도","화천군",884,884,282,185,210,116,69,0,0,0,0,1,3,0,2,868,16,0
"15162","상서면","상서면제1투","대통령선거","강원도","화천군",519,369,93,126,105,20,13,0,0,1,0,3,0,1,2,364,5,150
"15163","상서면","상서면제2투","대통령선거","강원도","화천군",364,243,44,120,55,11,8,0,0,0,0,0,0,0,0,238,5,121
"15164","상서면","상서면제3투","대통령선거","강원도","화천군",368,272,59,99,84,12,11,1,0,0,0,0,0,0,2,268,4,96
"15165","상서면","상서면제4투","대통령선거","강원도","화천군",657,368,97,99,85,52,28,1,0,2,0,0,0,0,1,365,3,289
"15166","상서면","상서면제5투","대통령선거","강원도","화천군",338,223,67,57,51,27,18,0,0,0,0,0,1,0,2,223,0,115
"15167","상서면","상서면제6투","대통령선거","강원도","화천군",362,212,61,82,45,14,7,2,1,0,0,0,0,0,0,212,0,150
"15168","사내면","관내사전투표","대통령선거","강원도","화천군",1163,1163,373,289,251,120,91,5,0,2,1,3,2,0,4,1141,22,0
"15169","사내면","사내면제1투","대통령선거","강원도","화천군",2130,1378,432,398,354,114,60,5,0,1,0,1,1,1,3,1370,8,752
"15170","사내면","사내면제2투","대통령선거","강원도","화천군",574,415,124,148,101,14,21,1,0,2,0,0,0,2,0,413,2,159
"15171","사내면","사내면제3투","대통령선거","강원도","화천군",436,286,74,117,68,14,10,0,1,0,0,1,0,0,0,285,1,150
"15172","사내면","사내면제4투","대통령선거","강원도","화천군",574,388,92,148,106,24,14,0,0,0,0,0,0,1,1,386,2,186
"15173","잘못 투입·구분된 투표지","잘못 투입·구분된 투표지","대통령선거","강원도","화천군",0,0,0,0,0,0,0,0,0,0,0,0,0,0,0,0,0,0
"15174","거소·선상투표","거소·선상투표","대통령선거","강원도","양구군",289,276,101,32,70,36,12,0,1,0,1,0,2,0,3,258,18,13
"15175","관외사전투표","관외사전투표","대통령선거","강원도","양구군",1740,1740,717,320,331,159,182,2,0,0,1,1,1,1,3,1718,22,0
"15176","재외투표","재외투표","대통령선거","강원도","양구군",62,44,21,6,5,2,10,0,0,0,0,0,0,0,0,44,0,18
"15177","양구읍","관내사전투표","대통령선거","강원도","양구군",2124,2124,773,426,487,238,153,6,1,1,3,2,2,1,7,2100,24,0
"15178","양구읍","양구읍제1투","대통령선거","강원도","양구군",503,351,72,157,87,14,14,0,1,0,0,2,0,0,1,348,3,152
"15179","양구읍","양구읍제2투","대통령선거","강원도","양구군",634,430,123,123,124,36,13,0,0,1,0,1,0,3,1,425,5,204
"15180","양구읍","양구읍제3투","대통령선거","강원도","양구군",1263,861,269,240,189,87,66,0,2,1,0,0,2,1,1,858,3,402
"15181","양구읍","양구읍제4투","대통령선거","강원도","양구군",857,556,127,215,142,46,20,0,1,0,1,0,0,1,2,555,1,301
"15182","양구읍","양구읍제5투","대통령선거","강원도","양구군",2644,1757,492,482,448,184,122,0,1,5,0,1,5,1,2,1743,14,887
"15183","양구읍","양구읍제6투","대통령선거","강원도","양구군",2047,1264,358,419,308,99,63,2,0,1,0,2,2,2,4,1260,4,783
"15184","양구읍","양구읍제7투","대통령선거","강원도","양구군",128,88,18,34,26,4,3,0,0,1,0,0,0,2,0,88,0,40
"15185","양구읍","양구읍제8투","대통령선거","강원도","양구군",213,159,37,75,32,4,7,0,0,2,0,0,1,1,0,159,0,54
"15186","남면","관내사전투표","대통령선거","강원도","양구군",430,430,147,109,99,41,18,0,0,0,0,0,0,2,5,421,9,0
"15187","남면","남면제1투","대통령선거","강원도","양구군",370,246,70,88,58,17,7,0,0,2,0,1,0,0,0,243,3,124
"15188","남면","남면제2투","대통령선거","강원도","양구군",1082,697,161,281,172,37,27,0,0,2,0,6,0,2,1,689,8,385
"15189","남면","남면제3투","대통령선거","강원도","양구군",685,410,85,171,90,22,28,2,0,0,1,1,1,3,2,406,4,275
"15190","남면","남면제4투","대통령선거","강원도","양구군",359,252,57,88,65,21,18,1,0,0,0,0,1,0,0,251,1,107
"15191","동면","관내사전투표","대통령선거","강원도","양구군",438,438,148,86,101,69,20,2,0,0,0,0,1,0,0,427,11,0
"15192","동면","동면제1투","대통령선거","강원도","양구군",470,322,73,138,74,19,12,0,0,0,1,0,0,0,1,318,4,148
"15193","동면","동면제2투","대통령선거","강원도","양구군",598,417,103,145,103,31,22,0,0,1,0,0,2,2,1,410,7,181
"15194","동면","동면제3투","대통령선거","강원도","양구군",325,219,44,100,47,9,16,0,0,0,0,0,0,1,0,217,2,106
"15195","방산면","관내사전투표","대통령선거","강원도","양구군",274,274,86,54,73,27,25,0,0,0,0,0,1,0,3,269,5,0
"15196","방산면","방산면제1투","대통령선거","강원도","양구군",318,223,55,82,69,5,9,1,0,0,0,1,0,0,0,222,1,95
"15197","방산면","방산면제2투","대통령선거","강원도","양구군",337,267,51,92,94,8,14,0,0,1,0,0,1,1,2,264,3,70
"15198","방산면","방산면제3투","대통령선거","강원도","양구군",295,187,55,58,36,18,12,0,0,0,0,0,1,1,0,181,6,108
"15199","해안면","관내사전투표","대통령선거","강원도","양구군",238,238,87,53,57,17,21,0,0,0,0,0,0,0,1,236,2,0
"15200","해안면","해안면투표소","대통령선거","강원도","양구군",887,578,196,176,132,37,30,0,0,1,0,1,1,2,0,576,2,309
"15201","잘못 투입·구분된 투표지","잘못 투입·구분된 투표지","대통령선거","강원도","양구군",0,0,0,0,0,0,0,0,0,0,0,0,0,0,0,0,0,0
"15202","거소·선상투표","거소·선상투표","대통령선거","강원도","철원군",563,535,181,77,157,62,19,2,2,2,1,0,0,0,8,511,24,28
"15203","관외사전투표","관외사전투표","대통령선거","강원도","철원군",3266,3265,1257,589,707,346,308,4,1,5,0,3,0,0,13,3233,32,1
"15204","재외투표","재외투표","대통령선거","강원도","철원군",138,105,61,5,20,2,13,0,0,0,0,0,0,0,1,102,3,33
"15205","철원읍","관내사전투표","대통령선거","강원도","철원군",897,897,313,196,215,84,78,2,0,0,0,1,0,0,4,893,4,0
"15206","철원읍","철원읍제1투","대통령선거","강원도","철원군",834,483,129,182,111,21,31,0,0,0,1,0,0,1,0,476,7,351
"15207","철원읍","철원읍제2투","대통령선거","강원도","철원군",982,684,195,200,170,65,46,2,0,0,0,0,1,0,1,680,4,298
"15208","철원읍","철원읍제3투","대통령선거","강원도","철원군",224,156,46,56,36,3,9,0,0,0,0,3,0,1,1,155,1,68
"15209","철원읍","철원읍제4투","대통령선거","강원도","철원군",441,268,74,74,69,14,25,0,0,1,1,5,1,0,0,264,4,173
"15210","철원읍","철원읍제5투","대통령선거","강원도","철원군",894,513,145,186,131,21,25,0,1,0,1,0,1,0,0,511,2,381
"15211","김화읍","관내사전투표","대통령선거","강원도","철원군",579,579,195,121,129,70,51,0,1,0,1,0,0,0,2,570,9,0
"15212","김화읍","김화읍제1투","대통령선거","강원도","철원군",606,378,107,136,83,22,22,0,0,1,1,0,0,0,0,372,6,228
"15213","김화읍","김화읍제2투","대통령선거","강원도","철원군",198,146,46,50,41,4,3,0,0,0,0,0,0,0,1,145,1,52
"15214","김화읍","김화읍제3투","대통령선거","강원도","철원군",1122,782,225,261,171,72,44,0,0,1,0,0,0,3,1,778,4,340
"15215","김화읍","김화읍제4투","대통령선거","강원도","철원군",298,211,58,66,62,10,10,2,0,1,0,0,0,0,0,209,2,87
"15216","갈말읍","관내사전투표","대통령선거","강원도","철원군",1880,1880,708,420,366,198,153,0,1,0,0,0,0,1,6,1853,27,0
"15217","갈말읍","갈말읍제1투","대통령선거","강원도","철원군",1014,588,146,247,120,35,33,1,0,1,0,0,0,0,1,584,4,426
"15218","갈말읍","갈말읍제2투","대통령선거","강원도","철원군",930,623,189,221,146,39,21,0,2,0,0,0,1,1,2,622,1,307
"15219","갈말읍","갈말읍제3투","대통령선거","강원도","철원군",1009,484,98,217,105,36,14,3,0,0,0,0,1,0,2,476,8,525
"15220","갈말읍","갈말읍제4투","대통령선거","강원도","철원군",744,475,131,161,107,34,35,0,0,1,0,0,0,0,0,469,6,269
"15221","갈말읍","갈말읍제5투","대통령선거","강원도","철원군",732,493,111,205,124,26,17,0,1,0,0,2,0,0,2,488,5,239
"15222","갈말읍","갈말읍제6투","대통령선거","강원도","철원군",601,382,55,203,82,21,14,0,0,0,0,1,1,0,0,377,5,219
"15223","갈말읍","갈말읍제7투","대통령선거","강원도","철원군",1591,1104,325,362,281,59,58,1,0,3,0,1,2,1,1,1094,10,487
"15224","갈말읍","갈말읍제8투","대통령선거","강원도","철원군",1199,763,231,269,150,61,43,4,0,1,0,0,0,0,2,761,2,436
"15225","갈말읍","갈말읍제9투","대통령선거","강원도","철원군",169,131,16,66,35,6,6,0,0,0,0,0,0,0,0,129,2,38
"15226","동송읍","관내사전투표","대통령선거","강원도","철원군",1550,1550,625,308,341,114,139,1,0,1,0,0,1,0,7,1537,13,0
"15227","동송읍","동송읍제1투","대통령선거","강원도","철원군",2599,1616,492,374,502,141,90,4,0,2,0,1,0,2,2,1610,6,983
"15228","동송읍","동송읍제2투","대통령선거","강원도","철원군",1094,707,177,252,190,35,45,1,1,0,1,0,0,0,0,702,5,387
"15229","동송읍","동송읍제3투","대통령선거","강원도","철원군",1613,1036,330,289,265,67,73,3,0,2,0,0,0,0,3,1032,4,577
"15230","동송읍","동송읍제4투","대통령선거","강원도","철원군",1199,730,182,210,251,45,36,0,0,0,1,0,0,0,0,725,5,469
"15231","동송읍","동송읍제5투","대통령선거","강원도","철원군",440,291,85,92,88,6,12,0,0,2,0,0,0,1,2,288,3,149
"15232","동송읍","동송읍제6투","대통령선거","강원도","철원군",864,584,161,216,145,33,19,1,1,0,0,0,0,1,0,577,7,280
"15233","동송읍","동송읍제7투","대통령선거","강원도","철원군",519,339,76,137,92,18,12,0,0,0,0,0,1,0,0,336,3,180
"15234","동송읍","동송읍제8투","대통령선거","강원도","철원군",1330,771,222,263,184,37,55,1,0,1,0,1,0,0,0,764,7,559
"15235","동송읍","동송읍제9투","대통령선거","강원도","철원군",588,380,96,160,90,14,16,1,0,1,0,0,0,1,0,379,1,208
"15236","동송읍","동송읍제10투","대통령선거","강원도","철원군",322,219,58,82,52,6,17,0,0,0,0,1,0,0,0,216,3,103
"15237","서면","관내사전투표","대통령선거","강원도","철원군",1138,1138,380,215,312,147,59,1,0,2,0,0,1,2,2,1121,17,0
"15238","서면","서면제1투","대통령선거","강원도","철원군",1200,764,185,253,216,57,38,3,1,1,0,0,0,0,1,755,9,436
"15239","서면","서면제2투","대통령선거","강원도","철원군",1270,766,225,221,214,52,47,1,0,2,0,0,0,0,1,763,3,504
"15240","서면","서면제3투","대통령선거","강원도","철원군",1334,853,224,320,221,43,36,2,0,1,0,1,0,0,1,849,4,481
"15241","근남면","관내사전투표","대통령선거","강원도","철원군",276,276,99,58,76,18,17,1,0,1,0,0,0,1,2,273,3,0
"15242","근남면","근남면제1투","대통령선거","강원도","철원군",281,183,36,81,42,8,12,0,0,1,0,2,0,0,0,182,1,98
"15243","근남면","근남면제2투","대통령선거","강원도","철원군",708,456,140,154,106,28,18,1,0,0,0,0,1,0,1,449,7,252
"15244","근남면","근남면제3투","대통령선거","강원도","철원군",426,318,85,136,60,16,17,0,0,0,2,0,0,0,2,318,0,108
"15245","근북면","관내사전투표","대통령선거","강원도","철원군",145,145,58,21,28,28,9,0,0,0,0,0,0,0,0,144,1,0
"15246","근북면","근북면투표소","대통령선거","강원도","철원군",77,56,20,25,8,1,2,0,0,0,0,0,0,0,0,56,0,21
"15247","잘못 투입·구분된 투표지","잘못 투입·구분된 투표지","대통령선거","강원도","철원군",0,0,0,0,0,0,0,0,0,0,0,0,0,0,0,0,0,0
"15248","거소·선상투표","거소·선상투표","대통령선거","서울특별시","종로구",218,206,64,42,65,8,15,0,1,3,1,0,0,0,2,201,5,12
"15249","관외사전투표","관외사전투표","대통령선거","서울특별시","종로구",12803,12803,5842,2025,2509,1156,1145,17,0,4,2,15,6,9,6,12736,67,0
"15250","재외투표","재외투표","대통령선거","서울특별시","종로구",2490,1813,987,215,304,75,214,8,0,1,0,1,0,0,0,1805,8,677
"15251","청운효자동","관내사전투표","대통령선거","서울특별시","종로구",1784,1784,819,331,352,120,149,1,0,3,0,3,0,1,2,1781,3,0
"15252","청운효자동","청운효자동제1투","대통령선거","서울특별시","종로구",2493,1682,664,451,342,107,96,6,0,5,0,0,1,3,2,1677,5,811
"15253","청운효자동","청운효자동제2투","대통령선거","서울특별시","종로구",2644,1986,793,509,382,144,143,1,0,0,0,1,0,1,2,1976,10,658
"15254","청운효자동","청운효자동제3투","대통령선거","서울특별시","종로구",2457,1843,833,386,362,104,143,5,0,3,1,2,0,0,0,1839,4,614
"15255","사직동","관내사전투표","대통령선거","서울특별시","종로구",2008,2008,890,447,359,134,162,1,0,9,0,0,0,0,1,2003,5,0
"15256","사직동","사직동제1투","대통령선거","서울특별시","종로구",2341,1375,520,380,298,92,76,2,0,1,0,0,0,0,1,1370,5,966
"15257","사직동","사직동제2투","대통령선거","서울특별시","종로구",3264,2405,736,790,504,229,128,5,0,1,0,1,0,2,1,2397,8,859
"15258","삼청동","관내사전투표","대통령선거","서울특별시","종로구",421,421,189,97,65,23,43,1,0,0,0,1,0,0,0,419,2,0
"15259","삼청동","삼청동투표소","대통령선거","서울특별시","종로구",1850,1233,428,359,251,90,88,10,0,1,2,0,2,0,0,1231,2,617
"15260","부암동","관내사전투표","대통령선거","서울특별시","종로구",1474,1474,676,309,235,106,139,4,0,0,1,1,1,0,0,1472,2,0
"15261","부암동","부암동제1투","대통령선거","서울특별시","종로구",2329,1531,616,369,305,111,110,8,0,1,0,2,1,4,0,1527,4,798
"15262","부암동","부암동제2투","대통령선거","서울특별시","종로구",2047,1564,611,397,321,120,107,4,0,0,0,2,0,0,0,1562,2,483
"15263","부암동","부암동제3투","대통령선거","서울특별시","종로구",1852,1347,451,427,278,92,85,9,0,0,0,0,0,1,0,1343,4,505
"15264","평창동","관내사전투표","대통령선거","서울특별시","종로구",2949,2949,1154,824,533,232,184,7,0,1,0,1,1,2,1,2940,9,0
"15265","평창동","평창동제1투","대통령선거","서울특별시","종로구",2174,1427,481,440,296,116,89,1,0,0,0,1,0,0,0,1424,3,747
"15266","평창동","평창동제2투","대통령선거","서울특별시","종로구",3211,2239,631,796,461,217,115,5,0,1,0,0,0,1,2,2229,10,972
"15267","평창동","평창동제3투","대통령선거","서울특별시","종로구",1936,1433,491,440,280,127,82,5,0,0,1,0,0,3,0,1429,4,503
"15268","평창동","평창동제4투","대통령선거","서울특별시","종로구",1916,1443,555,416,243,114,96,6,0,2,0,1,1,2,0,1436,7,473
"15269","평창동","평창동제5투","대통령선거","서울특별시","종로구",1932,1390,450,446,274,111,93,9,0,2,1,0,0,0,0,1386,4,542
"15270","무악동","관내사전투표","대통령선거","서울특별시","종로구",1390,1390,625,254,308,105,81,3,0,0,1,1,1,0,0,1379,11,0
"15271","무악동","무악동제1투","대통령선거","서울특별시","종로구",1700,1350,533,304,308,105,90,2,0,2,1,0,0,0,0,1345,5,350
"15272","무악동","무악동제2투","대통령선거","서울특별시","종로구",2912,2056,795,489,482,156,120,4,0,1,1,0,0,1,0,2049,7,856
"15273","교남동","관내사전투표","대통령선거","서울특별시","종로구",1060,1060,469,191,256,71,69,2,0,0,0,1,0,0,0,1059,1,0
"15274","교남동","교남동제1투","대통령선거","서울특별시","종로구",1828,1245,483,289,336,63,65,3,0,0,1,1,0,0,1,1242,3,583
"15275","교남동","교남동제2투","대통령선거","서울특별시","종로구",987,532,217,121,128,28,34,3,0,0,1,0,0,0,0,532,0,455
"15276","교남동","교남동제3투","대통령선거","서울특별시","종로구",1125,906,338,201,219,96,44,1,0,2,2,0,0,0,2,905,1,219
"15277","가회동","관내사전투표","대통령선거","서울특별시","종로구",937,937,436,189,169,60,76,1,0,0,0,1,0,0,0,932,5,0
"15278","가회동","가회동투표소","대통령선거","서울특별시","종로구",2832,1965,783,533,410,110,106,8,0,2,1,3,0,3,2,1961,4,867
"15279","종로1·2·3·4가동","관내사전투표","대통령선거","서울특별시","종로구",902,902,398,185,189,63,63,1,0,2,0,0,0,0,0,901,1,0
"15280","종로1·2·3·4가동","종로1·2·3·4가동제1투","대통령선거","서울특별시","종로구",2972,1247,362,480,302,60,30,4,0,1,1,0,0,0,0,1240,7,1725
"15281","종로1·2·3·4가동","종로1·2·3·4가동제2투","대통령선거","서울특별시","종로구",2336,1535,551,435,347,105,88,5,0,0,0,0,1,0,0,1532,3,801
"15282","종로5·6가동","관내사전투표","대통령선거","서울특별시","종로구",861,861,334,220,200,56,46,2,0,0,2,0,0,0,0,860,1,0
"15283","종로5·6가동","종로5·6가동제1투","대통령선거","서울특별시","종로구",1720,973,286,289,278,66,43,0,1,0,1,3,0,2,0,969,4,747
"15284","종로5·6가동","종로5·6가동제2투","대통령선거","서울특별시","종로구",1950,1276,512,286,333,77,57,1,0,1,1,2,0,0,2,1272,4,674
"15285","이화동","관내사전투표","대통령선거","서울특별시","종로구",1456,1456,710,218,274,99,142,2,0,2,0,1,0,0,2,1450,6,0
"15286","이화동","이화동제1투","대통령선거","서울특별시","종로구",2714,1996,904,406,420,125,128,4,0,0,0,0,1,0,3,1991,5,718
"15287","이화동","이화동제2투","대통령선거","서울특별시","종로구",2613,1648,721,297,383,140,96,3,0,1,1,0,0,1,0,1643,5,965
"15288","혜화동","관내사전투표","대통령선거","서울특별시","종로구",3448,3448,1678,475,568,330,382,3,0,1,0,3,0,0,1,3441,7,0
"15289","혜화동","혜화동제1투","대통령선거","서울특별시","종로구",2444,1859,787,381,363,164,146,6,0,2,1,1,0,2,0,1853,6,585
"15290","혜화동","혜화동제2투","대통령선거","서울특별시","종로구",2280,1495,607,310,288,128,147,3,0,0,0,1,1,1,0,1486,9,785
"15291","혜화동","혜화동제3투","대통령선거","서울특별시","종로구",2170,1594,613,345,347,161,116,5,0,0,1,2,0,0,0,1590,4,576
"15292","혜화동","혜화동제4투","대통령선거","서울특별시","종로구",1654,1211,521,200,262,101,117,2,0,0,1,0,0,1,1,1206,5,443
"15293","혜화동","혜화동제5투","대통령선거","서울특별시","종로구",1610,1097,447,217,254,96,76,1,0,1,1,0,1,2,0,1096,1,513
"15294","창신제1동","관내사전투표","대통령선거","서울특별시","종로구",502,502,230,100,128,22,18,2,0,0,0,0,0,0,1,501,1,0
"15295","창신제1동","창신제1동제1투","대통령선거","서울특별시","종로구",1304,595,220,163,169,21,18,0,0,1,0,0,0,0,0,592,3,709
"15296","창신제1동","창신제1동제2투","대통령선거","서울특별시","종로구",2813,1992,850,375,546,95,103,9,0,1,1,2,1,0,1,1984,8,821
"15297","창신제2동","관내사전투표","대통령선거","서울특별시","종로구",1172,1172,561,169,307,51,70,3,0,0,0,0,0,1,1,1163,9,0
"15298","창신제2동","창신제2동제1투","대통령선거","서울특별시","종로구",1815,1069,418,207,324,45,59,5,0,4,0,1,0,0,1,1064,5,746
"15299","창신제2동","창신제2동제2투","대통령선거","서울특별시","종로구",2371,1618,653,326,484,74,67,1,1,2,0,0,1,1,0,1610,8,753
"15300","창신제2동","창신제2동제3투","대통령선거","서울특별시","종로구",2410,1649,698,279,481,87,94,4,0,0,0,0,0,0,1,1644,5,761
"15301","창신제3동","관내사전투표","대통령선거","서울특별시","종로구",1123,1123,544,165,248,58,100,2,1,0,0,1,2,0,0,1121,2,0
"15302","창신제3동","창신제3동제1투","대통령선거","서울특별시","종로구",1848,1193,476,212,373,65,56,1,0,2,0,0,0,1,1,1187,6,655
"15303","창신제3동","창신제3동제2투","대통령선거","서울특별시","종로구",2833,2173,914,427,508,182,127,2,0,2,1,1,0,0,3,2167,6,660
"15304","숭인제1동","관내사전투표","대통령선거","서울특별시","종로구",975,975,449,157,248,52,64,0,0,1,0,0,1,1,0,973,2,0
"15305","숭인제1동","숭인제1동제1투","대통령선거","서울특별시","종로구",2471,1498,576,333,413,92,69,6,0,1,0,0,1,0,1,1492,6,973
"15306","숭인제1동","숭인제1동제2투","대통령선거","서울특별시","종로구",1813,1273,555,234,343,70,58,2,0,2,0,0,0,0,2,1266,7,540
"15307","숭인제2동","관내사전투표","대통령선거","서울특별시","종로구",1339,1339,669,206,284,84,84,3,0,0,0,1,1,0,1,1333,6,0
"15308","숭인제2동","숭인제2동제1투","대통령선거","서울특별시","종로구",1892,1167,490,201,298,84,86,0,0,1,0,4,0,1,1,1166,1,725
"15309","숭인제2동","숭인제2동제2투","대통령선거","서울특별시","종로구",2397,1356,565,255,349,81,90,3,1,3,1,1,1,0,1,1351,5,1041
"15310","숭인제2동","숭인제2동제3투","대통령선거","서울특별시","종로구",2197,1477,653,305,367,56,86,1,0,2,1,0,0,0,0,1471,6,720
"15311","잘못 투입·구분된 투표지","잘못 투입·구분된 투표지","대통령선거","서울특별시","종로구",0,0,0,0,0,0,0,0,0,0,0,0,0,0,0,0,0,0
"15312","거소·선상투표","거소·선상투표","대통령선거","서울특별시","중구",174,157,60,34,48,8,3,0,0,0,0,0,0,0,1,154,3,17
"15313","관외사전투표","관외사전투표","대통령선거","서울특별시","중구",10177,10173,4848,1596,2093,809,757,13,2,1,0,9,3,4,7,10142,31,4
"15314","재외투표","재외투표","대통령선거","서울특별시","중구",1715,1156,633,164,189,35,116,15,0,0,1,2,0,0,0,1155,1,559
"15315","소공동","관내사전투표","대통령선거","서울특별시","중구",266,266,130,46,54,22,12,1,0,0,0,0,0,0,0,265,1,0
"15316","소공동","소공동제1투","대통령선거","서울특별시","중구",372,197,80,50,45,10,8,1,0,0,0,0,1,2,0,197,0,175
"15317","소공동","소공동제2투","대통령선거","서울특별시","중구",823,621,232,144,134,67,41,0,0,0,0,0,0,0,1,619,2,202
"15318","회현동","관내사전투표","대통령선거","서울특별시","중구",687,687,279,181,145,41,34,1,3,2,0,0,0,1,0,687,0,0
"15319","회현동","회현동제1투","대통령선거","서울특별시","중구",2845,1491,436,495,380,102,65,2,0,3,0,0,0,0,1,1484,7,1354
"15320","회현동","회현동제2투","대통령선거","서울특별시","중구",872,417,94,148,117,30,15,3,0,1,1,0,0,0,2,411,6,455
"15321","명동","관내사전투표","대통령선거","서울특별시","중구",483,483,200,125,103,29,25,0,0,0,0,0,0,0,0,482,1,0
"15322","명동","명동제1투","대통령선거","서울특별시","중구",1598,910,317,295,163,77,53,1,1,1,0,0,0,0,1,909,1,688
"15323","명동","명동제2투","대통령선거","서울특별시","중구",166,90,20,32,33,3,1,0,0,0,1,0,0,0,0,90,0,76
"15324","필동","관내사전투표","대통령선거","서울특별시","중구",1106,1106,496,215,224,72,86,0,0,2,1,3,1,0,0,1100,6,0
"15325","필동","필동제1투","대통령선거","서울특별시","중구",1337,793,263,220,178,70,56,1,0,1,0,1,0,1,0,791,2,544
"15326","필동","필동제2투","대통령선거","서울특별시","중구",1218,809,292,250,169,51,40,1,0,1,0,0,0,0,2,806,3,409
"15327","장충동","관내사전투표","대통령선거","서울특별시","중구",866,866,383,167,167,66,79,2,0,0,0,1,0,0,0,865,1,0
"15328","장충동","장충동제1투","대통령선거","서울특별시","중구",1592,1040,387,267,218,87,69,2,0,0,2,2,0,2,0,1036,4,552
"15329","장충동","장충동제2투","대통령선거","서울특별시","중구",1421,1006,460,171,225,73,70,3,0,1,0,1,0,0,0,1004,2,415
"15330","광희동","관내사전투표","대통령선거","서울특별시","중구",483,483,211,99,112,28,27,1,0,2,0,0,0,0,0,480,3,0
"15331","광희동","광희동제1투","대통령선거","서울특별시","중구",1692,907,311,289,203,47,49,0,0,1,1,0,0,0,0,901,6,785
"15332","광희동","광희동제2투","대통령선거","서울특별시","중구",1774,1179,396,361,282,73,59,2,0,1,0,0,0,0,1,1175,4,595
"15333","을지로동","관내사전투표","대통령선거","서울특별시","중구",302,302,124,97,54,8,16,0,0,0,1,0,1,0,0,301,1,0
"15334","을지로동","을지로동제1투","대통령선거","서울특별시","중구",640,288,61,123,82,12,9,1,0,0,0,0,0,0,0,288,0,352
"15335","을지로동","을지로동제2투","대통령선거","서울특별시","중구",530,344,116,109,88,11,17,3,0,0,0,0,0,0,0,344,0,186
"15336","신당동","관내사전투표","대통령선거","서울특별시","중구",1510,1510,729,268,300,103,102,1,0,0,0,1,1,0,1,1506,4,0
"15337","신당동","신당동제1투","대통령선거","서울특별시","중구",2167,1202,491,272,300,57,72,1,0,1,0,4,0,0,1,1199,3,965
"15338","신당동","신당동제2투","대통령선거","서울특별시","중구",1358,924,387,170,218,87,55,1,0,2,0,0,0,0,0,920,4,434
"15339","신당동","신당동제3투","대통령선거","서울특별시","중구",1935,1263,495,296,317,74,64,1,0,2,1,0,0,0,3,1253,10,672
"15340","다산동","관내사전투표","대통령선거","서울특별시","중구",1642,1642,695,331,363,103,135,4,1,0,0,2,1,0,0,1635,7,0
"15341","다산동","다산동제1투","대통령선거","서울특별시","중구",2483,1539,618,341,363,116,87,2,2,1,1,1,0,1,1,1534,5,944
"15342","다산동","다산동제2투","대통령선거","서울특별시","중구",2500,1726,678,389,442,106,102,3,0,0,0,0,2,0,0,1722,4,774
"15343","다산동","다산동제3투","대통령선거","서울특별시","중구",2222,1507,606,298,388,92,108,11,0,1,0,0,0,0,1,1505,2,715
"15344","다산동","다산동제4투","대통령선거","서울특별시","중구",2425,1737,744,348,433,118,86,2,0,0,0,0,0,0,0,1731,6,688
"15345","약수동","관내사전투표","대통령선거","서울특별시","중구",2585,2585,1131,521,553,192,169,6,1,1,0,3,1,0,1,2579,6,0
"15346","약수동","약수동제1투","대통령선거","서울특별시","중구",1619,922,349,237,224,64,40,2,0,0,0,0,0,0,1,917,5,697
"15347","약수동","약수동제2투","대통령선거","서울특별시","중구",1859,1419,585,329,318,83,89,2,0,2,0,1,0,4,3,1416,3,440
"15348","약수동","약수동제3투","대통령선거","서울특별시","중구",2774,2152,825,508,475,225,109,4,0,0,0,0,0,0,1,2147,5,622
"15349","약수동","약수동제4투","대통령선거","서울특별시","중구",2783,2188,833,511,487,205,134,7,1,3,0,0,0,0,0,2181,7,595
"15350","약수동","약수동제5투","대통령선거","서울특별시","중구",2880,1946,703,467,550,105,103,6,0,2,0,1,0,1,1,1939,7,934
"15351","청구동","관내사전투표","대통령선거","서울특별시","중구",1537,1537,729,248,333,108,109,3,0,0,1,0,2,0,0,1533,4,0
"15352","청구동","청구동제1투","대통령선거","서울특별시","중구",1404,943,374,222,247,52,40,3,0,1,1,0,0,1,2,943,0,461
"15353","청구동","청구동제2투","대통령선거","서울특별시","중구",1880,1114,451,233,268,88,67,1,0,1,0,0,0,0,0,1109,5,766
"15354","청구동","청구동제3투","대통령선거","서울특별시","중구",2134,1781,645,453,428,161,80,4,0,0,1,1,0,2,2,1777,4,353
"15355","청구동","청구동제4투","대통령선거","서울특별시","중구",1842,1443,568,293,369,121,77,5,0,0,1,4,0,0,1,1439,4,399
"15356","청구동","청구동제5투","대통령선거","서울특별시","중구",2567,1980,759,463,498,143,94,4,0,3,0,1,1,0,1,1967,13,587
"15357","신당제5동","관내사전투표","대통령선거","서울특별시","중구",1571,1571,691,322,377,91,77,4,0,1,0,3,0,0,1,1567,4,0
"15358","신당제5동","신당제5동제1투","대통령선거","서울특별시","중구",2154,1254,503,271,354,50,69,3,0,0,0,3,0,0,0,1253,1,900
"15359","신당제5동","신당제5동제2투","대통령선거","서울특별시","중구",3155,2147,836,418,605,135,140,2,0,1,1,1,0,0,1,2140,7,1008
"15360","신당제5동","신당제5동제3투","대통령선거","서울특별시","중구",864,577,227,125,150,38,26,3,0,2,0,3,0,0,3,577,0,287
"15361","동화동","관내사전투표","대통령선거","서울특별시","중구",1688,1688,765,327,357,116,117,0,0,0,0,1,0,0,0,1683,5,0
"15362","동화동","동화동제1투","대통령선거","서울특별시","중구",1461,992,379,210,252,86,58,2,0,0,0,2,0,1,0,990,2,469
"15363","동화동","동화동제2투","대통령선거","서울특별시","중구",1833,1403,539,341,345,109,64,1,0,0,0,0,0,0,1,1400,3,430
"15364","동화동","동화동제3투","대통령선거","서울특별시","중구",2115,1607,623,339,402,150,87,2,0,0,0,0,0,0,0,1603,4,508
"15365","동화동","동화동제4투","대통령선거","서울특별시","중구",1590,1115,430,254,287,75,62,0,1,1,1,0,0,1,1,1113,2,475
"15366","황학동","관내사전투표","대통령선거","서울특별시","중구",1362,1362,634,250,307,82,83,1,0,1,0,0,0,0,1,1359,3,0
"15367","황학동","황학동제1투","대통령선거","서울특별시","중구",3557,2143,847,429,588,136,120,5,0,3,2,1,2,2,2,2137,6,1414
"15368","황학동","황학동제2투","대통령선거","서울특별시","중구",1636,1049,400,226,293,67,59,1,0,0,0,0,0,0,1,1047,2,587
"15369","황학동","황학동제3투","대통령선거","서울특별시","중구",3068,2291,1028,417,548,173,107,2,0,0,2,1,0,1,3,2282,9,777
"15370","중림동","관내사전투표","대통령선거","서울특별시","중구",1322,1322,571,289,277,90,87,0,0,1,1,1,1,0,1,1319,3,0
"15371","중림동","중림동제1투","대통령선거","서울특별시","중구",1172,672,295,126,158,51,39,0,0,1,0,0,0,0,0,670,2,500
"15372","중림동","중림동제2투","대통령선거","서울특별시","중구",2333,1446,524,359,367,99,81,4,0,2,0,1,1,1,0,1439,7,887
"15373","중림동","중림동제3투","대통령선거","서울특별시","중구",1710,1382,546,322,325,92,88,2,0,3,0,0,0,0,0,1378,4,328
"15374","잘못 투입·구분된 투표지","잘못 투입·구분된 투표지","대통령선거","서울특별시","중구",0,0,0,0,0,0,0,0,0,0,0,0,0,0,0,0,0,0
"15375","거소·선상투표","거소·선상투표","대통령선거","서울특별시","용산구",244,231,88,51,66,16,6,1,0,1,0,0,0,0,0,229,2,13
"15376","관외사전투표","관외사전투표","대통령선거","서울특별시","용산구",18318,18288,8077,3320,3690,1531,1493,35,3,5,3,20,4,7,19,18207,81,30
"15377","재외투표","재외투표","대통령선거","서울특별시","용산구",3497,2547,1277,351,443,144,289,23,0,1,0,1,1,1,1,2532,15,950
"15378","후암동","관내사전투표","대통령선거","서울특별시","용산구",2845,2845,1345,552,528,187,203,8,0,1,1,1,1,1,5,2833,12,0
"15379","후암동","후암동제1투","대통령선거","서울특별시","용산구",3353,1967,887,398,419,143,110,4,1,0,0,0,1,0,1,1964,3,1386
"15380","후암동","후암동제2투","대통령선거","서울특별시","용산구",2545,1654,699,366,374,92,107,10,0,0,0,0,0,0,0,1648,6,891
"15381","후암동","후암동제3투","대통령선거","서울특별시","용산구",2667,1839,760,416,411,115,123,4,1,1,0,2,0,1,1,1835,4,828
"15382","후암동","후암동제4투","대통령선거","서울특별시","용산구",2696,1837,811,407,389,97,107,11,1,0,0,2,0,1,0,1826,11,859
"15383","용산2가동","관내사전투표","대통령선거","서울특별시","용산구",1675,1675,775,331,329,82,151,0,0,1,0,0,1,0,0,1670,5,0
"15384","용산2가동","용산2가동제1투","대통령선거","서울특별시","용산구",2460,1438,541,331,329,104,116,2,1,2,1,1,0,3,0,1431,7,1022
"15385","용산2가동","용산2가동제2투","대통령선거","서울특별시","용산구",1626,1079,407,294,242,60,73,0,0,0,0,0,0,0,0,1076,3,547
"15386","용산2가동","용산2가동제3투","대통령선거","서울특별시","용산구",1601,1121,449,259,245,69,87,2,0,1,0,0,0,0,1,1113,8,480
"15387","용산2가동","용산2가동제4투","대통령선거","서울특별시","용산구",1619,1052,425,237,213,82,85,2,0,2,0,0,0,0,1,1047,5,567
"15388","남영동","관내사전투표","대통령선거","서울특별시","용산구",1607,1607,690,333,318,118,135,5,0,2,0,0,0,1,0,1602,5,0
"15389","남영동","남영동제1투","대통령선거","서울특별시","용산구",3082,1622,663,328,385,104,126,8,1,0,0,0,0,2,0,1617,5,1460
"15390","남영동","남영동제2투","대통령선거","서울특별시","용산구",2692,1498,527,416,382,76,83,3,2,1,1,0,1,1,1,1494,4,1194
"15391","청파동","관내사전투표","대통령선거","서울특별시","용산구",2225,2225,1173,316,350,154,216,6,0,0,0,3,0,0,1,2219,6,0
"15392","청파동","청파동제1투","대통령선거","서울특별시","용산구",1858,1215,498,301,293,66,50,3,0,1,1,0,1,0,1,1215,0,643
"15393","청파동","청파동제2투","대통령선거","서울특별시","용산구",2147,1444,609,298,364,90,71,3,0,2,0,0,1,2,1,1441,3,703
"15394","청파동","청파동제3투","대통령선거","서울특별시","용산구",2271,1540,664,315,354,101,90,1,0,1,1,2,0,0,3,1532,8,731
"15395","청파동","청파동제4투","대통령선거","서울특별시","용산구",2677,1864,824,398,410,120,98,3,0,0,0,0,0,2,2,1857,7,813
"15396","청파동","청파동제5투","대통령선거","서울특별시","용산구",1894,1281,540,249,300,89,95,2,0,1,0,0,1,0,0,1277,4,613
"15397","청파동","청파동제6투","대통령선거","서울특별시","용산구",2333,1274,566,281,256,79,80,2,0,1,0,1,0,0,1,1267,7,1059
"15398","원효로제1동","관내사전투표","대통령선거","서울특별시","용산구",2228,2228,1092,369,393,197,163,1,1,1,0,3,0,0,0,2220,8,0
"15399","원효로제1동","원효로제1동제1투","대통령선거","서울특별시","용산구",2545,1850,778,423,403,103,133,2,0,0,0,2,0,0,0,1844,6,695
"15400","원효로제1동","원효로제1동제2투","대통령선거","서울특별시","용산구",2255,1598,648,329,395,116,95,1,0,1,0,1,1,1,2,1590,8,657
"15401","원효로제1동","원효로제1동제3투","대통령선거","서울특별시","용산구",3601,2498,1001,470,541,302,172,4,0,0,0,1,1,1,1,2494,4,1103
"15402","원효로제2동","관내사전투표","대통령선거","서울특별시","용산구",2004,2004,973,357,349,163,151,0,0,1,0,1,0,2,1,1998,6,0
"15403","원효로제2동","원효로제2동제1투","대통령선거","서울특별시","용산구",3709,2670,1050,613,597,238,152,2,0,2,1,1,2,1,2,2661,9,1039
"15404","원효로제2동","원효로제2동제2투","대통령선거","서울특별시","용산구",2624,1927,763,449,447,131,120,8,0,2,0,1,0,0,0,1921,6,697
"15405","원효로제2동","원효로제2동제3투","대통령선거","서울특별시","용산구",2621,1876,745,443,439,127,105,3,0,2,0,1,2,1,3,1871,5,745
"15406","효창동","관내사전투표","대통령선거","서울특별시","용산구",1722,1722,812,298,342,133,129,3,0,0,1,1,0,0,0,1719,3,0
"15407","효창동","효창동제1투","대통령선거","서울특별시","용산구",1935,1338,549,281,324,80,97,3,0,1,0,1,0,0,0,1336,2,597
"15408","효창동","효창동제2투","대통령선거","서울특별시","용산구",1835,1434,546,306,352,127,97,1,0,0,0,0,1,0,1,1431,3,401
"15409","효창동","효창동제3투","대통령선거","서울특별시","용산구",1870,1335,471,375,337,77,68,3,1,1,0,0,0,1,0,1334,1,535
"15410","용문동","관내사전투표","대통령선거","서울특별시","용산구",2088,2088,996,358,423,162,134,1,0,1,1,2,0,1,0,2079,9,0
"15411","용문동","용문동제1투","대통령선거","서울특별시","용산구",2890,1838,762,398,428,134,105,2,0,1,0,4,0,0,0,1834,4,1052
"15412","용문동","용문동제2투","대통령선거","서울특별시","용산구",2190,1518,565,352,409,101,67,7,1,1,0,0,1,0,3,1507,11,672
"15413","용문동","용문동제3투","대통령선거","서울특별시","용산구",2460,2050,824,438,463,174,144,3,1,0,0,0,0,0,2,2049,1,410
"15414","한강로동","관내사전투표","대통령선거","서울특별시","용산구",1943,1943,832,412,416,144,131,1,0,2,1,1,0,0,0,1940,3,0
"15415","한강로동","한강로동제1투","대통령선거","서울특별시","용산구",2105,1488,474,404,365,150,83,4,0,2,0,0,0,0,0,1482,6,617
"15416","한강로동","한강로동제2투","대통령선거","서울특별시","용산구",1553,492,156,148,121,38,24,2,0,0,0,0,0,1,0,490,2,1061
"15417","한강로동","한강로동제3투","대통령선거","서울특별시","용산구",1264,879,347,223,168,92,44,0,0,1,1,0,0,0,0,876,3,385
"15418","한강로동","한강로동제4투","대통령선거","서울특별시","용산구",3282,2345,596,849,562,231,92,4,0,1,2,1,1,0,3,2342,3,937
"15419","한강로동","한강로동제5투","대통령선거","서울특별시","용산구",1404,864,304,215,258,51,31,1,0,0,0,0,0,0,0,860,4,540
"15420","이촌제1동","관내사전투표","대통령선거","서울특별시","용산구",4560,4560,1616,1281,887,523,235,5,0,0,1,1,0,1,0,4550,10,0
"15421","이촌제1동","이촌제1동제1투","대통령선거","서울특별시","용산구",3263,2281,562,901,481,242,80,8,0,0,1,0,0,2,0,2277,4,982
"15422","이촌제1동","이촌제1동제2투","대통령선거","서울특별시","용산구",4278,2636,878,690,610,331,118,1,1,2,0,1,1,1,0,2634,2,1642
"15423","이촌제1동","이촌제1동제3투","대통령선거","서울특별시","용산구",2844,2129,596,764,434,229,95,4,0,0,0,0,0,0,0,2122,7,715
"15424","이촌제1동","이촌제1동제4투","대통령선거","서울특별시","용산구",3031,2371,799,605,532,293,127,6,0,0,0,0,0,1,2,2365,6,660
"15425","이촌제1동","이촌제1동제5투","대통령선거","서울특별시","용산구",2387,1727,409,613,385,244,68,0,0,0,0,0,0,1,0,1720,7,660
"15426","이촌제2동","관내사전투표","대통령선거","서울특별시","용산구",1293,1293,533,281,292,99,74,3,0,0,0,0,1,0,0,1283,10,0
"15427","이촌제2동","이촌제2동제1투","대통령선거","서울특별시","용산구",1909,1229,440,326,278,90,89,2,0,0,0,0,0,0,1,1226,3,680
"15428","이촌제2동","이촌제2동제2투","대통령선거","서울특별시","용산구",1732,1293,428,403,299,89,67,3,0,1,0,0,0,0,0,1290,3,439
"15429","이촌제2동","이촌제2동제3투","대통령선거","서울특별시","용산구",2134,1700,622,429,400,154,84,2,0,1,1,1,1,0,0,1695,5,434
"15430","이태원제1동","관내사전투표","대통령선거","서울특별시","용산구",1114,1114,443,245,208,87,122,4,0,1,0,0,1,0,1,1112,2,0
"15431","이태원제1동","이태원제1동제1투","대통령선거","서울특별시","용산구",3325,1772,566,602,370,131,96,1,0,1,0,2,0,0,1,1770,2,1553
"15432","이태원제1동","이태원제1동제2투","대통령선거","서울특별시","용산구",1869,1176,392,372,244,88,76,0,1,0,0,0,1,0,0,1174,2,693
"15433","이태원제2동","관내사전투표","대통령선거","서울특별시","용산구",1330,1330,616,273,229,91,113,1,0,0,0,0,0,1,3,1327,3,0
"15434","이태원제2동","이태원제2동제1투","대통령선거","서울특별시","용산구",2647,1465,501,391,311,137,112,5,0,0,0,0,0,1,1,1459,6,1182
"15435","이태원제2동","이태원제2동제2투","대통령선거","서울특별시","용산구",2063,1414,533,388,298,99,88,4,0,1,0,0,0,0,0,1411,3,649
"15436","이태원제2동","이태원제2동제3투","대통령선거","서울특별시","용산구",1574,1056,381,268,249,61,85,2,0,5,0,0,0,0,0,1051,5,518
"15437","한남동","관내사전투표","대통령선거","서울특별시","용산구",2347,2347,1047,466,425,191,194,9,1,0,1,2,1,2,0,2339,8,0
"15438","한남동","한남동제1투","대통령선거","서울특별시","용산구",2650,1813,624,508,432,129,113,0,0,0,0,0,0,0,4,1810,3,837
"15439","한남동","한남동제2투","대통령선거","서울특별시","용산구",2290,1350,551,298,320,69,97,7,0,1,0,1,1,0,0,1345,5,940
"15440","한남동","한남동제3투","대통령선거","서울특별시","용산구",3352,2097,563,773,429,208,113,1,0,3,0,1,0,2,1,2094,3,1255
"15441","한남동","한남동제4투","대통령선거","서울특별시","용산구",2270,1442,557,403,294,94,82,5,0,1,0,0,0,0,1,1437,5,828
"15442","한남동","한남동제5투","대통령선거","서울특별시","용산구",3133,1331,504,319,323,75,94,5,0,1,0,1,1,0,0,1323,8,1802
"15443","서빙고동","관내사전투표","대통령선거","서울특별시","용산구",1418,1418,502,431,299,95,79,3,0,0,0,0,0,0,1,1410,8,0
"15444","서빙고동","서빙고동제1투","대통령선거","서울특별시","용산구",2321,1774,433,483,530,219,98,4,0,1,0,1,1,1,0,1771,3,547
"15445","서빙고동","서빙고동제2투","대통령선거","서울특별시","용산구",1853,1201,444,318,275,81,69,4,0,0,0,1,0,1,3,1196,5,652
"15446","서빙고동","서빙고동제3투","대통령선거","서울특별시","용산구",2651,2029,343,943,412,263,58,1,0,0,0,0,0,1,0,2021,8,622
"15447","서빙고동","서빙고동제4투","대통령선거","서울특별시","용산구",1260,693,206,218,162,50,54,0,0,0,0,0,0,0,0,690,3,567
"15448","보광동","관내사전투표","대통령선거","서울특별시","용산구",2475,2475,1021,513,518,173,229,3,0,2,1,2,1,1,1,2465,10,0
"15449","보광동","보광동제1투","대통령선거","서울특별시","용산구",3131,1692,599,459,405,114,104,0,0,1,0,0,0,0,1,1683,9,1439
"15450","보광동","보광동제2투","대통령선거","서울특별시","용산구",2436,1608,656,394,359,82,105,4,0,0,0,0,0,1,1,1602,6,828
"15451","보광동","보광동제3투","대통령선거","서울특별시","용산구",2718,1690,605,423,393,118,134,3,0,1,1,1,1,3,0,1683,7,1028
"15452","보광동","보광동제4투","대통령선거","서울특별시","용산구",2244,1523,532,391,404,86,90,5,0,1,2,3,0,0,1,1515,8,721
"15453","잘못 투입·구분된 투표지","잘못 투입·구분된 투표지","대통령선거","서울특별시","용산구",0,0,0,0,0,0,0,0,0,0,0,0,0,0,0,0,0,0
"15454","거소·선상투표","거소·선상투표","대통령선거","서울특별시","성동구",358,342,125,54,115,24,10,2,1,0,0,1,1,1,0,334,8,16
"15455","관외사전투표","관외사전투표","대통령선거","서울특별시","성동구",23632,23616,11080,3532,4912,2033,1859,33,3,9,5,12,10,5,22,23515,101,16
"15456","재외투표","재외투표","대통령선거","서울특별시","성동구",3007,2309,1314,183,378,111,296,10,0,1,1,1,1,2,2,2300,9,698
"15457","금호1가동","관내사전투표","대통령선거","서울특별시","성동구",1569,1569,717,287,348,93,112,3,0,0,0,2,0,1,1,1564,5,0
"15458","금호1가동","금호1가동제1투","대통령선거","서울특별시","성동구",2123,1352,520,334,329,84,76,0,0,0,0,1,0,0,0,1344,8,771
"15459","금호1가동","금호1가동제2투","대통령선거","서울특별시","성동구",3110,2241,929,463,572,151,107,4,0,0,0,0,0,3,3,2232,9,869
"15460","금호1가동","금호1가동제3투","대통령선거","서울특별시","성동구",3143,2395,965,550,525,205,138,8,1,0,0,0,0,0,0,2392,3,748
"15461","금호2·3가동","관내사전투표","대통령선거","서울특별시","성동구",3289,3289,1538,537,737,248,202,7,1,2,0,1,0,2,1,3276,13,0
"15462","금호2·3가동","금호2·3가동제1투","대통령선거","서울특별시","성동구",3448,2405,948,524,571,198,154,1,0,3,0,2,0,0,1,2402,3,1043
"15463","금호2·3가동","금호2·3가동제2투","대통령선거","서울특별시","성동구",3180,2129,865,448,497,158,150,1,0,1,0,0,0,0,0,2120,9,1051
"15464","금호2·3가동","금호2·3가동제3투","대통령선거","서울특별시","성동구",3308,2214,845,504,580,140,126,2,0,0,0,0,0,0,5,2202,12,1094
"15465","금호2·3가동","금호2·3가동제4투","대통령선거","서울특별시","성동구",2409,1956,703,466,480,185,112,1,0,0,0,0,0,0,0,1947,9,453
"15466","금호2·3가동","금호2·3가동제5투","대통령선거","서울특별시","성동구",2729,1664,710,281,393,183,92,0,1,0,1,0,0,0,1,1662,2,1065
"15467","금호4가동","관내사전투표","대통령선거","서울특별시","성동구",2502,2502,1110,469,547,218,135,4,0,2,1,0,3,4,4,2497,5,0
"15468","금호4가동","금호4가동제1투","대통령선거","서울특별시","성동구",2930,1971,794,436,440,192,97,6,0,0,0,1,0,1,1,1968,3,959
"15469","금호4가동","금호4가동제2투","대통령선거","서울특별시","성동구",2735,2049,843,470,442,188,96,0,0,1,2,0,0,1,1,2044,5,686
"15470","금호4가동","금호4가동제3투","대통령선거","서울특별시","성동구",2995,1996,769,474,497,124,118,0,0,1,1,1,0,0,2,1987,9,999
"15471","옥수동","관내사전투표","대통령선거","서울특별시","성동구",3619,3619,1562,708,733,359,239,2,0,1,1,2,1,1,2,3611,8,0
"15472","옥수동","옥수동제1투","대통령선거","서울특별시","성동구",2654,2041,819,449,436,242,85,5,0,0,0,1,0,0,1,2038,3,613
"15473","옥수동","옥수동제2투","대통령선거","서울특별시","성동구",2551,1773,588,505,403,169,98,5,0,1,0,0,0,0,1,1770,3,778
"15474","옥수동","옥수동제3투","대통령선거","서울특별시","성동구",2859,2204,861,522,486,219,106,5,0,1,1,0,0,0,0,2201,3,655
"15475","옥수동","옥수동제4투","대통령선거","서울특별시","성동구",3192,1988,659,582,445,190,101,5,0,0,0,0,0,1,0,1983,5,1204
"15476","옥수동","옥수동제5투","대통령선거","서울특별시","성동구",2346,1882,730,444,434,167,96,4,1,1,0,0,0,0,0,1877,5,464
"15477","옥수동","옥수동제6투","대통령선거","서울특별시","성동구",2737,2128,887,411,464,221,137,2,0,0,0,0,0,0,1,2123,5,609
"15478","응봉동","관내사전투표","대통령선거","서울특별시","성동구",3164,3164,1475,586,645,242,205,4,1,0,0,1,1,0,0,3160,4,0
"15479","응봉동","응봉동제1투","대통령선거","서울특별시","성동구",3136,2031,794,470,481,155,109,4,0,3,0,1,0,3,5,2025,6,1105
"15480","응봉동","응봉동제2투","대통령선거","서울특별시","성동구",3341,2466,931,626,541,210,139,9,0,0,6,0,0,0,1,2463,3,875
"15481","응봉동","응봉동제3투","대통령선거","서울특별시","성동구",2855,2263,967,468,517,182,114,7,0,1,1,1,0,1,0,2259,4,592
"15482","성수1가제1동","관내사전투표","대통령선거","서울특별시","성동구",2385,2385,1165,399,461,167,169,3,0,2,1,4,0,0,2,2373,12,0
"15483","성수1가제1동","성수1가제1동제1투","대통령선거","서울특별시","성동구",2895,1793,711,409,438,114,104,5,0,0,1,3,2,1,0,1788,5,1102
"15484","성수1가제1동","성수1가제1동제2투","대통령선거","서울특별시","성동구",2968,2247,914,510,470,194,136,4,1,2,1,2,1,1,2,2238,9,721
"15485","성수1가제1동","성수1가제1동제3투","대통령선거","서울특별시","성동구",2410,1767,673,424,410,142,109,1,0,2,2,0,0,0,0,1763,4,643
"15486","성수1가제1동","성수1가제1동제4투","대통령선거","서울특별시","성동구",2114,1406,576,294,312,124,88,2,0,0,1,3,0,0,1,1401,5,708
"15487","성수1가제2동","관내사전투표","대통령선거","서울특별시","성동구",2374,2373,1221,378,408,186,165,1,0,1,0,6,0,0,1,2367,6,1
"15488","성수1가제2동","성수1가제2동제1투","대통령선거","서울특별시","성동구",2162,1424,591,345,312,75,89,1,1,2,0,1,0,1,1,1419,5,738
"15489","성수1가제2동","성수1가제2동제2투","대통령선거","서울특별시","성동구",2213,1614,614,411,358,107,109,2,1,1,1,0,0,0,4,1608,6,599
"15490","성수1가제2동","성수1가제2동제3투","대통령선거","서울특별시","성동구",2769,1979,850,405,437,143,126,2,0,0,0,1,0,1,3,1968,11,790
"15491","성수1가제2동","성수1가제2동제4투","대통령선거","서울특별시","성동구",3202,2523,1063,553,563,177,157,2,0,0,0,0,0,1,3,2519,4,679
"15492","성수2가제1동","관내사전투표","대통령선거","서울특별시","성동구",3258,3258,1510,646,686,184,206,6,0,2,1,4,1,0,3,3249,9,0
"15493","성수2가제1동","성수2가제1동제1투","대통령선거","서울특별시","성동구",2740,1746,625,416,438,146,106,4,0,1,1,0,1,1,1,1740,6,994
"15494","성수2가제1동","성수2가제1동제2투","대통령선거","서울특별시","성동구",3247,2257,827,569,570,150,132,1,0,0,0,0,0,0,0,2249,8,990
"15495","성수2가제1동","성수2가제1동제3투","대통령선거","서울특별시","성동구",2953,1767,693,417,428,112,97,5,0,0,1,2,0,1,0,1756,11,1186
"15496","성수2가제1동","성수2가제1동제4투","대통령선거","서울특별시","성동구",2891,1932,726,439,492,131,125,3,0,3,0,2,0,0,0,1921,11,959
"15497","성수2가제3동","관내사전투표","대통령선거","서울특별시","성동구",2114,2114,958,424,421,149,155,0,0,0,0,0,1,0,0,2108,6,0
"15498","성수2가제3동","성수2가제3동제1투","대통령선거","서울특별시","성동구",2816,1777,763,381,387,127,106,2,0,1,0,2,0,1,0,1770,7,1039
"15499","성수2가제3동","성수2가제3동제2투","대통령선거","서울특별시","성동구",2842,2208,744,680,493,181,98,1,0,1,0,1,0,1,1,2201,7,634
"15500","성수2가제3동","성수2가제3동제3투","대통령선거","서울특별시","성동구",1463,953,402,178,234,70,63,2,0,1,0,0,1,0,0,951,2,510
"15501","왕십리도선동","관내사전투표","대통령선거","서울특별시","성동구",3522,3522,1733,526,720,307,224,3,0,1,0,1,1,1,0,3517,5,0
"15502","왕십리도선동","왕십리도선동제1투","대통령선거","서울특별시","성동구",3306,2293,945,516,534,139,137,1,0,1,2,1,1,3,1,2281,12,1013
"15503","왕십리도선동","왕십리도선동제2투","대통령선거","서울특별시","성동구",2024,1371,567,303,325,73,96,0,0,0,0,1,0,1,1,1367,4,653
"15504","왕십리도선동","왕십리도선동제3투","대통령선거","서울특별시","성동구",2511,1949,690,508,479,153,99,4,0,1,0,0,3,2,2,1941,8,562
"15505","왕십리도선동","왕십리도선동제4투","대통령선거","서울특별시","성동구",3295,2199,1013,345,518,178,134,3,0,0,0,0,0,1,1,2193,6,1096
"15506","왕십리도선동","왕십리도선동제5투","대통령선거","서울특별시","성동구",2986,2295,929,458,528,232,138,3,1,0,0,1,1,0,1,2292,3,691
"15507","왕십리도선동","왕십리도선동제6투","대통령선거","서울특별시","성동구",2067,1627,673,280,403,150,114,1,0,1,0,0,1,0,0,1623,4,440
"15508","왕십리제2동","관내사전투표","대통령선거","서울특별시","성동구",2396,2396,1181,347,488,150,216,2,0,0,0,1,1,1,2,2389,7,0
"15509","왕십리제2동","왕십리제2동제1투","대통령선거","서울특별시","성동구",3417,2134,892,439,527,134,128,3,0,3,0,0,0,1,0,2127,7,1283
"15510","왕십리제2동","왕십리제2동제2투","대통령선거","서울특별시","성동구",2741,1888,747,394,481,131,112,5,0,1,0,1,0,3,3,1878,10,853
"15511","왕십리제2동","왕십리제2동제3투","대통령선거","서울특별시","성동구",1464,1155,488,253,270,71,66,2,0,0,0,0,0,1,0,1151,4,309
"15512","왕십리제2동","왕십리제2동제4투","대통령선거","서울특별시","성동구",2645,2116,1000,336,464,164,140,3,1,2,0,1,0,0,1,2112,4,529
"15513","행당제1동","관내사전투표","대통령선거","서울특별시","성동구",2991,2991,1409,514,572,242,230,5,0,2,0,1,2,0,3,2980,11,0
"15514","행당제1동","행당제1동제1투","대통령선거","서울특별시","성동구",3256,2119,786,531,528,150,106,6,0,3,0,2,0,0,2,2114,5,1137
"15515","행당제1동","행당제1동제2투","대통령선거","서울특별시","성동구",3376,2499,985,526,633,199,139,6,0,2,0,0,0,1,3,2494,5,877
"15516","행당제1동","행당제1동제3투","대통령선거","서울특별시","성동구",1862,1254,496,306,295,71,72,2,0,0,1,1,1,0,1,1246,8,608
"15517","행당제2동","관내사전투표","대통령선거","서울특별시","성동구",3487,3486,1748,545,658,270,242,10,0,0,0,1,1,0,1,3476,10,1
"15518","행당제2동","행당제2동제1투","대통령선거","서울특별시","성동구",3138,2309,924,503,527,222,121,7,0,0,1,0,0,0,0,2305,4,829
"15519","행당제2동","행당제2동제2투","대통령선거","서울특별시","성동구",2713,1945,830,324,471,176,131,3,0,0,1,5,0,0,0,1941,4,768
"15520","행당제2동","행당제2동제3투","대통령선거","서울특별시","성동구",3099,2316,981,453,576,155,141,1,0,0,1,1,1,0,1,2311,5,783
"15521","행당제2동","행당제2동제4투","대통령선거","서울특별시","성동구",2797,2230,984,476,478,188,93,3,0,1,1,0,0,1,2,2227,3,567
"15522","행당제2동","행당제2동제5투","대통령선거","서울특별시","성동구",3001,2305,976,475,529,174,132,7,1,0,0,3,1,0,0,2298,7,696
"15523","마장동","관내사전투표","대통령선거","서울특별시","성동구",2795,2795,1403,466,580,165,165,4,0,1,0,1,1,1,0,2787,8,0
"15524","마장동","마장동제1투","대통령선거","서울특별시","성동구",2488,1696,652,388,404,139,101,5,0,0,1,0,0,0,1,1691,5,792
"15525","마장동","마장동제2투","대통령선거","서울특별시","성동구",2612,2037,800,423,497,160,146,2,0,2,0,0,0,0,2,2032,5,575
"15526","마장동","마장동제3투","대통령선거","서울특별시","성동구",2970,2319,961,507,529,176,127,5,0,1,1,1,0,0,4,2312,7,651
"15527","마장동","마장동제4투","대통령선거","서울특별시","성동구",2482,1717,696,398,417,89,104,2,0,1,2,1,1,0,0,1711,6,765
"15528","마장동","마장동제5투","대통령선거","서울특별시","성동구",2600,1708,663,401,434,92,103,2,1,2,0,1,0,1,0,1700,8,892
"15529","마장동","마장동제6투","대통령선거","서울특별시","성동구",2187,1662,673,321,383,161,113,1,0,1,0,5,0,0,0,1658,4,525
"15530","사근동","관내사전투표","대통령선거","서울특별시","성동구",1685,1685,766,205,343,204,161,0,0,2,1,0,0,0,1,1683,2,0
"15531","사근동","사근동제1투","대통령선거","서울특별시","성동구",1578,1198,522,195,272,108,82,1,0,2,2,4,1,1,1,1191,7,380
"15532","사근동","사근동제2투","대통령선거","서울특별시","성동구",2206,1462,562,305,383,90,105,0,0,3,0,1,0,1,2,1452,10,744
"15533","사근동","사근동제3투","대통령선거","서울특별시","성동구",2943,2116,863,350,450,276,161,2,0,1,0,3,0,2,2,2110,6,827
"15534","송정동","관내사전투표","대통령선거","서울특별시","성동구",1430,1430,689,278,286,74,89,3,0,3,0,0,0,0,1,1423,7,0
"15535","송정동","송정동제1투","대통령선거","서울특별시","성동구",2618,1734,757,340,401,110,115,1,0,2,0,0,0,0,2,1728,6,884
"15536","송정동","송정동제2투","대통령선거","서울특별시","성동구",2411,1605,656,362,383,114,81,2,0,1,1,1,0,0,0,1601,4,806
"15537","송정동","송정동제3투","대통령선거","서울특별시","성동구",2490,1607,618,371,429,86,85,4,0,0,0,0,0,1,2,1596,11,883
"15538","용답동","관내사전투표","대통령선거","서울특별시","성동구",2143,2143,1060,362,442,112,148,1,0,3,1,3,0,0,0,2132,11,0
"15539","용답동","용답동제1투","대통령선거","서울특별시","성동구",3027,1704,720,321,444,97,111,0,0,3,0,1,0,0,3,1700,4,1323
"15540","용답동","용답동제2투","대통령선거","서울특별시","성동구",2672,1790,695,407,474,110,95,2,0,0,0,1,0,0,1,1785,5,882
"15541","용답동","용답동제3투","대통령선거","서울특별시","성동구",2478,1650,683,354,406,85,108,1,0,0,0,4,0,0,0,1641,9,828
"15542","용답동","용답동제4투","대통령선거","서울특별시","성동구",2363,1635,595,393,446,112,76,5,0,1,0,1,0,0,0,1629,6,728
"15543","잘못 투입·구분된 투표지","잘못 투입·구분된 투표지","대통령선거","서울특별시","성동구",0,2,1,0,1,0,0,0,0,0,0,0,0,0,0,2,0,-2
"15544","거소·선상투표","거소·선상투표","대통령선거","서울특별시","광진구",384,370,145,53,123,28,9,1,1,0,1,0,2,1,0,364,6,14
"15545","관외사전투표","관외사전투표","대통령선거","서울특별시","광진구",27805,27803,13607,3918,5565,2084,2362,44,6,9,6,17,7,8,29,27662,141,2
"15546","재외투표","재외투표","대통령선거","서울특별시","광진구",3250,2494,1472,208,398,107,288,9,0,1,0,4,0,1,0,2488,6,756
"15547","중곡제1동","관내사전투표","대통령선거","서울특별시","광진구",2062,2062,970,349,447,121,159,0,0,1,1,1,0,0,1,2050,12,0
"15548","중곡제1동","중곡제1동제1투","대통령선거","서울특별시","광진구",3002,1926,860,403,398,129,123,0,0,2,0,1,0,0,0,1916,10,1076
"15549","중곡제1동","중곡제1동제2투","대통령선거","서울특별시","광진구",1999,1369,565,322,291,91,90,0,0,1,0,1,0,1,0,1362,7,630
"15550","중곡제1동","중곡제1동제3투","대통령선거","서울특별시","광진구",2779,1856,695,427,469,124,128,2,0,1,0,3,0,1,1,1851,5,923
"15551","중곡제1동","중곡제1동제4투","대통령선거","서울특별시","광진구",2454,1765,740,370,414,131,99,1,0,1,0,0,1,1,0,1758,7,689
"15552","중곡제2동","관내사전투표","대통령선거","서울특별시","광진구",3331,3331,1671,561,637,200,249,3,1,2,0,0,0,0,1,3325,6,0
"15553","중곡제2동","중곡제2동제1투","대통령선거","서울특별시","광진구",2796,1871,794,361,459,119,132,2,0,0,0,0,0,1,0,1868,3,925
"15554","중곡제2동","중곡제2동제2투","대통령선거","서울특별시","광진구",3092,2271,997,431,521,151,149,2,0,0,1,3,1,0,3,2259,12,821
"15555","중곡제2동","중곡제2동제3투","대통령선거","서울특별시","광진구",3200,2287,990,493,499,142,151,0,0,0,0,0,0,2,1,2278,9,913
"15556","중곡제2동","중곡제2동제4투","대통령선거","서울특별시","광진구",2227,1485,596,331,357,88,103,2,0,0,0,0,0,1,1,1479,6,742
"15557","중곡제2동","중곡제2동제5투","대통령선거","서울특별시","광진구",2979,2056,830,453,504,116,140,3,0,2,0,0,1,2,0,2051,5,923
"15558","중곡제3동","관내사전투표","대통령선거","서울특별시","광진구",2241,2241,1082,420,428,120,176,4,1,1,0,1,2,0,0,2235,6,0
"15559","중곡제3동","중곡제3동제1투","대통령선거","서울특별시","광진구",2250,1617,635,365,373,113,116,2,0,5,1,0,1,0,1,1612,5,633
"15560","중곡제3동","중곡제3동제2투","대통령선거","서울특별시","광진구",2149,1536,619,337,362,106,100,3,0,1,2,0,0,0,1,1531,5,613
"15561","중곡제3동","중곡제3동제3투","대통령선거","서울특별시","광진구",2464,1664,671,333,412,115,119,2,0,1,1,1,0,1,1,1657,7,800
"15562","중곡제3동","중곡제3동제4투","대통령선거","서울특별시","광진구",2658,1685,651,377,453,91,101,6,0,0,1,0,0,1,2,1683,2,973
"15563","중곡제3동","중곡제3동제5투","대통령선거","서울특별시","광진구",2127,1420,562,339,338,96,73,5,1,2,0,1,1,0,0,1418,2,707
"15564","중곡제4동","관내사전투표","대통령선거","서울특별시","광진구",4211,4211,1948,825,886,251,277,5,0,0,1,2,2,0,1,4198,13,0
"15565","중곡제4동","중곡제4동제1투","대통령선거","서울특별시","광진구",2521,1874,758,406,438,131,131,3,0,1,0,0,0,0,0,1868,6,647
"15566","중곡제4동","중곡제4동제2투","대통령선거","서울특별시","광진구",3018,2294,986,465,520,148,158,1,1,3,1,3,0,1,1,2288,6,724
"15567","중곡제4동","중곡제4동제3투","대통령선거","서울특별시","광진구",2781,1719,709,390,377,98,122,5,0,3,2,2,0,2,2,1712,7,1062
"15568","중곡제4동","중곡제4동제4투","대통령선거","서울특별시","광진구",2607,1770,666,420,461,87,120,2,0,1,1,0,1,0,1,1760,10,837
"15569","중곡제4동","중곡제4동제5투","대통령선거","서울특별시","광진구",3021,2137,908,460,453,141,153,10,0,1,1,1,0,0,2,2130,7,884
"15570","중곡제4동","중곡제4동제6투","대통령선거","서울특별시","광진구",2888,1969,735,504,471,125,120,1,0,3,0,1,0,0,3,1963,6,919
"15571","중곡제4동","중곡제4동제7투","대통령선거","서울특별시","광진구",3365,2494,1019,508,612,180,157,2,0,0,0,6,2,0,4,2490,4,871
"15572","능동","관내사전투표","대통령선거","서울특별시","광진구",2093,2093,1105,278,377,139,187,1,0,0,0,1,0,0,2,2090,3,0
"15573","능동","능동제1투","대통령선거","서울특별시","광진구",2029,1354,597,257,297,99,98,4,0,0,0,0,0,0,0,1352,2,675
"15574","능동","능동제2투","대통령선거","서울특별시","광진구",2252,1645,720,328,340,131,113,3,0,0,0,1,0,1,2,1639,6,607
"15575","능동","능동제3투","대통령선거","서울특별시","광진구",2729,2044,911,427,438,148,114,3,0,0,0,0,0,0,0,2041,3,685
"15576","구의제1동","관내사전투표","대통령선거","서울특별시","광진구",3907,3907,2020,556,757,262,284,5,0,2,3,2,0,1,1,3893,14,0
"15577","구의제1동","구의제1동제1투","대통령선거","서울특별시","광진구",2977,1961,818,378,476,150,127,4,1,0,0,0,1,0,1,1956,5,1016
"15578","구의제1동","구의제1동제2투","대통령선거","서울특별시","광진구",2968,2076,896,424,484,133,126,5,0,1,0,0,0,0,0,2069,7,892
"15579","구의제1동","구의제1동제3투","대통령선거","서울특별시","광진구",2921,2079,888,409,463,154,143,4,0,2,1,3,2,1,0,2070,9,842
"15580","구의제1동","구의제1동제4투","대통령선거","서울특별시","광진구",2540,1789,809,327,401,112,134,1,0,1,0,2,0,0,1,1788,1,751
"15581","구의제1동","구의제1동제5투","대통령선거","서울특별시","광진구",2741,1853,800,349,453,128,116,2,0,1,0,1,0,1,0,1851,2,888
"15582","구의제2동","관내사전투표","대통령선거","서울특별시","광진구",3193,3193,1629,558,586,194,201,5,0,1,3,4,3,1,0,3185,8,0
"15583","구의제2동","구의제2동제1투","대통령선거","서울특별시","광진구",2832,1801,761,376,414,106,132,6,0,1,0,0,0,0,1,1797,4,1031
"15584","구의제2동","구의제2동제2투","대통령선거","서울특별시","광진구",2966,2038,830,470,466,129,132,1,0,1,0,2,1,1,0,2033,5,928
"15585","구의제2동","구의제2동제3투","대통령선거","서울특별시","광진구",2611,1946,788,470,467,112,96,2,0,2,2,2,1,1,1,1944,2,665
"15586","구의제2동","구의제2동제4투","대통령선거","서울특별시","광진구",2916,2181,903,465,525,137,137,1,0,1,0,0,0,2,1,2172,9,735
"15587","구의제2동","구의제2동제5투","대통령선거","서울특별시","광진구",2355,1599,672,360,365,99,89,3,0,2,1,1,0,0,0,1592,7,756
"15588","구의제2동","구의제2동제6투","대통령선거","서울특별시","광진구",2395,1778,752,401,387,107,113,6,0,1,0,1,1,1,2,1772,6,617
"15589","구의제3동","관내사전투표","대통령선거","서울특별시","광진구",4839,4839,2403,801,844,422,350,5,0,0,1,0,0,2,2,4830,9,0
"15590","구의제3동","구의제3동제1투","대통령선거","서울특별시","광진구",3200,2696,1046,557,667,259,155,0,0,0,0,0,0,1,1,2686,10,504
"15591","구의제3동","구의제3동제2투","대통령선거","서울특별시","광진구",2891,2137,926,439,501,122,135,1,0,1,0,2,0,2,0,2129,8,754
"15592","구의제3동","구의제3동제3투","대통령선거","서울특별시","광진구",3095,2277,985,437,562,153,133,0,0,2,0,0,0,0,0,2272,5,818
"15593","구의제3동","구의제3동제4투","대통령선거","서울특별시","광진구",2649,1901,710,457,438,168,117,2,0,0,0,0,1,1,0,1894,7,748
"15594","구의제3동","구의제3동제5투","대통령선거","서울특별시","광진구",3111,2391,894,569,574,201,131,4,0,2,0,3,0,2,1,2381,10,720
"15595","구의제3동","구의제3동제6투","대통령선거","서울특별시","광진구",2993,2455,859,699,546,230,110,4,0,1,0,0,1,0,1,2451,4,538
"15596","광장동","관내사전투표","대통령선거","서울특별시","광진구",3991,3991,1774,790,786,377,240,6,0,1,1,2,0,1,1,3979,12,0
"15597","광장동","광장동제1투","대통령선거","서울특별시","광진구",3621,2442,830,630,622,213,130,5,0,2,0,1,0,2,0,2435,7,1179
"15598","광장동","광장동제2투","대통령선거","서울특별시","광진구",2535,1862,555,718,378,130,64,2,1,2,0,1,1,1,3,1856,6,673
"15599","광장동","광장동제3투","대통령선거","서울특별시","광진구",3041,2542,1168,395,570,225,174,2,0,1,0,0,0,0,0,2535,7,499
"15600","광장동","광장동제4투","대통령선거","서울특별시","광진구",3463,2967,1391,427,661,293,179,4,0,1,0,1,0,0,1,2958,9,496
"15601","광장동","광장동제5투","대통령선거","서울특별시","광진구",3819,3111,1410,511,655,308,219,3,0,0,1,0,0,1,2,3110,1,708
"15602","광장동","광장동제6투","대통령선거","서울특별시","광진구",3284,2654,998,604,623,263,154,2,0,2,0,0,0,1,1,2648,6,630
"15603","자양제1동","관내사전투표","대통령선거","서울특별시","광진구",3929,3929,1913,646,832,215,295,3,1,4,0,6,1,1,1,3918,11,0
"15604","자양제1동","자양제1동제1투","대통령선거","서울특별시","광진구",2586,1533,655,298,384,93,90,2,0,0,0,2,0,0,2,1526,7,1053
"15605","자양제1동","자양제1동제2투","대통령선거","서울특별시","광진구",2047,1431,606,287,325,108,96,2,0,0,0,0,0,0,2,1426,5,616
"15606","자양제1동","자양제1동제3투","대통령선거","서울특별시","광진구",2985,2141,963,383,479,142,154,5,0,0,0,1,0,1,0,2128,13,844
"15607","자양제1동","자양제1동제4투","대통령선거","서울특별시","광진구",2172,1516,639,313,359,90,107,0,1,2,0,0,1,0,1,1513,3,656
"15608","자양제1동","자양제1동제5투","대통령선거","서울특별시","광진구",2226,1369,598,256,343,82,78,4,0,1,0,1,0,0,1,1364,5,857
"15609","자양제1동","자양제1동제6투","대통령선거","서울특별시","광진구",2316,1576,672,331,351,106,107,0,0,2,0,2,0,0,1,1572,4,740
"15610","자양제2동","관내사전투표","대통령선거","서울특별시","광진구",3016,3016,1482,535,584,187,214,4,0,2,1,1,1,0,0,3011,5,0
"15611","자양제2동","자양제2동제1투","대통령선거","서울특별시","광진구",3200,2168,873,477,510,155,142,3,0,1,1,1,0,1,0,2164,4,1032
"15612","자양제2동","자양제2동제2투","대통령선거","서울특별시","광진구",3137,2353,808,645,576,180,124,7,0,2,1,0,1,1,2,2347,6,784
"15613","자양제2동","자양제2동제3투","대통령선거","서울특별시","광진구",2606,1822,785,327,449,127,125,2,0,1,0,1,0,0,1,1818,4,784
"15614","자양제2동","자양제2동제4투","대통령선거","서울특별시","광진구",2548,1924,831,376,463,123,120,0,1,0,1,3,2,0,0,1920,4,624
"15615","자양제2동","자양제2동제5투","대통령선거","서울특별시","광진구",2486,1736,739,322,429,113,121,2,1,1,0,1,1,1,1,1732,4,750
"15616","자양제2동","자양제2동제6투","대통령선거","서울특별시","광진구",2937,2066,921,375,512,120,125,1,0,3,0,1,0,0,1,2059,7,871
"15617","자양제3동","관내사전투표","대통령선거","서울특별시","광진구",4941,4941,2405,815,1010,352,337,5,0,0,1,2,1,1,2,4931,10,0
"15618","자양제3동","자양제3동제1투","대통령선거","서울특별시","광진구",2765,1961,835,425,456,136,97,0,0,1,0,2,0,0,0,1952,9,804
"15619","자양제3동","자양제3동제2투","대통령선거","서울특별시","광진구",2920,2155,797,472,556,184,133,4,0,2,0,1,1,0,0,2150,5,765
"15620","자양제3동","자양제3동제3투","대통령선거","서울특별시","광진구",2603,2111,858,449,497,154,145,2,0,1,0,0,0,1,0,2107,4,492
"15621","자양제3동","자양제3동제4투","대통령선거","서울특별시","광진구",2351,1899,782,406,435,164,99,1,0,2,0,0,0,0,0,1889,10,452
"15622","자양제3동","자양제3동제5투","대통령선거","서울특별시","광진구",2290,1851,792,306,454,175,116,0,0,0,0,1,0,0,1,1845,6,439
"15623","자양제3동","자양제3동제6투","대통령선거","서울특별시","광진구",1432,1009,418,217,227,78,62,2,0,0,0,0,0,1,0,1005,4,423
"15624","자양제3동","자양제3동제7투","대통령선거","서울특별시","광진구",3270,2619,658,978,646,226,93,4,0,0,1,0,0,1,0,2607,12,651
"15625","자양제4동","관내사전투표","대통령선거","서울특별시","광진구",3054,3054,1436,563,668,169,192,2,0,2,1,5,0,1,1,3040,14,0
"15626","자양제4동","자양제4동제1투","대통령선거","서울특별시","광진구",2384,1313,536,292,337,89,54,0,0,1,0,0,0,0,0,1309,4,1071
"15627","자양제4동","자양제4동제2투","대통령선거","서울특별시","광진구",2496,1733,694,388,418,125,96,3,0,0,0,1,0,0,1,1726,7,763
"15628","자양제4동","자양제4동제3투","대통령선거","서울특별시","광진구",2685,1770,700,383,498,90,86,2,0,0,2,1,0,0,1,1763,7,915
"15629","자양제4동","자양제4동제4투","대통령선거","서울특별시","광진구",2838,1843,749,423,432,115,108,6,0,1,0,3,1,1,0,1839,4,995
"15630","자양제4동","자양제4동제5투","대통령선거","서울특별시","광진구",2528,1657,686,394,394,99,69,0,0,1,1,0,0,2,4,1650,7,871
"15631","자양제4동","자양제4동제6투","대통령선거","서울특별시","광진구",2127,1512,630,339,365,84,80,3,0,0,0,0,0,0,1,1502,10,615
"15632","화양동","관내사전투표","대통령선거","서울특별시","광진구",3677,3677,1937,378,582,354,401,3,1,1,0,1,0,2,5,3665,12,0
"15633","화양동","화양동제1투","대통령선거","서울특별시","광진구",3448,2031,935,290,382,190,223,1,2,2,0,0,0,0,1,2026,5,1417
"15634","화양동","화양동제2투","대통령선거","서울특별시","광진구",2343,1597,749,271,272,162,135,1,0,1,0,0,1,0,1,1593,4,746
"15635","화양동","화양동제3투","대통령선거","서울특별시","광진구",2675,1807,800,311,407,124,144,2,0,1,1,3,0,0,2,1795,12,868
"15636","화양동","화양동제4투","대통령선거","서울특별시","광진구",2152,1383,620,224,301,115,117,0,0,1,0,0,0,0,1,1379,4,769
"15637","화양동","화양동제5투","대통령선거","서울특별시","광진구",2025,1391,615,261,253,123,129,0,1,0,1,0,1,0,1,1385,6,634
"15638","화양동","화양동제6투","대통령선거","서울특별시","광진구",1462,959,399,208,189,75,76,2,0,0,0,1,0,0,2,952,7,503
"15639","군자동","관내사전투표","대통령선거","서울특별시","광진구",2630,2630,1361,361,464,185,229,4,2,1,1,4,2,2,4,2620,10,0
"15640","군자동","군자동제1투","대통령선거","서울특별시","광진구",2749,1799,813,333,386,112,140,4,1,3,0,2,1,0,0,1795,4,950
"15641","군자동","군자동제2투","대통령선거","서울특별시","광진구",1779,1309,568,228,324,88,97,0,0,0,0,1,0,0,0,1306,3,470
"15642","군자동","군자동제3투","대통령선거","서울특별시","광진구",1999,1400,597,272,330,65,118,2,0,5,2,0,0,0,3,1394,6,599
"15643","군자동","군자동제4투","대통령선거","서울특별시","광진구",2309,1619,678,339,372,98,120,2,0,2,0,0,0,0,2,1613,6,690
"15644","군자동","군자동제5투","대통령선거","서울특별시","광진구",2081,1571,583,393,397,111,78,4,0,0,0,0,0,0,2,1568,3,510
"15645","군자동","군자동제6투","대통령선거","서울특별시","광진구",2350,1670,667,382,387,94,130,2,0,0,0,1,0,0,0,1663,7,680
"15646","잘못 투입·구분된 투표지","잘못 투입·구분된 투표지","대통령선거","서울특별시","광진구",0,0,0,0,0,0,0,0,0,0,0,0,0,0,0,0,0,0
"15647","거소·선상투표","거소·선상투표","대통령선거","서울특별시","동대문구",399,376,117,76,135,23,13,0,1,0,0,0,1,0,0,366,10,23
"15648","관외사전투표","관외사전투표","대통령선거","서울특별시","동대문구",27360,27359,13276,3791,5501,2108,2425,39,5,15,7,26,8,6,34,27241,118,1
"15649","재외투표","재외투표","대통령선거","서울특별시","동대문구",2946,2186,1292,207,334,90,239,14,0,0,0,0,0,0,0,2176,10,760
"15650","용신동","관내사전투표","대통령선거","서울특별시","동대문구",4165,4165,1978,774,842,260,278,9,0,1,1,3,2,3,0,4151,14,0
"15651","용신동","용신동제1투","대통령선거","서울특별시","동대문구",3418,2012,743,452,524,167,110,4,3,2,0,0,2,1,0,2008,4,1406
"15652","용신동","용신동제2투","대통령선거","서울특별시","동대문구",2798,2023,800,488,496,107,117,3,0,1,2,1,0,1,1,2017,6,775
"15653","용신동","용신동제3투","대통령선거","서울특별시","동대문구",2823,1832,682,468,503,86,78,3,2,0,0,0,0,2,2,1826,6,991
"15654","용신동","용신동제4투","대통령선거","서울특별시","동대문구",2213,1507,593,390,340,98,74,1,1,1,0,0,1,1,1,1501,6,706
"15655","용신동","용신동제5투","대통령선거","서울특별시","동대문구",2480,1610,674,334,379,103,113,3,0,0,0,0,0,1,0,1607,3,870
"15656","용신동","용신동제6투","대통령선거","서울특별시","동대문구",2200,1424,528,414,321,76,78,2,0,0,0,2,0,0,0,1421,3,776
"15657","용신동","용신동제7투","대통령선거","서울특별시","동대문구",2641,1656,623,470,346,88,105,9,0,0,1,3,0,4,0,1649,7,985
"15658","용신동","용신동제8투","대통령선거","서울특별시","동대문구",2571,1785,737,413,411,110,101,2,1,2,0,1,0,0,0,1778,7,786
"15659","제기동","관내사전투표","대통령선거","서울특별시","동대문구",3647,3647,1572,782,829,213,218,4,1,4,1,2,1,1,3,3631,16,0
"15660","제기동","제기동제1투","대통령선거","서울특별시","동대문구",3326,2026,656,676,487,105,75,3,0,4,1,1,1,3,5,2017,9,1300
"15661","제기동","제기동제2투","대통령선거","서울특별시","동대문구",2996,2161,780,564,530,139,129,5,0,1,1,1,0,2,3,2155,6,835
"15662","제기동","제기동제3투","대통령선거","서울특별시","동대문구",3038,1681,613,446,401,103,102,4,0,0,0,2,1,3,2,1677,4,1357
"15663","제기동","제기동제4투","대통령선거","서울특별시","동대문구",2691,1796,666,490,385,124,115,0,0,2,0,1,0,1,3,1787,9,895
"15664","제기동","제기동제5투","대통령선거","서울특별시","동대문구",2293,1704,710,345,391,144,105,0,0,2,0,0,1,1,1,1700,4,589
"15665","제기동","제기동제6투","대통령선거","서울특별시","동대문구",2604,1967,793,440,486,124,108,6,0,2,1,0,0,0,2,1962,5,637
"15666","전농제1동","관내사전투표","대통령선거","서울특별시","동대문구",3345,3345,1488,670,729,233,199,3,0,3,1,1,0,0,1,3328,17,0
"15667","전농제1동","전농제1동제1투","대통령선거","서울특별시","동대문구",3289,1791,688,425,476,99,84,2,1,3,1,1,1,1,2,1784,7,1498
"15668","전농제1동","전농제1동제2투","대통령선거","서울특별시","동대문구",1817,1096,443,239,293,45,62,1,3,2,0,2,0,0,1,1091,5,721
"15669","전농제1동","전농제1동제3투","대통령선거","서울특별시","동대문구",2926,2066,764,523,502,137,117,5,0,1,1,0,0,1,2,2053,13,860
"15670","전농제1동","전농제1동제4투","대통령선거","서울특별시","동대문구",2261,1513,623,398,320,79,74,3,0,3,1,2,1,1,2,1507,6,748
"15671","전농제1동","전농제1동제5투","대통령선거","서울특별시","동대문구",2475,1599,600,418,402,80,86,5,0,2,0,1,0,1,0,1595,4,876
"15672","전농제1동","전농제1동제6투","대통령선거","서울특별시","동대문구",2185,1423,533,392,348,59,75,2,0,1,0,2,1,0,1,1414,9,762
"15673","전농제1동","전농제1동제7투","대통령선거","서울특별시","동대문구",2191,1732,730,345,431,108,103,4,0,0,0,1,0,0,1,1723,9,459
"15674","전농제1동","전농제1동제8투","대통령선거","서울특별시","동대문구",2432,2031,838,416,481,166,118,5,0,0,0,2,1,0,0,2027,4,401
"15675","전농제2동","관내사전투표","대통령선거","서울특별시","동대문구",3727,3727,1718,726,750,243,262,5,1,4,1,2,1,1,1,3715,12,0
"15676","전농제2동","전농제2동제1투","대통령선거","서울특별시","동대문구",1998,1510,568,395,373,72,95,4,0,0,1,1,0,0,0,1509,1,488
"15677","전농제2동","전농제2동제2투","대통령선거","서울특별시","동대문구",2717,2163,816,546,533,148,109,1,0,1,1,1,1,0,1,2158,5,554
"15678","전농제2동","전농제2동제3투","대통령선거","서울특별시","동대문구",2262,1649,633,400,418,98,81,3,0,2,0,3,0,0,3,1641,8,613
"15679","전농제2동","전농제2동제4투","대통령선거","서울특별시","동대문구",3264,2354,848,656,551,157,131,1,0,2,1,1,0,1,1,2350,4,910
"15680","전농제2동","전농제2동제5투","대통령선거","서울특별시","동대문구",2051,1404,574,310,353,86,72,1,1,0,0,0,3,1,1,1402,2,647
"15681","답십리제1동","관내사전투표","대통령선거","서울특별시","동대문구",2703,2703,1350,460,511,182,187,2,0,0,0,3,0,1,2,2698,5,0
"15682","답십리제1동","답십리제1동제1투","대통령선거","서울특별시","동대문구",2451,1329,564,268,322,89,75,4,0,0,0,1,0,0,1,1324,5,1122
"15683","답십리제1동","답십리제1동제2투","대통령선거","서울특별시","동대문구",2927,2003,794,482,485,112,116,2,1,2,0,0,1,0,2,1997,6,924
"15684","답십리제1동","답십리제1동제3투","대통령선거","서울특별시","동대문구",2403,1969,810,379,513,140,120,2,0,0,0,0,1,1,0,1966,3,434
"15685","답십리제1동","답십리제1동제4투","대통령선거","서울특별시","동대문구",2582,2074,949,350,482,148,128,3,1,0,1,4,0,0,1,2067,7,508
"15686","답십리제1동","답십리제1동제5투","대통령선거","서울특별시","동대문구",1662,1155,472,267,283,61,66,0,0,0,0,2,1,0,0,1152,3,507
"15687","답십리제1동","답십리제1동제6투","대통령선거","서울특별시","동대문구",1738,1289,501,315,330,82,51,1,1,0,0,0,0,2,1,1284,5,449
"15688","답십리제1동","답십리제1동제7투","대통령선거","서울특별시","동대문구",2266,1819,749,375,420,140,121,3,0,0,0,2,0,2,1,1813,6,447
"15689","답십리제2동","관내사전투표","대통령선거","서울특별시","동대문구",3128,3128,1457,622,698,167,158,3,0,4,0,0,2,0,3,3114,14,0
"15690","답십리제2동","답십리제2동제1투","대통령선거","서울특별시","동대문구",2596,1591,650,318,399,116,91,3,0,2,0,1,0,0,2,1582,9,1005
"15691","답십리제2동","답십리제2동제2투","대통령선거","서울특별시","동대문구",2535,1890,749,440,457,113,113,4,0,2,0,1,1,2,2,1884,6,645
"15692","답십리제2동","답십리제2동제3투","대통령선거","서울특별시","동대문구",2069,1580,574,392,379,97,122,0,0,2,2,1,1,0,0,1570,10,489
"15693","답십리제2동","답십리제2동제4투","대통령선거","서울특별시","동대문구",2713,2104,900,437,485,121,142,5,1,1,0,1,0,0,2,2095,9,609
"15694","답십리제2동","답십리제2동제5투","대통령선거","서울특별시","동대문구",2959,2277,927,533,555,134,112,4,0,2,0,0,0,3,4,2274,3,682
"15695","답십리제2동","답십리제2동제6투","대통령선거","서울특별시","동대문구",3184,2545,958,656,617,152,150,4,0,0,0,0,1,0,1,2539,6,639
"15696","답십리제2동","답십리제2동제7투","대통령선거","서울특별시","동대문구",3381,2215,808,601,584,95,114,3,0,1,1,3,0,0,1,2211,4,1166
"15697","장안제1동","관내사전투표","대통령선거","서울특별시","동대문구",4758,4758,2296,906,998,254,278,5,0,3,1,4,0,3,3,4751,7,0
"15698","장안제1동","장안제1동제1투","대통령선거","서울특별시","동대문구",3125,1796,739,397,476,82,90,2,0,0,0,1,2,0,0,1789,7,1329
"15699","장안제1동","장안제1동제2투","대통령선거","서울특별시","동대문구",3405,2333,906,554,578,139,142,1,0,0,0,2,0,2,3,2327,6,1072
"15700","장안제1동","장안제1동제3투","대통령선거","서울특별시","동대문구",3547,2221,939,472,551,127,117,2,0,1,0,0,0,2,2,2213,8,1326
"15701","장안제1동","장안제1동제4투","대통령선거","서울특별시","동대문구",3550,2512,1008,611,596,128,157,3,0,0,0,0,0,0,2,2505,7,1038
"15702","장안제1동","장안제1동제5투","대통령선거","서울특별시","동대문구",2705,1949,783,444,474,117,116,6,0,1,0,1,2,0,1,1945,4,756
"15703","장안제1동","장안제1동제6투","대통령선거","서울특별시","동대문구",3174,2240,897,513,560,141,109,4,0,0,0,4,0,0,0,2228,12,934
"15704","장안제1동","장안제1동제7투","대통령선거","서울특별시","동대문구",2866,2351,909,666,516,143,106,3,0,2,0,0,0,0,0,2345,6,515
"15705","장안제1동","장안제1동제8투","대통령선거","서울특별시","동대문구",2945,2450,987,648,521,157,127,0,0,1,0,0,0,0,0,2441,9,495
"15706","장안제2동","관내사전투표","대통령선거","서울특별시","동대문구",4641,4641,2064,1046,945,257,296,4,1,2,4,2,0,3,2,4626,15,0
"15707","장안제2동","장안제2동제1투","대통령선거","서울특별시","동대문구",1933,1143,402,321,309,60,42,3,0,1,0,0,0,0,2,1140,3,790
"15708","장안제2동","장안제2동제2투","대통령선거","서울특별시","동대문구",2772,1986,723,510,488,118,126,4,2,1,0,0,1,1,2,1976,10,786
"15709","장안제2동","장안제2동제3투","대통령선거","서울특별시","동대문구",1662,1081,393,284,256,78,67,2,0,0,0,0,0,0,0,1080,1,581
"15710","장안제2동","장안제2동제4투","대통령선거","서울특별시","동대문구",2166,1439,505,378,378,80,83,5,0,1,1,1,1,0,2,1435,4,727
"15711","장안제2동","장안제2동제5투","대통령선거","서울특별시","동대문구",3197,2260,951,512,541,125,114,4,0,1,0,1,0,2,2,2253,7,937
"15712","장안제2동","장안제2동제6투","대통령선거","서울특별시","동대문구",1920,1350,515,341,319,92,76,2,0,1,0,0,0,0,2,1348,2,570
"15713","장안제2동","장안제2동제7투","대통령선거","서울특별시","동대문구",3466,2843,1256,586,685,178,124,4,0,2,0,0,0,1,0,2836,7,623
"15714","장안제2동","장안제2동제8투","대통령선거","서울특별시","동대문구",2509,1928,846,388,438,136,109,2,0,1,0,0,0,1,0,1921,7,581
"15715","청량리동","관내사전투표","대통령선거","서울특별시","동대문구",2780,2780,1230,629,544,178,178,5,1,4,0,0,1,0,1,2771,9,0
"15716","청량리동","청량리동제1투","대통령선거","서울특별시","동대문구",2612,1353,485,363,319,91,81,3,0,0,0,0,2,0,0,1344,9,1259
"15717","청량리동","청량리동제2투","대통령선거","서울특별시","동대문구",2837,2216,813,608,535,126,114,5,0,4,1,5,0,0,0,2211,5,621
"15718","청량리동","청량리동제3투","대통령선거","서울특별시","동대문구",2081,1361,491,363,343,76,72,3,0,0,3,0,0,0,3,1354,7,720
"15719","청량리동","청량리동제4투","대통령선거","서울특별시","동대문구",2195,1416,442,488,339,66,64,5,0,3,0,0,0,1,1,1409,7,779
"15720","청량리동","청량리동제5투","대통령선거","서울특별시","동대문구",2562,1848,568,573,500,103,88,3,1,1,0,3,0,1,1,1842,6,714
"15721","청량리동","청량리동제6투","대통령선거","서울특별시","동대문구",3138,2287,663,804,555,146,107,5,1,0,0,1,0,0,1,2283,4,851
"15722","회기동","관내사전투표","대통령선거","서울특별시","동대문구",3501,3501,1833,440,503,328,362,4,0,0,1,10,4,1,2,3488,13,0
"15723","회기동","회기동제1투","대통령선거","서울특별시","동대문구",2317,1484,604,308,304,145,107,0,0,1,0,1,0,0,2,1472,12,833
"15724","회기동","회기동제2투","대통령선거","서울특별시","동대문구",2063,1537,681,314,324,111,99,2,0,1,1,0,0,0,0,1533,4,526
"15725","회기동","회기동제3투","대통령선거","서울특별시","동대문구",1665,1130,496,263,229,76,60,1,0,0,0,1,2,0,1,1129,1,535
"15726","휘경제1동","관내사전투표","대통령선거","서울특별시","동대문구",1900,1900,859,386,383,119,140,1,0,3,1,1,0,2,2,1897,3,0
"15727","휘경제1동","휘경제1동제1투","대통령선거","서울특별시","동대문구",1859,1105,378,321,271,56,68,2,0,0,0,1,0,1,0,1098,7,754
"15728","휘경제1동","휘경제1동제2투","대통령선거","서울특별시","동대문구",2103,1283,473,342,324,53,78,1,0,2,0,1,0,2,3,1279,4,820
"15729","휘경제1동","휘경제1동제3투","대통령선거","서울특별시","동대문구",2348,1606,754,279,303,136,118,7,0,2,0,0,0,0,1,1600,6,742
"15730","휘경제1동","휘경제1동제4투","대통령선거","서울특별시","동대문구",2059,1547,533,425,408,86,89,1,0,0,0,0,2,0,1,1545,2,512
"15731","휘경제2동","관내사전투표","대통령선거","서울특별시","동대문구",2166,2166,1063,397,389,131,170,3,3,4,0,0,0,0,0,2160,6,0
"15732","휘경제2동","휘경제2동제1투","대통령선거","서울특별시","동대문구",2136,1451,561,349,311,99,121,1,1,0,0,2,0,0,1,1446,5,685
"15733","휘경제2동","휘경제2동제2투","대통령선거","서울특별시","동대문구",2311,1894,812,405,454,98,114,2,1,2,0,0,0,1,1,1890,4,417
"15734","휘경제2동","휘경제2동제3투","대통령선거","서울특별시","동대문구",2898,2181,868,436,487,172,198,2,0,1,0,3,1,0,5,2173,8,717
"15735","휘경제2동","휘경제2동제4투","대통령선거","서울특별시","동대문구",3080,2253,897,519,506,139,170,3,2,0,0,3,3,1,1,2244,9,827
"15736","휘경제2동","휘경제2동제5투","대통령선거","서울특별시","동대문구",2828,2305,965,529,521,136,133,4,0,3,0,4,1,1,0,2297,8,523
"15737","휘경제2동","휘경제2동제6투","대통령선거","서울특별시","동대문구",2334,1725,721,405,395,88,100,4,0,4,0,1,1,0,1,1720,5,609
"15738","이문제1동","관내사전투표","대통령선거","서울특별시","동대문구",3305,3305,1568,588,612,246,268,0,0,1,0,5,3,1,1,3293,12,0
"15739","이문제1동","이문제1동제1투","대통령선거","서울특별시","동대문구",2497,1354,525,349,333,64,69,2,0,0,1,2,0,1,0,1346,8,1143
"15740","이문제1동","이문제1동제2투","대통령선거","서울특별시","동대문구",2131,1429,564,324,384,73,67,0,1,2,0,0,2,0,2,1419,10,702
"15741","이문제1동","이문제1동제3투","대통령선거","서울특별시","동대문구",1845,1253,507,287,290,85,70,3,0,2,0,2,0,0,1,1247,6,592
"15742","이문제1동","이문제1동제4투","대통령선거","서울특별시","동대문구",2110,1323,503,338,281,76,112,0,0,0,0,0,3,1,1,1315,8,787
"15743","이문제1동","이문제1동제5투","대통령선거","서울특별시","동대문구",2156,1677,667,408,347,123,119,3,0,1,0,2,0,1,1,1672,5,479
"15744","이문제1동","이문제1동제6투","대통령선거","서울특별시","동대문구",2111,1539,630,335,310,133,110,4,0,1,1,1,4,1,0,1530,9,572
"15745","이문제1동","이문제1동제7투","대통령선거","서울특별시","동대문구",1970,1558,573,388,329,146,113,5,0,0,0,0,1,0,0,1555,3,412
"15746","이문제1동","이문제1동제8투","대통령선거","서울특별시","동대문구",1661,1148,495,217,249,83,89,1,0,1,1,3,1,0,0,1140,8,513
"15747","이문제1동","이문제1동제9투","대통령선거","서울특별시","동대문구",1870,1245,438,306,322,87,82,0,1,0,0,1,2,1,1,1241,4,625
"15748","이문제2동","관내사전투표","대통령선거","서울특별시","동대문구",2667,2667,1238,537,524,182,166,6,0,4,0,2,1,0,1,2661,6,0
"15749","이문제2동","이문제2동제1투","대통령선거","서울특별시","동대문구",2707,1650,601,407,387,111,128,1,0,3,0,1,2,1,1,1643,7,1057
"15750","이문제2동","이문제2동제2투","대통령선거","서울특별시","동대문구",2569,1646,609,394,447,79,109,0,0,1,0,1,0,2,0,1642,4,923
"15751","이문제2동","이문제2동제3투","대통령선거","서울특별시","동대문구",2728,2060,882,430,478,134,115,6,0,0,0,5,2,0,3,2055,5,668
"15752","이문제2동","이문제2동제4투","대통령선거","서울특별시","동대문구",2828,2329,972,489,546,162,149,4,0,2,1,0,0,0,0,2325,4,499
"15753","이문제2동","이문제2동제5투","대통령선거","서울특별시","동대문구",2857,2307,968,537,522,147,114,3,2,2,0,0,1,1,2,2299,8,550
"15754","잘못 투입·구분된 투표지","잘못 투입·구분된 투표지","대통령선거","서울특별시","동대문구",0,1,0,0,1,0,0,0,0,0,0,0,0,0,0,1,0,-1
"15755","거소·선상투표","거소·선상투표","대통령선거","서울특별시","중랑구",630,598,212,111,192,30,24,3,2,1,0,0,1,1,1,578,20,32
"15756","관외사전투표","관외사전투표","대통령선거","서울특별시","중랑구",28364,28358,13462,4327,6099,1955,2207,27,5,24,14,17,8,8,40,28193,165,6
"15757","재외투표","재외투표","대통령선거","서울특별시","중랑구",2371,1813,1173,146,235,57,189,4,0,0,0,1,0,1,1,1807,6,558
"15758","면목본동","관내사전투표","대통령선거","서울특별시","중랑구",5342,5342,2459,956,1194,313,361,11,0,7,0,3,1,5,6,5316,26,0
"15759","면목본동","면목본동제1투","대통령선거","서울특별시","중랑구",4193,2418,888,595,604,149,169,2,0,1,2,0,1,1,1,2413,5,1775
"15760","면목본동","면목본동제2투","대통령선거","서울특별시","중랑구",3230,2121,822,494,572,109,114,2,0,0,0,1,0,1,2,2117,4,1109
"15761","면목본동","면목본동제3투","대통령선거","서울특별시","중랑구",3513,2315,914,508,610,124,136,0,1,1,3,3,2,1,1,2304,11,1198
"15762","면목본동","면목본동제4투","대통령선거","서울특별시","중랑구",3362,2186,897,450,545,135,142,3,0,1,0,1,2,1,1,2178,8,1176
"15763","면목본동","면목본동제5투","대통령선거","서울특별시","중랑구",3256,2130,827,530,507,122,130,1,0,0,0,0,0,1,1,2119,11,1126
"15764","면목본동","면목본동제6투","대통령선거","서울특별시","중랑구",3525,2168,900,410,561,125,156,2,0,1,1,3,0,0,4,2163,5,1357
"15765","면목본동","면목본동제7투","대통령선거","서울특별시","중랑구",3150,2078,868,409,531,127,123,8,1,1,0,1,0,1,0,2070,8,1072
"15766","면목제2동","관내사전투표","대통령선거","서울특별시","중랑구",2921,2921,1370,545,659,141,187,3,0,1,1,1,0,0,2,2910,11,0
"15767","면목제2동","면목제2동제1투","대통령선거","서울특별시","중랑구",4043,2424,976,535,617,130,140,7,0,5,2,1,0,0,2,2415,9,1619
"15768","면목제2동","면목제2동제2투","대통령선거","서울특별시","중랑구",3211,2280,873,545,576,130,141,2,0,2,1,1,1,1,0,2273,7,931
"15769","면목제2동","면목제2동제3투","대통령선거","서울특별시","중랑구",3895,2607,1017,589,668,149,167,1,0,2,2,0,2,0,3,2600,7,1288
"15770","면목제2동","면목제2동제4투","대통령선거","서울특별시","중랑구",3349,2098,818,464,543,111,146,5,0,2,0,2,1,1,0,2093,5,1251
"15771","면목제2동","면목제2동제5투","대통령선거","서울특별시","중랑구",3347,2158,870,490,524,123,133,1,0,0,3,0,0,0,2,2146,12,1189
"15772","면목제3·8동","관내사전투표","대통령선거","서울특별시","중랑구",3133,3133,1410,664,661,174,193,6,2,5,0,1,1,2,3,3122,11,0
"15773","면목제3·8동","면목제3·8동제1투","대통령선거","서울특별시","중랑구",3065,1733,643,469,424,84,104,0,0,1,1,1,1,1,1,1730,3,1332
"15774","면목제3·8동","면목제3·8동제2투","대통령선거","서울특별시","중랑구",2500,1672,674,362,428,91,101,3,1,1,0,0,0,0,6,1667,5,828
"15775","면목제3·8동","면목제3·8동제3투","대통령선거","서울특별시","중랑구",2518,1581,660,326,382,92,100,3,0,2,1,4,0,3,4,1577,4,937
"15776","면목제3·8동","면목제3·8동제4투","대통령선거","서울특별시","중랑구",2534,1658,692,371,398,98,81,4,0,0,0,4,0,2,2,1652,6,876
"15777","면목제3·8동","면목제3·8동제5투","대통령선거","서울특별시","중랑구",2810,2025,804,474,502,123,112,1,0,1,0,3,0,2,1,2023,2,785
"15778","면목제3·8동","면목제3·8동제6투","대통령선거","서울특별시","중랑구",2372,1462,526,368,369,88,99,2,0,3,0,1,0,1,1,1458,4,910
"15779","면목제3·8동","면목제3·8동제7투","대통령선거","서울특별시","중랑구",2583,1813,704,427,484,84,89,6,0,5,0,1,1,1,2,1804,9,770
"15780","면목제4동","관내사전투표","대통령선거","서울특별시","중랑구",2941,2941,1349,542,658,165,201,8,0,2,3,2,0,0,1,2931,10,0
"15781","면목제4동","면목제4동제1투","대통령선거","서울특별시","중랑구",2499,1635,632,400,407,95,93,1,0,0,1,2,0,0,1,1632,3,864
"15782","면목제4동","면목제4동제2투","대통령선거","서울특별시","중랑구",3136,2179,913,493,528,117,110,0,0,1,2,0,0,2,1,2167,12,957
"15783","면목제4동","면목제4동제3투","대통령선거","서울특별시","중랑구",2770,1982,832,431,468,111,122,2,0,0,0,3,0,0,2,1971,11,788
"15784","면목제4동","면목제4동제4투","대통령선거","서울특별시","중랑구",2851,1752,732,373,422,104,106,7,1,1,0,1,0,0,3,1750,2,1099
"15785","면목제4동","면목제4동제5투","대통령선거","서울특별시","중랑구",2705,1845,662,479,512,97,81,3,0,0,0,1,0,0,1,1836,9,860
"15786","면목제5동","관내사전투표","대통령선거","서울특별시","중랑구",1719,1719,825,291,389,77,119,0,0,2,0,1,2,0,1,1707,12,0
"15787","면목제5동","면목제5동제1투","대통령선거","서울특별시","중랑구",3468,2147,874,413,591,113,140,4,1,1,0,0,0,1,2,2140,7,1321
"15788","면목제5동","면목제5동제2투","대통령선거","서울특별시","중랑구",3378,2138,871,421,573,115,140,1,0,0,0,2,0,0,4,2127,11,1240
"15789","면목제7동","관내사전투표","대통령선거","서울특별시","중랑구",3770,3770,1694,830,791,193,234,5,0,6,3,1,1,1,1,3760,10,0
"15790","면목제7동","면목제7동제1투","대통령선거","서울특별시","중랑구",2844,1677,676,379,413,79,119,3,1,0,0,1,0,0,1,1672,5,1167
"15791","면목제7동","면목제7동제2투","대통령선거","서울특별시","중랑구",3311,2151,836,514,516,125,132,4,0,1,1,6,0,1,5,2141,10,1160
"15792","면목제7동","면목제7동제3투","대통령선거","서울특별시","중랑구",2910,1857,740,430,453,120,94,7,0,1,1,2,1,0,2,1851,6,1053
"15793","면목제7동","면목제7동제4투","대통령선거","서울특별시","중랑구",2967,2108,803,541,506,132,111,2,0,0,1,2,0,1,0,2099,9,859
"15794","면목제7동","면목제7동제5투","대통령선거","서울특별시","중랑구",2323,1564,580,376,410,89,99,6,0,0,0,0,0,0,0,1560,4,759
"15795","상봉제1동","관내사전투표","대통령선거","서울특별시","중랑구",2879,2879,1360,514,579,189,208,7,0,1,2,5,0,0,5,2870,9,0
"15796","상봉제1동","상봉제1동제1투","대통령선거","서울특별시","중랑구",3580,2185,849,508,512,138,156,3,0,2,0,1,0,1,4,2174,11,1395
"15797","상봉제1동","상봉제1동제2투","대통령선거","서울특별시","중랑구",3775,3031,1273,580,716,218,213,6,1,5,0,2,0,0,5,3019,12,744
"15798","상봉제1동","상봉제1동제3투","대통령선거","서울특별시","중랑구",3224,2397,1008,505,576,151,139,3,1,1,0,4,0,0,1,2389,8,827
"15799","상봉제1동","상봉제1동제4투","대통령선거","서울특별시","중랑구",3649,2587,1066,562,624,153,149,8,0,4,1,1,3,3,3,2577,10,1062
"15800","상봉제1동","상봉제1동제5투","대통령선거","서울특별시","중랑구",1488,1152,388,316,305,72,60,5,0,0,0,0,0,0,3,1149,3,336
"15801","상봉제2동","관내사전투표","대통령선거","서울특별시","중랑구",2581,2581,1239,463,545,146,169,3,1,1,0,4,0,0,0,2571,10,0
"15802","상봉제2동","상봉제2동제1투","대통령선거","서울특별시","중랑구",3437,2075,866,464,459,139,129,3,0,1,1,3,0,2,1,2068,7,1362
"15803","상봉제2동","상봉제2동제2투","대통령선거","서울특별시","중랑구",3506,2408,874,619,642,142,118,3,0,1,0,0,0,0,0,2399,9,1098
"15804","상봉제2동","상봉제2동제3투","대통령선거","서울특별시","중랑구",2960,1876,768,439,420,112,125,2,0,1,0,0,1,0,1,1869,7,1084
"15805","상봉제2동","상봉제2동제4투","대통령선거","서울특별시","중랑구",2682,1774,731,356,424,106,142,3,0,0,0,1,2,0,0,1765,9,908
"15806","중화제1동","관내사전투표","대통령선거","서울특별시","중랑구",2775,2775,1325,496,585,149,202,3,0,1,0,1,2,1,3,2768,7,0
"15807","중화제1동","중화제1동제1투","대통령선거","서울특별시","중랑구",3725,2377,917,560,581,146,162,0,0,1,0,0,1,2,0,2370,7,1348
"15808","중화제1동","중화제1동제2투","대통령선거","서울특별시","중랑구",3197,2127,849,408,593,123,137,1,0,0,0,4,0,3,2,2120,7,1070
"15809","중화제1동","중화제1동제3투","대통령선거","서울특별시","중랑구",3590,2487,991,551,628,135,157,7,1,1,1,3,1,1,1,2478,9,1103
"15810","중화제1동","중화제1동제4투","대통령선거","서울특별시","중랑구",3002,2474,1055,494,596,174,144,2,0,0,0,1,0,0,2,2468,6,528
"15811","중화제2동","관내사전투표","대통령선거","서울특별시","중랑구",2912,2912,1327,526,671,173,195,7,1,1,0,0,1,0,0,2902,10,0
"15812","중화제2동","중화제2동제1투","대통령선거","서울특별시","중랑구",2364,1257,460,290,351,64,81,3,0,0,0,0,0,1,1,1251,6,1107
"15813","중화제2동","중화제2동제2투","대통령선거","서울특별시","중랑구",2108,1374,530,341,348,73,75,1,0,2,0,0,0,0,1,1371,3,734
"15814","중화제2동","중화제2동제3투","대통령선거","서울특별시","중랑구",2785,1713,626,433,447,99,93,2,0,0,0,0,1,2,2,1705,8,1072
"15815","중화제2동","중화제2동제4투","대통령선거","서울특별시","중랑구",3792,2504,1004,567,602,150,156,8,2,2,1,3,1,0,1,2497,7,1288
"15816","중화제2동","중화제2동제5투","대통령선거","서울특별시","중랑구",3061,1921,723,456,496,117,115,1,1,0,2,0,1,0,1,1913,8,1140
"15817","중화제2동","중화제2동제6투","대통령선거","서울특별시","중랑구",2725,1734,650,397,490,82,101,4,0,0,1,1,0,0,1,1727,7,991
"15818","중화제2동","중화제2동제7투","대통령선거","서울특별시","중랑구",3015,1810,658,452,490,105,88,2,1,3,1,0,0,1,3,1804,6,1205
"15819","묵제1동","관내사전투표","대통령선거","서울특별시","중랑구",4556,4556,2215,931,869,258,259,6,0,0,0,2,1,0,5,4546,10,0
"15820","묵제1동","묵제1동제1투","대통령선거","서울특별시","중랑구",2503,1864,742,385,476,145,93,3,2,0,0,1,2,3,0,1852,12,639
"15821","묵제1동","묵제1동제2투","대통령선거","서울특별시","중랑구",1906,1339,495,299,368,93,73,0,0,1,0,1,1,2,3,1336,3,567
"15822","묵제1동","묵제1동제3투","대통령선거","서울특별시","중랑구",2769,2300,826,620,518,195,127,1,0,0,0,1,0,0,1,2289,11,469
"15823","묵제1동","묵제1동제4투","대통령선거","서울특별시","중랑구",3684,2851,1257,509,667,200,201,2,0,2,0,2,0,1,2,2843,8,833
"15824","묵제1동","묵제1동제5투","대통령선거","서울특별시","중랑구",4026,2833,1156,628,685,148,191,2,0,5,0,0,0,2,1,2818,15,1193
"15825","묵제1동","묵제1동제6투","대통령선거","서울특별시","중랑구",3196,2337,880,533,610,167,131,2,0,3,1,0,0,0,2,2329,8,859
"15826","묵제1동","묵제1동제7투","대통령선거","서울특별시","중랑구",2904,1792,790,362,400,99,120,4,0,1,0,1,2,1,5,1785,7,1112
"15827","묵제2동","관내사전투표","대통령선거","서울특별시","중랑구",3421,3421,1528,695,780,174,219,1,1,2,1,1,0,1,1,3404,17,0
"15828","묵제2동","묵제2동제1투","대통령선거","서울특별시","중랑구",3346,2238,927,502,569,120,111,0,0,1,1,1,0,2,0,2234,4,1108
"15829","묵제2동","묵제2동제2투","대통령선거","서울특별시","중랑구",2894,1871,776,365,438,124,153,8,0,0,0,0,0,0,0,1864,7,1023
"15830","묵제2동","묵제2동제3투","대통령선거","서울특별시","중랑구",3018,2086,806,480,547,109,134,4,0,1,0,1,0,0,1,2083,3,932
"15831","묵제2동","묵제2동제4투","대통령선거","서울특별시","중랑구",3145,2109,820,502,533,107,129,9,0,0,1,0,1,1,0,2103,6,1036
"15832","망우본동","관내사전투표","대통령선거","서울특별시","중랑구",4495,4495,1971,1096,898,239,262,4,0,2,2,3,2,0,3,4482,13,0
"15833","망우본동","망우본동제1투","대통령선거","서울특별시","중랑구",3344,1887,655,559,456,100,104,3,1,1,0,1,1,0,2,1883,4,1457
"15834","망우본동","망우본동제2투","대통령선거","서울특별시","중랑구",3176,2180,795,572,552,128,122,1,0,1,0,0,0,0,3,2174,6,996
"15835","망우본동","망우본동제3투","대통령선거","서울특별시","중랑구",2630,1874,665,530,429,132,109,3,0,0,1,0,0,1,0,1870,4,756
"15836","망우본동","망우본동제4투","대통령선거","서울특별시","중랑구",2479,1704,559,541,412,94,89,2,0,1,0,0,1,0,1,1700,4,775
"15837","망우본동","망우본동제5투","대통령선거","서울특별시","중랑구",2717,1752,646,491,410,94,93,3,0,0,1,0,1,1,3,1743,9,965
"15838","망우본동","망우본동제6투","대통령선거","서울특별시","중랑구",3825,2463,907,706,566,138,127,7,0,1,0,4,0,0,1,2457,6,1362
"15839","망우본동","망우본동제7투","대통령선거","서울특별시","중랑구",3672,2496,975,599,593,145,165,4,1,1,3,0,0,0,3,2489,7,1176
"15840","망우제3동","관내사전투표","대통령선거","서울특별시","중랑구",2891,2891,1299,572,664,149,189,2,0,3,0,1,1,2,3,2885,6,0
"15841","망우제3동","망우제3동제1투","대통령선거","서울특별시","중랑구",2824,1713,648,430,409,94,121,4,0,0,0,1,1,1,1,1710,3,1111
"15842","망우제3동","망우제3동제2투","대통령선거","서울특별시","중랑구",3188,1995,719,485,516,136,124,1,0,1,0,5,1,0,1,1989,6,1193
"15843","망우제3동","망우제3동제3투","대통령선거","서울특별시","중랑구",3403,2178,819,508,554,117,158,6,0,5,0,2,0,1,1,2171,7,1225
"15844","망우제3동","망우제3동제4투","대통령선거","서울특별시","중랑구",2941,1873,709,477,482,84,107,2,0,1,0,1,1,0,3,1867,6,1068
"15845","신내제1동","관내사전투표","대통령선거","서울특별시","중랑구",3382,3382,1556,681,728,219,187,0,1,0,0,2,0,0,0,3374,8,0
"15846","신내제1동","신내제1동제1투","대통령선거","서울특별시","중랑구",3053,2127,777,540,527,126,144,1,1,0,1,0,1,0,2,2120,7,926
"15847","신내제1동","신내제1동제2투","대통령선거","서울특별시","중랑구",2374,1916,767,446,450,132,109,4,0,1,0,1,1,2,0,1913,3,458
"15848","신내제1동","신내제1동제3투","대통령선거","서울특별시","중랑구",2589,1959,781,420,526,112,114,0,0,1,1,0,1,0,0,1956,3,630
"15849","신내제1동","신내제1동제4투","대통령선거","서울특별시","중랑구",3581,2682,1167,564,616,166,156,3,0,1,0,2,0,0,2,2677,5,899
"15850","신내제1동","신내제1동제5투","대통령선거","서울특별시","중랑구",2876,2231,915,523,538,132,110,1,2,2,0,0,1,1,2,2227,4,645
"15851","신내제1동","신내제1동제6투","대통령선거","서울특별시","중랑구",2149,1382,474,391,332,104,68,0,1,1,0,1,1,1,0,1374,8,767
"15852","신내제1동","신내제1동제7투","대통령선거","서울특별시","중랑구",2640,2061,742,508,528,167,103,6,0,1,1,0,1,0,0,2057,4,579
"15853","신내제1동","신내제1동제8투","대통령선거","서울특별시","중랑구",3569,2751,1224,529,649,176,158,2,0,0,1,2,1,0,1,2743,8,818
"15854","신내제1동","신내제1동제9투","대통령선거","서울특별시","중랑구",2578,2045,898,356,508,147,125,5,0,0,0,1,0,2,0,2042,3,533
"15855","신내제2동","관내사전투표","대통령선거","서울특별시","중랑구",5713,5713,2767,900,1173,442,403,9,0,0,3,1,1,1,2,5702,11,0
"15856","신내제2동","신내제2동제1투","대통령선거","서울특별시","중랑구",2650,1968,806,443,455,125,129,0,0,1,0,1,0,1,1,1962,6,682
"15857","신내제2동","신내제2동제2투","대통령선거","서울특별시","중랑구",2912,2357,1119,423,492,157,159,2,0,1,0,0,0,0,0,2353,4,555
"15858","신내제2동","신내제2동제3투","대통령선거","서울특별시","중랑구",3322,2655,1098,622,534,211,175,5,0,1,0,2,0,1,0,2649,6,667
"15859","신내제2동","신내제2동제4투","대통령선거","서울특별시","중랑구",3082,2298,933,536,580,124,109,2,0,0,2,1,1,1,2,2291,7,784
"15860","신내제2동","신내제2동제5투","대통령선거","서울특별시","중랑구",2942,2113,826,511,539,115,98,2,0,2,1,1,0,3,4,2102,11,829
"15861","잘못 투입·구분된 투표지","잘못 투입·구분된 투표지","대통령선거","서울특별시","중랑구",0,1,0,0,0,0,0,0,0,0,0,0,0,0,0,0,1,-1
"15862","거소·선상투표","거소·선상투표","대통령선거","서울특별시","성북구",494,463,169,71,154,26,23,3,1,1,1,1,0,0,2,452,11,31
"15863","관외사전투표","관외사전투표","대통령선거","서울특별시","성북구",34776,34766,16872,4789,6966,2702,3139,50,5,24,8,27,8,5,30,34625,141,10
"15864","재외투표","재외투표","대통령선거","서울특별시","성북구",4235,3256,1914,254,517,122,419,16,0,1,0,1,1,1,0,3246,10,979
"15865","성북동","관내사전투표","대통령선거","서울특별시","성북구",3180,3180,1558,548,541,220,299,2,0,1,1,2,0,1,3,3176,4,0
"15866","성북동","성북동제1투","대통령선거","서울특별시","성북구",2758,2008,826,408,429,144,193,0,0,0,1,1,0,0,0,2002,6,750
"15867","성북동","성북동제2투","대통령선거","서울특별시","성북구",3006,1805,743,502,328,89,129,4,0,5,1,2,0,0,0,1803,2,1201
"15868","성북동","성북동제3투","대통령선거","서울특별시","성북구",2230,1544,496,498,354,95,90,5,0,1,0,1,0,0,0,1540,4,686
"15869","성북동","성북동제4투","대통령선거","서울특별시","성북구",2475,1783,802,323,358,150,133,3,0,0,1,2,2,1,1,1776,7,692
"15870","삼선동","관내사전투표","대통령선거","서울특별시","성북구",5876,5876,2946,780,1197,421,501,7,0,1,2,3,0,2,4,5864,12,0
"15871","삼선동","삼선동제1투","대통령선거","서울특별시","성북구",3754,2385,945,545,529,163,182,5,0,2,1,1,1,2,1,2377,8,1369
"15872","삼선동","삼선동제2투","대통령선거","서울특별시","성북구",2662,1855,803,403,396,109,130,4,1,1,0,0,0,1,0,1848,7,807
"15873","삼선동","삼선동제3투","대통령선거","서울특별시","성북구",2970,2321,1024,392,577,170,146,1,1,1,0,1,0,2,1,2316,5,649
"15874","삼선동","삼선동제4투","대통령선거","서울특별시","성북구",4095,2888,1204,585,681,174,230,1,0,1,2,2,0,3,2,2885,3,1207
"15875","삼선동","삼선동제5투","대통령선거","서울특별시","성북구",3129,2002,878,379,449,122,160,2,0,4,0,0,0,1,2,1997,5,1127
"15876","동선동","관내사전투표","대통령선거","서울특별시","성북구",2687,2687,1341,398,445,214,273,1,0,0,1,3,0,1,1,2678,9,0
"15877","동선동","동선동제1투","대통령선거","서울특별시","성북구",2153,1355,572,274,280,95,121,1,0,0,0,0,0,1,4,1348,7,798
"15878","동선동","동선동제2투","대통령선거","서울특별시","성북구",2553,1825,853,302,331,150,179,3,0,0,0,2,0,0,1,1821,4,728
"15879","동선동","동선동제3투","대통령선거","서울특별시","성북구",2337,1716,712,373,378,124,113,2,0,2,0,0,0,1,2,1707,9,621
"15880","동선동","동선동제4투","대통령선거","서울특별시","성북구",2884,2116,958,371,423,187,167,1,1,2,0,0,0,2,1,2113,3,768
"15881","돈암제1동","관내사전투표","대통령선거","서울특별시","성북구",2281,2281,1077,400,498,146,148,1,0,2,0,2,0,1,0,2275,6,0
"15882","돈암제1동","돈암제1동제1투","대통령선거","서울특별시","성북구",2391,1742,738,350,412,106,117,4,2,0,0,5,1,1,0,1736,6,649
"15883","돈암제1동","돈암제1동제2투","대통령선거","서울특별시","성북구",2500,1857,646,464,510,110,114,2,0,2,1,1,0,1,0,1851,6,643
"15884","돈암제1동","돈암제1동제3투","대통령선거","서울특별시","성북구",3316,2692,1105,576,609,210,177,2,0,0,1,2,1,1,0,2684,8,624
"15885","돈암제1동","돈암제1동제4투","대통령선거","서울특별시","성북구",2334,1683,710,344,379,126,108,2,0,0,1,2,0,2,2,1676,7,651
"15886","돈암제2동","관내사전투표","대통령선거","서울특별시","성북구",3044,3044,1477,534,572,222,221,0,1,2,1,1,0,2,2,3035,9,0
"15887","돈암제2동","돈암제2동제1투","대통령선거","서울특별시","성북구",3274,2451,1004,506,599,168,161,3,0,1,1,0,0,0,0,2443,8,823
"15888","돈암제2동","돈암제2동제2투","대통령선거","서울특별시","성북구",2504,1955,792,420,424,168,140,3,0,0,1,0,1,1,0,1950,5,549
"15889","돈암제2동","돈암제2동제3투","대통령선거","서울특별시","성북구",2673,2166,1081,320,446,150,161,3,0,0,0,2,0,0,0,2163,3,507
"15890","돈암제2동","돈암제2동제4투","대통령선거","서울특별시","성북구",2871,2276,840,621,470,194,136,3,0,2,0,0,0,0,1,2267,9,595
"15891","돈암제2동","돈암제2동제5투","대통령선거","서울특별시","성북구",2488,1811,688,430,431,157,95,1,0,3,0,1,0,0,0,1806,5,677
"15892","안암동","관내사전투표","대통령선거","서울특별시","성북구",3020,3020,1467,429,544,255,306,2,0,0,0,3,0,0,2,3008,12,0
"15893","안암동","안암동제1투","대통령선거","서울특별시","성북구",2269,1367,540,301,332,92,91,1,0,1,0,1,1,1,1,1362,5,902
"15894","안암동","안암동제2투","대통령선거","서울특별시","성북구",1970,1412,535,245,315,171,135,2,0,0,0,0,0,1,0,1404,8,558
"15895","안암동","안암동제3투","대통령선거","서울특별시","성북구",3016,2129,925,366,466,181,168,6,0,0,2,2,1,1,0,2118,11,887
"15896","안암동","안암동제4투","대통령선거","서울특별시","성북구",2324,1657,654,362,372,128,122,10,1,0,0,0,1,0,3,1653,4,667
"15897","보문동","관내사전투표","대통령선거","서울특별시","성북구",2095,2095,1052,336,425,127,144,0,1,0,0,0,0,1,1,2087,8,0
"15898","보문동","보문동제1투","대통령선거","서울특별시","성북구",3792,2337,970,495,585,129,136,6,1,1,0,1,1,0,4,2329,8,1455
"15899","보문동","보문동제2투","대통령선거","서울특별시","성북구",3118,2204,947,457,459,153,173,3,0,0,0,1,0,0,0,2193,11,914
"15900","보문동","보문동제3투","대통령선거","서울특별시","성북구",3416,2474,1066,435,620,187,152,3,0,3,0,0,0,0,1,2467,7,942
"15901","정릉제1동","관내사전투표","대통령선거","서울특별시","성북구",2780,2780,1358,522,550,167,173,1,0,1,0,1,0,0,0,2773,7,0
"15902","정릉제1동","정릉제1동제1투","대통령선거","서울특별시","성북구",2998,2161,918,434,501,159,136,0,0,2,0,0,0,1,3,2154,7,837
"15903","정릉제1동","정릉제1동제2투","대통령선거","서울특별시","성북구",3117,2171,871,499,516,137,131,7,1,1,2,0,0,2,1,2168,3,946
"15904","정릉제1동","정릉제1동제3투","대통령선거","서울특별시","성북구",2165,1628,642,364,386,116,110,1,0,2,0,0,0,1,1,1623,5,537
"15905","정릉제1동","정릉제1동제4투","대통령선거","서울특별시","성북구",2623,2088,911,405,479,150,126,1,0,2,0,2,0,1,1,2078,10,535
"15906","정릉제2동","관내사전투표","대통령선거","서울특별시","성북구",4109,4109,1771,887,882,260,278,5,0,2,0,2,4,3,3,4097,12,0
"15907","정릉제2동","정릉제2동제1투","대통령선거","서울특별시","성북구",3499,2617,1068,539,658,171,162,2,0,0,1,2,0,6,2,2611,6,882
"15908","정릉제2동","정릉제2동제2투","대통령선거","서울특별시","성북구",3532,2344,929,554,537,147,154,5,1,2,2,2,0,2,1,2336,8,1188
"15909","정릉제2동","정릉제2동제3투","대통령선거","서울특별시","성북구",3459,2220,904,478,550,148,130,3,0,1,0,0,0,0,2,2216,4,1239
"15910","정릉제2동","정릉제2동제4투","대통령선거","서울특별시","성북구",3373,2295,937,519,539,149,137,4,0,2,2,0,0,0,1,2290,5,1078
"15911","정릉제3동","관내사전투표","대통령선거","서울특별시","성북구",2320,2320,985,467,483,179,189,1,0,0,0,5,0,2,1,2312,8,0
"15912","정릉제3동","정릉제3동제1투","대통령선거","서울특별시","성북구",2717,1694,633,375,385,128,158,3,0,1,0,1,0,2,0,1686,8,1023
"15913","정릉제3동","정릉제3동제2투","대통령선거","서울특별시","성북구",1392,852,291,281,206,32,29,2,0,0,0,0,0,0,2,843,9,540
"15914","정릉제3동","정릉제3동제3투","대통령선거","서울특별시","성북구",3338,2200,862,477,583,131,131,3,1,2,1,1,0,1,0,2193,7,1138
"15915","정릉제3동","정릉제3동제4투","대통령선거","서울특별시","성북구",2159,1448,543,381,341,90,82,2,0,1,1,2,0,0,0,1443,5,711
"15916","정릉제4동","관내사전투표","대통령선거","서울특별시","성북구",4266,4266,2044,798,881,241,267,9,1,2,0,7,1,0,6,4257,9,0
"15917","정릉제4동","정릉제4동제1투","대통령선거","서울특별시","성북구",2829,2030,838,452,439,152,132,3,1,2,1,1,0,0,4,2025,5,799
"15918","정릉제4동","정릉제4동제2투","대통령선거","서울특별시","성북구",3829,2463,993,542,587,149,170,3,0,3,0,3,2,1,0,2453,10,1366
"15919","정릉제4동","정릉제4동제3투","대통령선거","서울특별시","성북구",3268,2094,874,404,514,165,126,6,0,1,0,0,0,0,0,2090,4,1174
"15920","정릉제4동","정릉제4동제4투","대통령선거","서울특별시","성북구",2185,1509,567,369,381,103,81,0,0,1,0,0,0,2,1,1505,4,676
"15921","정릉제4동","정릉제4동제5투","대통령선거","서울특별시","성북구",3929,3081,1329,603,768,184,182,2,0,2,0,2,0,1,1,3074,7,848
"15922","길음제1동","관내사전투표","대통령선거","서울특별시","성북구",4998,4998,2663,688,969,311,344,8,0,3,0,1,1,1,1,4990,8,0
"15923","길음제1동","길음제1동제1투","대통령선거","서울특별시","성북구",2960,2439,1125,414,542,196,150,2,0,0,0,1,2,0,2,2434,5,521
"15924","길음제1동","길음제1동제2투","대통령선거","서울특별시","성북구",3345,2659,1284,462,566,193,136,8,0,0,0,2,1,1,0,2653,6,686
"15925","길음제1동","길음제1동제3투","대통령선거","서울특별시","성북구",3531,2424,1129,394,574,190,125,0,0,0,0,2,3,0,1,2418,6,1107
"15926","길음제1동","길음제1동제4투","대통령선거","서울특별시","성북구",3355,2502,1003,544,608,180,149,2,0,2,0,1,0,3,3,2495,7,853
"15927","길음제1동","길음제1동제5투","대통령선거","서울특별시","성북구",2890,2386,1081,394,551,194,157,2,0,0,0,1,0,1,0,2381,5,504
"15928","길음제1동","길음제1동제6투","대통령선거","서울특별시","성북구",2035,1711,753,260,418,147,122,4,0,2,0,0,0,0,1,1707,4,324
"15929","길음제1동","길음제1동제7투","대통령선거","서울특별시","성북구",2257,1830,822,318,425,156,93,5,0,0,0,0,0,2,2,1823,7,427
"15930","길음제2동","관내사전투표","대통령선거","서울특별시","성북구",1384,1384,597,280,324,75,100,2,1,0,1,0,0,0,0,1380,4,0
"15931","길음제2동","길음제2동제1투","대통령선거","서울특별시","성북구",1406,629,236,178,152,27,29,0,0,2,0,1,0,0,0,625,4,777
"15932","길음제2동","길음제2동제2투","대통령선거","서울특별시","성북구",3006,1971,804,425,503,132,95,2,0,2,1,1,1,1,2,1969,2,1035
"15933","길음제2동","길음제2동제3투","대통령선거","서울특별시","성북구",3482,2673,1107,534,668,171,164,9,0,6,2,3,0,2,1,2667,6,809
"15934","종암동","관내사전투표","대통령선거","서울특별시","성북구",5761,5761,2865,900,1166,354,432,11,0,3,3,2,0,2,3,5741,20,0
"15935","종암동","종암동제1투","대통령선거","서울특별시","성북구",3377,2623,1165,485,597,183,170,6,0,0,0,1,0,5,1,2613,10,754
"15936","종암동","종암동제2투","대통령선거","서울특별시","성북구",3411,2548,1055,543,608,185,148,3,0,0,0,0,0,0,1,2543,5,863
"15937","종암동","종암동제3투","대통령선거","서울특별시","성북구",3262,2466,990,575,614,145,129,0,1,0,1,1,2,2,2,2462,4,796
"15938","종암동","종암동제4투","대통령선거","서울특별시","성북구",3224,2413,948,559,523,196,176,2,0,0,1,0,1,0,1,2407,6,811
"15939","종암동","종암동제5투","대통령선거","서울특별시","성북구",2661,1463,555,364,355,86,94,0,0,2,1,1,2,0,0,1460,3,1198
"15940","종암동","종암동제6투","대통령선거","서울특별시","성북구",3254,2619,1116,525,627,186,147,5,0,4,0,1,0,0,4,2615,4,635
"15941","종암동","종암동제7투","대통령선거","서울특별시","성북구",3245,2103,869,435,506,129,148,1,1,1,0,2,0,0,3,2095,8,1142
"15942","종암동","종암동제8투","대통령선거","서울특별시","성북구",2685,2038,899,374,482,137,131,4,0,1,0,2,0,1,2,2033,5,647
"15943","월곡제1동","관내사전투표","대통령선거","서울특별시","성북구",3662,3662,1862,512,789,227,247,7,1,2,0,4,0,2,1,3654,8,0
"15944","월곡제1동","월곡제1동제1투","대통령선거","서울특별시","성북구",3135,2098,952,330,522,155,130,1,0,0,0,2,0,0,2,2094,4,1037
"15945","월곡제1동","월곡제1동제2투","대통령선거","서울특별시","성북구",2421,1551,627,321,446,63,78,3,1,2,1,0,2,2,0,1546,5,870
"15946","월곡제1동","월곡제1동제3투","대통령선거","서울특별시","성북구",2829,1959,800,421,508,106,108,0,0,6,0,3,1,0,3,1956,3,870
"15947","월곡제1동","월곡제1동제4투","대통령선거","서울특별시","성북구",2582,2025,838,442,493,122,114,1,0,3,0,2,1,1,1,2018,7,557
"15948","월곡제1동","월곡제1동제5투","대통령선거","서울특별시","성북구",2940,2226,971,428,537,148,121,4,0,1,1,2,1,0,1,2215,11,714
"15949","월곡제1동","월곡제1동제6투","대통령선거","서울특별시","성북구",3396,2705,1323,427,622,171,148,3,0,1,0,2,0,0,1,2698,7,691
"15950","월곡제2동","관내사전투표","대통령선거","서울특별시","성북구",2921,2921,1404,510,588,174,229,6,0,0,0,1,1,0,1,2914,7,0
"15951","월곡제2동","월곡제2동제1투","대통령선거","서울특별시","성북구",3324,2128,875,483,492,132,131,2,0,4,0,0,2,0,3,2124,4,1196
"15952","월곡제2동","월곡제2동제2투","대통령선거","서울특별시","성북구",3032,2265,909,510,528,164,146,2,0,1,0,1,0,0,0,2261,4,767
"15953","월곡제2동","월곡제2동제3투","대통령선거","서울특별시","성북구",3162,2216,928,462,510,135,158,4,0,1,1,6,1,0,0,2206,10,946
"15954","월곡제2동","월곡제2동제4투","대통령선거","서울특별시","성북구",3530,2710,1105,610,607,209,161,7,0,0,0,0,0,0,0,2699,11,820
"15955","장위제1동","관내사전투표","대통령선거","서울특별시","성북구",2944,2944,1333,585,661,149,193,6,3,4,0,0,0,0,2,2936,8,0
"15956","장위제1동","장위제1동제1투","대통령선거","서울특별시","성북구",3404,2077,811,417,569,128,139,4,0,2,0,0,0,0,1,2071,6,1327
"15957","장위제1동","장위제1동제2투","대통령선거","서울특별시","성북구",988,618,220,159,159,34,39,4,1,0,0,0,0,0,0,616,2,370
"15958","장위제1동","장위제1동제3투","대통령선거","서울특별시","성북구",2745,1807,694,410,489,88,107,4,1,3,1,0,0,2,1,1800,7,938
"15959","장위제1동","장위제1동제4투","대통령선거","서울특별시","성북구",2202,1360,537,322,355,65,67,3,0,4,0,0,1,0,2,1356,4,842
"15960","장위제1동","장위제1동제5투","대통령선거","서울특별시","성북구",2057,1315,505,283,381,65,70,1,1,1,0,0,1,1,2,1311,4,742
"15961","장위제1동","장위제1동제6투","대통령선거","서울특별시","성북구",2568,1538,614,314,426,89,86,1,0,2,0,1,0,0,2,1535,3,1030
"15962","장위제2동","관내사전투표","대통령선거","서울특별시","성북구",2280,2280,986,552,508,116,104,1,0,0,0,2,0,2,1,2272,8,0
"15963","장위제2동","장위제2동제1투","대통령선거","서울특별시","성북구",2749,1861,664,495,487,93,102,1,1,6,0,0,1,2,2,1854,7,888
"15964","장위제2동","장위제2동제2투","대통령선거","서울특별시","성북구",2570,1485,520,469,360,56,65,2,0,3,0,1,0,1,1,1478,7,1085
"15965","장위제2동","장위제2동제3투","대통령선거","서울특별시","성북구",2402,1655,609,390,462,80,93,4,0,2,0,1,2,0,3,1646,9,747
"15966","장위제2동","장위제2동제4투","대통령선거","서울특별시","성북구",2903,1881,656,509,503,91,106,1,0,3,0,1,0,0,2,1872,9,1022
"15967","장위제2동","장위제2동제5투","대통령선거","서울특별시","성북구",2851,1849,742,461,430,96,96,4,0,1,0,4,0,0,3,1837,12,1002
"15968","장위제3동","관내사전투표","대통령선거","서울특별시","성북구",1214,1214,524,262,284,54,80,0,0,0,0,1,1,2,0,1208,6,0
"15969","장위제3동","장위제3동제1투","대통령선거","서울특별시","성북구",2485,1446,486,436,378,59,77,2,0,0,0,0,2,0,2,1442,4,1039
"15970","장위제3동","장위제3동제2투","대통령선거","서울특별시","성북구",2705,1753,646,461,472,72,87,0,0,2,1,2,0,2,1,1746,7,952
"15971","장위제3동","장위제3동제3투","대통령선거","서울특별시","성북구",3132,2420,992,510,606,176,119,7,1,0,1,1,0,1,0,2414,6,712
"15972","석관동","관내사전투표","대통령선거","서울특별시","성북구",3762,3762,1707,771,794,212,257,2,0,0,0,2,2,0,1,3748,14,0
"15973","석관동","석관동제1투","대통령선거","서울특별시","성북구",3584,2185,881,521,525,116,125,1,0,2,0,1,0,0,2,2174,11,1399
"15974","석관동","석관동제2투","대통령선거","서울특별시","성북구",2969,1995,772,482,498,104,121,2,0,3,1,0,1,1,0,1985,10,974
"15975","석관동","석관동제3투","대통령선거","서울특별시","성북구",3757,2346,886,621,589,100,128,1,1,4,0,1,1,1,1,2334,12,1411
"15976","석관동","석관동제4투","대통령선거","서울특별시","성북구",1422,1040,392,250,266,75,50,1,0,1,0,0,0,2,1,1038,2,382
"15977","석관동","석관동제5투","대통령선거","서울특별시","성북구",3710,2916,1193,690,677,224,119,2,0,0,0,2,1,1,0,2909,7,794
"15978","석관동","석관동제6투","대통령선거","서울특별시","성북구",2403,1624,608,410,405,86,100,2,0,1,0,1,2,0,1,1616,8,779
"15979","석관동","석관동제7투","대통령선거","서울특별시","성북구",3243,2321,938,481,567,136,181,3,0,0,1,1,2,1,0,2311,10,922
"15980","석관동","석관동제8투","대통령선거","서울특별시","성북구",1675,1214,489,280,280,72,82,1,0,3,0,0,0,0,2,1209,5,461
"15981","잘못 투입·구분된 투표지","잘못 투입·구분된 투표지","대통령선거","서울특별시","성북구",0,0,0,0,0,0,0,0,0,0,0,0,0,0,0,0,0,0
"15982","거소·선상투표","거소·선상투표","대통령선거","서울특별시","강북구",429,405,148,63,137,27,9,1,3,1,0,1,0,0,2,392,13,24
"15983","관외사전투표","관외사전투표","대통령선거","서울특별시","강북구",22519,22516,10780,3302,4950,1448,1826,31,5,7,2,11,7,10,26,22405,111,3
"15984","재외투표","재외투표","대통령선거","서울특별시","강북구",2193,1626,1005,125,248,50,183,10,0,1,0,0,0,1,1,1624,2,567
"15985","삼양동","관내사전투표","대통령선거","서울특별시","강북구",2413,2413,1121,442,572,115,155,2,0,1,0,1,0,1,0,2410,3,0
"15986","삼양동","삼양동제1투","대통령선거","서울특별시","강북구",2915,1584,621,330,441,94,85,2,0,2,0,1,2,0,2,1580,4,1331
"15987","삼양동","삼양동제2투","대통령선거","서울특별시","강북구",2323,1510,618,333,398,79,74,0,0,2,0,0,0,1,1,1506,4,813
"15988","삼양동","삼양동제3투","대통령선거","서울특별시","강북구",2485,1564,696,282,393,80,104,2,0,4,0,1,0,1,0,1563,1,921
"15989","삼양동","삼양동제4투","대통령선거","서울특별시","강북구",2867,1926,768,399,488,111,145,6,0,2,0,0,0,0,1,1920,6,941
"15990","삼양동","삼양동제5투","대통령선거","서울특별시","강북구",2981,2104,903,400,512,128,149,1,0,2,0,0,0,3,1,2099,5,877
"15991","삼양동","삼양동제6투","대통령선거","서울특별시","강북구",2121,1337,573,246,359,68,76,2,0,1,1,2,0,0,1,1329,8,784
"15992","삼양동","삼양동제7투","대통령선거","서울특별시","강북구",1399,892,333,218,235,51,48,1,2,0,0,0,0,1,0,889,3,507
"15993","삼양동","삼양동제8투","대통령선거","서울특별시","강북구",2381,1832,797,327,454,124,121,2,0,0,0,2,0,1,1,1829,3,549
"15994","미아동","관내사전투표","대통령선거","서울특별시","강북구",3972,3972,1942,609,806,247,338,4,0,1,0,2,1,2,1,3953,19,0
"15995","미아동","미아동제1투","대통령선거","서울특별시","강북구",2990,1896,805,352,500,116,114,3,1,0,0,1,0,0,1,1893,3,1094
"15996","미아동","미아동제2투","대통령선거","서울특별시","강북구",1614,1121,461,241,302,53,56,1,0,1,1,0,1,1,1,1119,2,493
"15997","미아동","미아동제3투","대통령선거","서울특별시","강북구",3477,2352,952,488,612,132,150,6,0,4,0,0,1,1,0,2346,6,1125
"15998","미아동","미아동제4투","대통령선거","서울특별시","강북구",2609,1744,715,377,464,76,106,2,0,1,0,1,0,1,0,1743,1,865
"15999","미아동","미아동제5투","대통령선거","서울특별시","강북구",2418,1670,699,371,411,85,86,5,1,1,0,1,3,1,1,1665,5,748
"16000","미아동","미아동제6투","대통령선거","서울특별시","강북구",2590,1728,715,333,476,105,87,2,0,1,0,3,0,0,0,1722,6,862
"16001","송중동","관내사전투표","대통령선거","서울특별시","강북구",2889,2889,1423,464,630,157,193,2,1,1,0,3,1,3,1,2879,10,0
"16002","송중동","송중동제1투","대통령선거","서울특별시","강북구",2310,1305,558,241,327,79,89,0,0,2,0,0,0,0,2,1298,7,1005
"16003","송중동","송중동제2투","대통령선거","서울특별시","강북구",2367,1533,623,322,395,94,84,1,0,2,0,3,0,1,1,1526,7,834
"16004","송중동","송중동제3투","대통령선거","서울특별시","강북구",2737,1880,754,436,455,113,106,4,2,3,0,1,1,0,0,1875,5,857
"16005","송중동","송중동제4투","대통령선거","서울특별시","강북구",3023,2103,852,471,542,115,107,6,0,1,1,0,1,1,0,2097,6,920
"16006","송중동","송중동제5투","대통령선거","서울특별시","강북구",1375,971,448,186,221,44,64,0,0,4,0,0,0,1,0,968,3,404
"16007","송중동","송중동제6투","대통령선거","서울특별시","강북구",2133,1401,538,307,421,65,63,0,1,1,0,0,0,0,1,1397,4,732
"16008","송중동","송중동제7투","대통령선거","서울특별시","강북구",2925,2075,836,447,553,113,109,2,1,5,0,0,0,0,2,2068,7,850
"16009","송중동","송중동제8투","대통령선거","서울특별시","강북구",2711,1757,751,363,417,108,105,1,0,1,0,2,0,1,2,1751,6,954
"16010","송천동","관내사전투표","대통령선거","서울특별시","강북구",3484,3484,1667,638,784,163,199,8,0,3,1,3,1,0,4,3471,13,0
"16011","송천동","송천동제1투","대통령선거","서울특별시","강북구",3054,1678,639,374,482,82,84,1,0,1,2,2,0,0,3,1670,8,1376
"16012","송천동","송천동제2투","대통령선거","서울특별시","강북구",2321,1538,627,305,431,77,83,4,0,4,0,0,0,0,0,1531,7,783
"16013","송천동","송천동제3투","대통령선거","서울특별시","강북구",2419,1685,666,382,457,96,77,2,0,1,1,0,0,0,1,1683,2,734
"16014","송천동","송천동제4투","대통령선거","서울특별시","강북구",2419,1807,725,367,480,106,116,3,0,1,0,1,1,0,1,1801,6,612
"16015","송천동","송천동제5투","대통령선거","서울특별시","강북구",2756,1894,745,424,505,83,122,4,0,2,0,3,0,1,2,1891,3,862
"16016","송천동","송천동제6투","대통령선거","서울특별시","강북구",2358,1578,626,324,445,79,84,2,1,1,2,3,1,3,1,1572,6,780
"16017","송천동","송천동제7투","대통령선거","서울특별시","강북구",2670,1861,800,344,504,85,117,1,0,1,1,0,0,0,2,1855,6,809
"16018","송천동","송천동제8투","대통령선거","서울특별시","강북구",2652,1748,711,382,451,90,100,1,0,1,0,0,0,1,1,1738,10,904
"16019","삼각산동","관내사전투표","대통령선거","서울특별시","강북구",4109,4109,2194,493,868,243,293,6,0,0,0,0,2,0,2,4101,8,0
"16020","삼각산동","삼각산동제1투","대통령선거","서울특별시","강북구",2449,1836,779,350,491,112,95,0,0,1,0,4,1,1,1,1835,1,613
"16021","삼각산동","삼각산동제2투","대통령선거","서울특별시","강북구",2305,1443,583,344,383,53,70,1,0,1,0,0,0,1,3,1439,4,862
"16022","삼각산동","삼각산동제3투","대통령선거","서울특별시","강북구",2755,2269,1110,340,531,136,143,4,1,0,0,0,1,0,0,2266,3,486
"16023","삼각산동","삼각산동제4투","대통령선거","서울특별시","강북구",2093,1753,776,340,418,105,104,2,0,1,2,0,0,0,0,1748,5,340
"16024","삼각산동","삼각산동제5투","대통령선거","서울특별시","강북구",2789,2346,1142,376,537,143,135,1,0,2,2,1,1,1,0,2341,5,443
"16025","삼각산동","삼각산동제6투","대통령선거","서울특별시","강북구",2658,1831,795,350,454,125,102,1,1,0,0,0,0,1,0,1829,2,827
"16026","삼각산동","삼각산동제7투","대통령선거","서울특별시","강북구",2078,1670,729,256,398,143,137,0,0,1,0,1,0,2,1,1668,2,408
"16027","삼각산동","삼각산동제8투","대통령선거","서울특별시","강북구",2315,1828,861,251,468,144,98,2,0,0,0,1,0,1,0,1826,2,487
"16028","번제1동","관내사전투표","대통령선거","서울특별시","강북구",2520,2520,1160,442,585,127,186,4,0,4,0,0,1,1,1,2511,9,0
"16029","번제1동","번제1동제1투","대통령선거","서울특별시","강북구",2974,1667,654,352,431,106,106,2,1,1,1,3,0,1,0,1658,9,1307
"16030","번제1동","번제1동제2투","대통령선거","서울특별시","강북구",2524,1664,668,330,463,102,91,4,1,1,0,1,0,1,0,1662,2,860
"16031","번제1동","번제1동제3투","대통령선거","서울특별시","강북구",2999,1876,717,446,480,106,112,3,0,2,0,2,1,0,2,1871,5,1123
"16032","번제1동","번제1동제4투","대통령선거","서울특별시","강북구",2699,1760,679,441,440,84,101,3,0,2,0,0,0,1,1,1752,8,939
"16033","번제1동","번제1동제5투","대통령선거","서울특별시","강북구",2182,1397,517,330,374,78,80,7,1,2,0,1,1,1,0,1392,5,785
"16034","번제2동","관내사전투표","대통령선거","서울특별시","강북구",2484,2484,1139,479,568,114,162,3,0,3,2,1,0,3,0,2474,10,0
"16035","번제2동","번제2동제1투","대통령선거","서울특별시","강북구",2731,1967,847,416,463,131,99,2,0,0,0,0,2,2,0,1962,5,764
"16036","번제2동","번제2동제2투","대통령선거","서울특별시","강북구",2022,1280,482,304,348,61,63,1,2,1,1,0,2,2,1,1268,12,742
"16037","번제2동","번제2동제3투","대통령선거","서울특별시","강북구",2569,1716,672,367,476,83,101,7,0,1,0,0,2,1,1,1711,5,853
"16038","번제2동","번제2동제4투","대통령선거","서울특별시","강북구",2397,1600,682,298,423,66,116,3,0,3,0,1,0,2,1,1595,5,797
"16039","번제2동","번제2동제5투","대통령선거","서울특별시","강북구",2338,1577,643,298,435,95,89,3,0,0,1,3,1,2,3,1573,4,761
"16040","번제3동","관내사전투표","대통령선거","서울특별시","강북구",2684,2684,1211,534,635,142,140,4,1,0,1,3,2,0,1,2674,10,0
"16041","번제3동","번제3동제1투","대통령선거","서울특별시","강북구",2093,1255,474,329,317,58,61,2,0,4,1,2,0,1,0,1249,6,838
"16042","번제3동","번제3동제2투","대통령선거","서울특별시","강북구",2611,1959,819,384,500,122,121,1,0,4,0,1,2,1,1,1956,3,652
"16043","번제3동","번제3동제3투","대통령선거","서울특별시","강북구",2062,1337,574,277,317,70,85,3,1,1,0,0,0,0,5,1333,4,725
"16044","번제3동","번제3동제4투","대통령선거","서울특별시","강북구",2864,2064,816,480,564,92,93,1,1,1,0,1,1,1,3,2054,10,800
"16045","번제3동","번제3동제5투","대통령선거","서울특별시","강북구",2932,2127,876,454,560,107,114,4,0,1,0,0,1,0,5,2122,5,805
"16046","수유제1동","관내사전투표","대통령선거","서울특별시","강북구",3021,3021,1373,555,689,165,217,5,0,0,2,3,0,1,1,3011,10,0
"16047","수유제1동","수유제1동제1투","대통령선거","서울특별시","강북구",2920,1682,664,355,439,106,98,3,1,3,3,0,1,0,2,1675,7,1238
"16048","수유제1동","수유제1동제2투","대통령선거","서울특별시","강북구",2787,1902,752,400,514,106,115,4,0,2,0,1,1,0,1,1896,6,885
"16049","수유제1동","수유제1동제3투","대통령선거","서울특별시","강북구",2719,1767,685,382,465,103,122,2,0,0,0,3,0,0,0,1762,5,952
"16050","수유제1동","수유제1동제4투","대통령선거","서울특별시","강북구",2758,1860,748,400,489,93,114,3,0,0,0,1,1,0,2,1851,9,898
"16051","수유제1동","수유제1동제5투","대통령선거","서울특별시","강북구",3651,2327,945,526,573,133,131,4,1,2,0,0,0,0,1,2316,11,1324
"16052","수유제2동","관내사전투표","대통령선거","서울특별시","강북구",3743,3743,1663,722,856,226,244,14,0,1,2,1,0,0,2,3731,12,0
"16053","수유제2동","수유제2동제1투","대통령선거","서울특별시","강북구",2961,2007,733,532,521,118,89,4,0,1,0,0,0,0,3,2001,6,954
"16054","수유제2동","수유제2동제2투","대통령선거","서울특별시","강북구",3183,2074,774,491,564,123,106,3,1,2,1,1,0,1,0,2067,7,1109
"16055","수유제2동","수유제2동제3투","대통령선거","서울특별시","강북구",2483,1906,637,571,475,138,75,4,0,1,1,0,1,0,1,1904,2,577
"16056","수유제2동","수유제2동제4투","대통령선거","서울특별시","강북구",2539,1686,633,392,431,89,124,5,0,1,0,0,0,2,4,1681,5,853
"16057","수유제2동","수유제2동제5투","대통령선거","서울특별시","강북구",2894,1972,687,514,544,112,97,2,0,0,1,1,0,3,3,1964,8,922
"16058","수유제3동","관내사전투표","대통령선거","서울특별시","강북구",4462,4462,2149,710,907,263,398,5,0,1,1,4,0,1,3,4442,20,0
"16059","수유제3동","수유제3동제1투","대통령선거","서울특별시","강북구",1881,1179,460,263,298,69,82,2,0,0,2,0,0,0,0,1176,3,702
"16060","수유제3동","수유제3동제2투","대통령선거","서울특별시","강북구",2745,1830,743,407,441,94,123,7,0,2,1,1,0,1,4,1824,6,915
"16061","수유제3동","수유제3동제3투","대통령선거","서울특별시","강북구",2631,1602,588,401,420,94,89,2,0,2,0,2,0,0,1,1599,3,1029
"16062","수유제3동","수유제3동제4투","대통령선거","서울특별시","강북구",2837,2011,793,452,490,117,144,2,0,1,1,3,0,1,1,2005,6,826
"16063","수유제3동","수유제3동제5투","대통령선거","서울특별시","강북구",3328,1940,775,447,489,102,107,1,0,1,1,3,0,1,4,1931,9,1388
"16064","수유제3동","수유제3동제6투","대통령선거","서울특별시","강북구",3055,2123,838,472,514,113,157,6,1,2,0,2,0,3,4,2112,11,932
"16065","우이동","관내사전투표","대통령선거","서울특별시","강북구",2748,2748,1201,605,574,155,190,5,0,0,0,7,0,1,0,2738,10,0
"16066","우이동","우이동제1투","대통령선거","서울특별시","강북구",3513,2094,733,583,514,122,128,4,2,2,1,0,0,0,1,2090,4,1419
"16067","우이동","우이동제2투","대통령선거","서울특별시","강북구",4290,2813,1082,661,688,156,209,0,0,5,0,2,1,2,0,2806,7,1477
"16068","우이동","우이동제3투","대통령선거","서울특별시","강북구",3372,2298,848,588,588,125,135,3,0,2,1,0,2,1,0,2293,5,1074
"16069","우이동","우이동제4투","대통령선거","서울특별시","강북구",3113,2210,774,604,557,119,133,5,0,0,0,0,1,3,4,2200,10,903
"16070","인수동","관내사전투표","대통령선거","서울특별시","강북구",4109,4109,1890,816,933,191,249,7,0,4,1,2,0,4,0,4097,12,0
"16071","인수동","인수동제1투","대통령선거","서울특별시","강북구",2412,1395,483,375,362,79,92,1,0,0,0,0,0,0,1,1393,2,1017
"16072","인수동","인수동제2투","대통령선거","서울특별시","강북구",2112,1445,527,378,363,80,87,0,0,1,1,0,1,2,2,1442,3,667
"16073","인수동","인수동제3투","대통령선거","서울특별시","강북구",2584,1768,704,390,467,101,91,6,0,0,0,3,0,0,2,1764,4,816
"16074","인수동","인수동제4투","대통령선거","서울특별시","강북구",2206,1512,513,399,385,87,115,0,0,3,0,4,1,0,1,1508,4,694
"16075","인수동","인수동제5투","대통령선거","서울특별시","강북구",2430,1482,609,368,337,63,95,3,0,1,0,1,0,0,2,1479,3,948
"16076","인수동","인수동제6투","대통령선거","서울특별시","강북구",2883,1884,741,439,472,83,128,3,0,1,0,2,1,1,2,1873,11,999
"16077","인수동","인수동제7투","대통령선거","서울특별시","강북구",3216,2155,806,475,584,129,142,7,0,0,0,2,0,1,0,2146,9,1061
"16078","인수동","인수동제8투","대통령선거","서울특별시","강북구",3313,2209,854,519,541,131,145,3,0,0,2,0,0,0,2,2197,12,1104
"16079","잘못 투입·구분된 투표지","잘못 투입·구분된 투표지","대통령선거","서울특별시","강북구",0,0,0,0,0,0,0,0,0,0,0,0,0,0,0,0,0,0
"16080","거소·선상투표","거소·선상투표","대통령선거","서울특별시","도봉구",445,418,151,92,123,26,14,2,0,1,0,0,0,1,0,410,8,27
"16081","관외사전투표","관외사전투표","대통령선거","서울특별시","도봉구",24222,24214,11268,3516,5478,1710,1964,34,5,13,4,19,9,8,35,24063,151,8
"16082","재외투표","재외투표","대통령선거","서울특별시","도봉구",2381,1798,1087,143,221,76,250,13,0,0,0,1,1,0,1,1793,5,583
"16083","쌍문1동","관내사전투표","대통령선거","서울특별시","도봉구",2869,2869,1359,545,546,177,216,9,1,0,0,1,0,2,3,2859,10,0
"16084","쌍문1동","쌍문1동제1투","대통령선거","서울특별시","도봉구",3167,2008,769,421,528,143,127,6,0,2,1,3,0,2,0,2002,6,1159
"16085","쌍문1동","쌍문1동제2투","대통령선거","서울특별시","도봉구",2773,1840,776,412,426,115,99,2,0,0,0,1,0,1,0,1832,8,933
"16086","쌍문1동","쌍문1동제3투","대통령선거","서울특별시","도봉구",2502,1824,714,402,474,104,118,1,0,1,1,3,0,0,1,1819,5,678
"16087","쌍문1동","쌍문1동제4투","대통령선거","서울특별시","도봉구",2753,1931,773,471,456,125,94,4,0,3,1,1,0,1,1,1930,1,822
"16088","쌍문1동","쌍문1동제5투","대통령선거","서울특별시","도봉구",2848,1994,757,511,469,108,128,3,0,4,0,2,0,2,2,1986,8,854
"16089","쌍문2동","관내사전투표","대통령선거","서울특별시","도봉구",3487,3486,1614,663,735,209,244,3,1,2,0,2,1,1,1,3476,10,1
"16090","쌍문2동","쌍문2동제1투","대통령선거","서울특별시","도봉구",3315,2112,833,444,536,131,152,0,0,2,0,0,1,1,2,2102,10,1203
"16091","쌍문2동","쌍문2동제2투","대통령선거","서울특별시","도봉구",2682,1699,619,392,478,109,85,3,0,0,1,2,0,1,2,1692,7,983
"16092","쌍문2동","쌍문2동제3투","대통령선거","서울특별시","도봉구",2138,1533,613,321,406,91,90,3,0,1,0,4,0,0,1,1530,3,605
"16093","쌍문2동","쌍문2동제4투","대통령선거","서울특별시","도봉구",2606,2055,805,461,498,133,137,3,0,4,1,0,1,1,2,2046,9,551
"16094","쌍문2동","쌍문2동제5투","대통령선거","서울특별시","도봉구",2569,1711,674,393,417,109,104,1,1,5,0,3,0,1,0,1708,3,858
"16095","쌍문3동","관내사전투표","대통령선거","서울특별시","도봉구",2332,2332,1026,456,550,100,175,7,0,1,0,2,0,0,2,2319,13,0
"16096","쌍문3동","쌍문3동제1투","대통령선거","서울특별시","도봉구",3505,2396,921,503,652,134,167,4,0,2,0,3,0,1,0,2387,9,1109
"16097","쌍문3동","쌍문3동제2투","대통령선거","서울특별시","도봉구",3029,2059,819,413,538,126,141,2,0,5,1,1,1,1,2,2050,9,970
"16098","쌍문3동","쌍문3동제3투","대통령선거","서울특별시","도봉구",2594,1746,671,394,452,89,122,2,1,2,0,0,0,1,2,1736,10,848
"16099","쌍문3동","쌍문3동제4투","대통령선거","서울특별시","도봉구",2477,1800,692,416,458,119,98,2,0,1,1,3,0,0,1,1791,9,677
"16100","쌍문4동","관내사전투표","대통령선거","서울특별시","도봉구",2662,2662,1244,479,558,177,192,3,1,0,1,0,0,1,0,2656,6,0
"16101","쌍문4동","쌍문4동제1투","대통령선거","서울특별시","도봉구",2921,2079,812,442,476,173,160,2,0,1,0,2,1,0,1,2070,9,842
"16102","쌍문4동","쌍문4동제2투","대통령선거","서울특별시","도봉구",3116,2373,892,534,610,184,142,3,0,1,1,0,0,1,1,2369,4,743
"16103","쌍문4동","쌍문4동제3투","대통령선거","서울특별시","도봉구",2777,2172,848,501,520,146,141,8,0,0,0,2,0,2,0,2168,4,605
"16104","쌍문4동","쌍문4동제4투","대통령선거","서울특별시","도봉구",3181,2344,928,510,559,175,158,3,0,1,2,4,0,0,1,2341,3,837
"16105","방학1동","관내사전투표","대통령선거","서울특별시","도봉구",3610,3610,1579,728,852,206,223,4,0,1,0,2,0,1,3,3599,11,0
"16106","방학1동","방학1동제1투","대통령선거","서울특별시","도봉구",2986,1731,606,383,534,90,104,4,2,0,0,2,0,0,1,1726,5,1255
"16107","방학1동","방학1동제2투","대통령선거","서울특별시","도봉구",2754,1836,672,444,512,110,83,3,0,3,0,2,1,0,0,1830,6,918
"16108","방학1동","방학1동제3투","대통령선거","서울특별시","도봉구",3147,2046,760,513,539,96,124,2,1,1,0,1,0,0,1,2038,8,1101
"16109","방학1동","방학1동제4투","대통령선거","서울특별시","도봉구",3318,2283,872,541,588,127,139,0,0,1,2,2,1,2,1,2276,7,1035
"16110","방학1동","방학1동제5투","대통령선거","서울특별시","도봉구",2849,1993,805,365,559,135,115,4,0,1,0,0,0,2,1,1987,6,856
"16111","방학1동","방학1동제6투","대통령선거","서울특별시","도봉구",2308,1714,572,462,464,127,76,5,0,0,1,0,0,0,0,1707,7,594
"16112","방학1동","방학1동제7투","대통령선거","서울특별시","도봉구",2425,1952,742,453,506,148,98,2,0,0,0,0,0,0,2,1951,1,473
"16113","방학2동","관내사전투표","대통령선거","서울특별시","도봉구",2768,2768,1206,544,693,139,163,6,0,3,1,0,0,1,1,2757,11,0
"16114","방학2동","방학2동제1투","대통령선거","서울특별시","도봉구",2773,1612,602,396,409,80,106,6,1,0,0,2,1,0,2,1605,7,1161
"16115","방학2동","방학2동제2투","대통령선거","서울특별시","도봉구",2005,1317,502,313,342,70,73,1,0,1,0,2,0,2,3,1309,8,688
"16116","방학2동","방학2동제3투","대통령선거","서울특별시","도봉구",2486,1586,593,387,404,81,103,4,0,5,0,3,0,0,1,1581,5,900
"16117","방학2동","방학2동제4투","대통령선거","서울특별시","도봉구",2528,1681,648,398,426,96,96,2,0,4,0,0,0,0,3,1673,8,847
"16118","방학2동","방학2동제5투","대통령선거","서울특별시","도봉구",2294,1378,534,325,368,67,67,6,0,2,1,0,0,1,0,1371,7,916
"16119","방학2동","방학2동제6투","대통령선거","서울특별시","도봉구",2587,1656,636,374,488,69,75,3,0,3,0,0,0,0,0,1648,8,931
"16120","방학3동","관내사전투표","대통령선거","서울특별시","도봉구",5207,5207,2372,961,1148,362,328,5,0,5,3,2,1,1,4,5192,15,0
"16121","방학3동","방학3동제1투","대통령선거","서울특별시","도봉구",2687,1961,789,417,467,139,139,4,0,1,0,0,0,0,1,1957,4,726
"16122","방학3동","방학3동제2투","대통령선거","서울특별시","도봉구",2799,2064,736,515,542,141,120,3,0,0,0,1,0,0,1,2059,5,735
"16123","방학3동","방학3동제3투","대통령선거","서울특별시","도봉구",3057,2149,826,514,519,152,122,3,0,2,0,5,0,0,0,2143,6,908
"16124","방학3동","방학3동제4투","대통령선거","서울특별시","도봉구",2191,1569,665,311,374,102,108,1,0,2,1,0,1,0,0,1565,4,622
"16125","방학3동","방학3동제5투","대통령선거","서울특별시","도봉구",2170,1692,666,379,408,125,99,5,0,3,0,0,0,0,2,1687,5,478
"16126","방학3동","방학3동제6투","대통령선거","서울특별시","도봉구",2316,1881,791,329,494,126,129,1,2,0,0,1,0,0,0,1873,8,435
"16127","방학3동","방학3동제7투","대통령선거","서울특별시","도봉구",2412,1802,727,365,457,133,111,0,0,1,0,3,0,0,2,1799,3,610
"16128","창1동","관내사전투표","대통령선거","서울특별시","도봉구",4299,4299,2164,664,843,265,337,3,0,0,3,7,1,2,2,4291,8,0
"16129","창1동","창1동제1투","대통령선거","서울특별시","도봉구",2990,2088,797,479,543,125,119,14,1,1,0,1,0,0,0,2080,8,902
"16130","창1동","창1동제2투","대통령선거","서울특별시","도봉구",2502,1556,568,357,414,91,112,1,0,0,0,1,0,0,0,1544,12,946
"16131","창1동","창1동제3투","대통령선거","서울특별시","도봉구",2651,1788,709,402,468,109,90,1,0,1,0,1,0,1,2,1784,4,863
"16132","창1동","창1동제4투","대통령선거","서울특별시","도봉구",2761,2092,932,415,457,146,131,1,0,2,0,1,0,0,0,2085,7,669
"16133","창1동","창1동제5투","대통령선거","서울특별시","도봉구",3007,2430,1014,470,551,204,178,4,1,1,0,1,0,1,0,2425,5,577
"16134","창1동","창1동제6투","대통령선거","서울특별시","도봉구",2600,1977,818,446,456,129,115,3,0,2,0,1,0,1,0,1971,6,623
"16135","창2동","관내사전투표","대통령선거","서울특별시","도봉구",4524,4524,2092,799,1026,244,324,6,1,5,0,2,2,3,5,4509,15,0
"16136","창2동","창2동제1투","대통령선거","서울특별시","도봉구",3015,1975,779,417,492,140,134,0,0,1,1,0,0,1,0,1965,10,1040
"16137","창2동","창2동제2투","대통령선거","서울특별시","도봉구",3561,2285,896,494,549,150,174,5,0,4,0,0,0,1,0,2273,12,1276
"16138","창2동","창2동제3투","대통령선거","서울특별시","도봉구",3105,2308,957,419,607,164,152,1,0,0,0,0,0,0,1,2301,7,797
"16139","창2동","창2동제4투","대통령선거","서울특별시","도봉구",2860,2225,843,555,561,137,116,1,0,2,1,2,0,0,0,2218,7,635
"16140","창2동","창2동제5투","대통령선거","서울특별시","도봉구",3741,2587,1109,517,627,159,156,4,1,1,0,0,0,0,3,2577,10,1154
"16141","창2동","창2동제6투","대통령선거","서울특별시","도봉구",3354,2180,889,410,616,116,141,2,0,0,0,1,0,0,1,2176,4,1174
"16142","창3동","관내사전투표","대통령선거","서울특별시","도봉구",1827,1827,829,377,416,76,111,6,0,1,0,1,0,1,3,1821,6,0
"16143","창3동","창3동제1투","대통령선거","서울특별시","도봉구",2300,1386,491,340,392,76,79,3,0,0,0,1,0,1,0,1383,3,914
"16144","창3동","창3동제2투","대통령선거","서울특별시","도봉구",2969,1932,772,427,469,112,140,2,0,0,0,1,0,1,1,1925,7,1037
"16145","창3동","창3동제3투","대통령선거","서울특별시","도봉구",2056,1296,528,261,345,69,74,4,0,3,0,2,1,2,1,1290,6,760
"16146","창3동","창3동제4투","대통령선거","서울특별시","도봉구",2555,1821,708,399,463,113,114,8,0,3,0,2,1,2,0,1813,8,734
"16147","창4동","관내사전투표","대통령선거","서울특별시","도봉구",3209,3209,1498,517,744,202,235,2,0,3,1,2,0,1,0,3205,4,0
"16148","창4동","창4동제1투","대통령선거","서울특별시","도봉구",3135,2324,1009,411,570,164,154,2,0,1,0,1,0,0,0,2312,12,811
"16149","창4동","창4동제2투","대통령선거","서울특별시","도봉구",2557,1861,794,391,451,110,101,1,1,0,0,3,1,0,0,1853,8,696
"16150","창4동","창4동제3투","대통령선거","서울특별시","도봉구",3274,2567,996,589,623,189,157,1,0,0,1,1,0,1,1,2559,8,707
"16151","창4동","창4동제4투","대통령선거","서울특별시","도봉구",3124,2619,1019,542,669,211,166,0,0,1,0,0,0,2,1,2611,8,505
"16152","창4동","창4동제5투","대통령선거","서울특별시","도봉구",2621,2100,859,413,533,149,135,6,0,3,0,0,1,0,0,2099,1,521
"16153","창4동","창4동제6투","대통령선거","서울특별시","도봉구",3201,2617,1095,461,712,195,146,3,0,1,2,0,0,0,0,2615,2,584
"16154","창5동","관내사전투표","대통령선거","서울특별시","도봉구",4350,4350,1972,748,931,345,328,6,0,6,0,1,0,2,1,4340,10,0
"16155","창5동","창5동제1투","대통령선거","서울특별시","도봉구",2774,2008,873,417,488,97,119,2,0,0,1,2,1,1,0,2001,7,766
"16156","창5동","창5동제2투","대통령선거","서울특별시","도봉구",2151,1599,684,337,375,97,96,3,0,1,0,0,0,0,1,1594,5,552
"16157","창5동","창5동제3투","대통령선거","서울특별시","도봉구",2755,2012,834,420,477,123,143,4,0,2,1,0,1,1,1,2007,5,743
"16158","창5동","창5동제4투","대통령선거","서울특별시","도봉구",2733,1837,684,428,464,143,103,6,0,2,0,2,0,1,1,1834,3,896
"16159","창5동","창5동제5투","대통령선거","서울특별시","도봉구",1592,1294,426,337,323,114,87,3,0,1,0,1,0,0,0,1292,2,298
"16160","창5동","창5동제6투","대통령선거","서울특별시","도봉구",2321,1885,646,481,489,152,101,4,0,1,0,1,1,0,4,1880,5,436
"16161","창5동","창5동제7투","대통령선거","서울특별시","도봉구",1642,1137,467,261,263,69,67,1,0,2,0,0,0,0,2,1132,5,505
"16162","도봉1동","관내사전투표","대통령선거","서울특별시","도봉구",3430,3430,1503,741,750,173,220,2,4,1,0,5,1,2,4,3406,24,0
"16163","도봉1동","도봉1동제1투","대통령선거","서울특별시","도봉구",2787,1574,608,356,404,96,93,0,1,4,1,2,1,0,1,1567,7,1213
"16164","도봉1동","도봉1동제2투","대통령선거","서울특별시","도봉구",3769,2672,958,721,648,142,160,8,0,1,2,2,0,3,2,2647,25,1097
"16165","도봉1동","도봉1동제3투","대통령선거","서울특별시","도봉구",2064,1397,502,337,406,80,63,1,0,1,0,0,0,0,2,1392,5,667
"16166","도봉1동","도봉1동제4투","대통령선거","서울특별시","도봉구",1364,933,288,297,222,50,63,1,0,1,1,2,0,0,2,927,6,431
"16167","도봉1동","도봉1동제5투","대통령선거","서울특별시","도봉구",2396,1752,563,522,461,90,105,3,0,0,0,1,0,2,2,1749,3,644
"16168","도봉1동","도봉1동제6투","대통령선거","서울특별시","도봉구",3601,2366,849,606,627,122,138,3,0,1,2,1,0,0,5,2354,12,1235
"16169","도봉2동","관내사전투표","대통령선거","서울특별시","도봉구",3821,3821,1767,785,800,218,230,3,0,3,0,3,2,1,2,3814,7,0
"16170","도봉2동","도봉2동제1투","대통령선거","서울특별시","도봉구",2204,1256,498,275,323,72,77,0,1,0,1,0,2,0,1,1250,6,948
"16171","도봉2동","도봉2동제2투","대통령선거","서울특별시","도봉구",2481,1917,720,476,499,97,109,5,0,1,1,0,0,1,0,1909,8,564
"16172","도봉2동","도봉2동제3투","대통령선거","서울특별시","도봉구",2377,1532,602,364,392,84,78,1,1,1,0,1,2,1,0,1527,5,845
"16173","도봉2동","도봉2동제4투","대통령선거","서울특별시","도봉구",2469,1814,713,388,479,106,113,5,1,2,0,1,0,0,0,1808,6,655
"16174","도봉2동","도봉2동제5투","대통령선거","서울특별시","도봉구",3099,2447,891,632,623,148,129,2,0,2,0,5,0,1,1,2434,13,652
"16175","도봉2동","도봉2동제6투","대통령선거","서울특별시","도봉구",3127,2546,1037,609,581,161,143,4,1,2,0,0,0,1,0,2539,7,581
"16176","도봉2동","도봉2동제7투","대통령선거","서울특별시","도봉구",3546,2838,1082,699,721,166,148,4,0,0,0,3,0,2,1,2826,12,708
"16177","잘못 투입·구분된 투표지","잘못 투입·구분된 투표지","대통령선거","서울특별시","도봉구",0,0,0,0,0,0,0,0,0,0,0,0,0,0,0,0,0,0
"16178","거소·선상투표","거소·선상투표","대통령선거","서울특별시","노원구",885,806,256,139,300,44,22,2,3,2,3,1,7,0,5,784,22,79
"16179","관외사전투표","관외사전투표","대통령선거","서울특별시","노원구",41225,41218,19138,5677,9672,3047,3273,55,7,11,9,17,9,8,38,40961,257,7
"16180","재외투표","재외투표","대통령선거","서울특별시","노원구",4170,3291,2008,238,494,131,392,14,0,0,0,5,0,2,1,3285,6,879
"16181","월계1동","관내사전투표","대통령선거","서울특별시","노원구",3578,3578,1637,650,738,276,260,2,0,0,0,0,0,2,1,3566,12,0
"16182","월계1동","월계1동제1투","대통령선거","서울특별시","노원구",2842,2025,749,477,509,143,123,8,0,4,2,0,1,0,1,2017,8,817
"16183","월계1동","월계1동제2투","대통령선거","서울특별시","노원구",2743,1943,685,511,524,105,103,1,0,1,1,1,0,0,1,1933,10,800
"16184","월계1동","월계1동제3투","대통령선거","서울특별시","노원구",3507,2570,983,559,661,184,164,3,1,3,0,1,0,0,4,2563,7,937
"16185","월계1동","월계1동제4투","대통령선거","서울특별시","노원구",3008,2123,853,473,523,130,128,1,0,0,2,1,1,1,0,2113,10,885
"16186","월계1동","월계1동제5투","대통령선거","서울특별시","노원구",2763,1975,778,416,543,113,110,3,0,2,0,1,0,3,1,1970,5,788
"16187","월계2동","관내사전투표","대통령선거","서울특별시","노원구",2970,2970,1357,601,626,177,180,1,0,1,0,5,1,1,4,2954,16,0
"16188","월계2동","월계2동제1투","대통령선거","서울특별시","노원구",3360,2241,784,562,635,145,99,5,0,0,1,0,0,0,4,2235,6,1119
"16189","월계2동","월계2동제2투","대통령선거","서울특별시","노원구",2732,1977,870,405,477,100,113,2,1,2,0,1,1,0,1,1973,4,755
"16190","월계2동","월계2동제3투","대통령선거","서울특별시","노원구",2863,2217,886,488,547,157,120,4,0,0,2,3,0,0,1,2208,9,646
"16191","월계2동","월계2동제4투","대통령선거","서울특별시","노원구",3824,2839,1122,543,771,199,179,4,0,1,0,4,2,1,2,2828,11,985
"16192","월계2동","월계2동제5투","대통령선거","서울특별시","노원구",3236,2134,714,583,599,107,91,8,0,3,0,4,2,2,0,2113,21,1102
"16193","월계2동","월계2동제6투","대통령선거","서울특별시","노원구",1339,902,321,242,224,53,54,4,0,0,0,0,0,2,0,900,2,437
"16194","월계3동","관내사전투표","대통령선거","서울특별시","노원구",2626,2626,1261,474,536,156,181,3,0,1,0,2,0,1,1,2616,10,0
"16195","월계3동","월계3동제1투","대통령선거","서울특별시","노원구",2267,1562,688,298,355,101,104,5,0,1,1,0,1,0,2,1556,6,705
"16196","월계3동","월계3동제2투","대통령선거","서울특별시","노원구",2602,2134,960,441,500,115,103,3,2,2,1,2,0,1,0,2130,4,468
"16197","월계3동","월계3동제3투","대통령선거","서울특별시","노원구",2588,2067,824,497,497,109,127,4,0,1,0,0,2,1,1,2063,4,521
"16198","월계3동","월계3동제4투","대통령선거","서울특별시","노원구",2684,2077,960,344,481,131,146,2,0,2,0,4,0,0,0,2070,7,607
"16199","월계3동","월계3동제5투","대통령선거","서울특별시","노원구",3140,2638,1111,585,587,180,161,2,0,1,1,2,0,0,3,2633,5,502
"16200","월계3동","월계3동제6투","대통령선거","서울특별시","노원구",3106,2561,1009,602,602,180,153,9,0,1,0,0,1,1,0,2558,3,545
"16201","월계3동","월계3동제7투","대통령선거","서울특별시","노원구",1715,1328,549,287,330,82,73,2,0,0,0,0,1,0,1,1325,3,387
"16202","월계3동","월계3동제8투","대통령선거","서울특별시","노원구",1917,1296,543,280,314,82,65,0,0,0,0,5,2,0,1,1292,4,621
"16203","월계3동","월계3동제9투","대통령선거","서울특별시","노원구",2202,1437,492,387,407,66,59,3,1,1,2,0,4,0,1,1423,14,765
"16204","공릉1동","관내사전투표","대통령선거","서울특별시","노원구",5511,5511,2699,787,1109,405,459,12,0,2,1,8,2,4,6,5494,17,0
"16205","공릉1동","공릉1동제1투","대통령선거","서울특별시","노원구",3085,2077,832,425,508,157,140,4,0,0,0,0,1,0,1,2068,9,1008
"16206","공릉1동","공릉1동제2투","대통령선거","서울특별시","노원구",3965,2932,1217,592,726,160,221,3,0,3,0,1,0,4,1,2928,4,1033
"16207","공릉1동","공릉1동제3투","대통령선거","서울특별시","노원구",3015,1770,699,319,470,145,130,0,0,0,1,0,0,0,1,1765,5,1245
"16208","공릉1동","공릉1동제4투","대통령선거","서울특별시","노원구",2720,1912,743,437,498,116,101,2,0,0,1,0,1,3,1,1903,9,808
"16209","공릉1동","공릉1동제5투","대통령선거","서울특별시","노원구",2490,1758,654,426,487,99,80,1,0,2,1,0,1,0,3,1754,4,732
"16210","공릉1동","공릉1동제6투","대통령선거","서울특별시","노원구",1942,1385,537,301,374,72,86,3,0,1,1,0,1,1,3,1380,5,557
"16211","공릉1동","공릉1동제7투","대통령선거","서울특별시","노원구",2695,2057,866,408,506,135,130,3,1,1,0,2,0,0,1,2053,4,638
"16212","공릉1동","공릉1동제8투","대통령선거","서울특별시","노원구",2707,2081,907,364,533,152,109,3,0,0,0,2,0,1,2,2073,8,626
"16213","공릉1동","공릉1동제9투","대통령선거","서울특별시","노원구",2987,2467,1079,429,613,171,166,4,0,0,0,0,0,0,0,2462,5,520
"16214","공릉2동","관내사전투표","대통령선거","서울특별시","노원구",5327,5327,2621,845,1031,403,403,7,1,2,0,4,0,0,1,5318,9,0
"16215","공릉2동","공릉2동제1투","대통령선거","서울특별시","노원구",3153,2214,1012,354,507,166,161,2,0,0,0,0,0,0,4,2206,8,939
"16216","공릉2동","공릉2동제2투","대통령선거","서울특별시","노원구",3115,2582,1092,495,600,204,181,2,0,0,0,0,0,1,1,2576,6,533
"16217","공릉2동","공릉2동제3투","대통령선거","서울특별시","노원구",3240,2545,1049,522,627,176,151,2,0,3,2,0,0,0,3,2535,10,695
"16218","공릉2동","공릉2동제4투","대통령선거","서울특별시","노원구",3003,2314,955,456,565,182,146,2,0,2,1,0,0,0,1,2310,4,689
"16219","공릉2동","공릉2동제5투","대통령선거","서울특별시","노원구",3266,2616,1098,561,635,157,146,3,0,1,1,1,1,0,3,2607,9,650
"16220","공릉2동","공릉2동제6투","대통령선거","서울특별시","노원구",3033,2247,852,507,557,171,149,3,0,0,0,3,0,3,1,2246,1,786
"16221","공릉2동","공릉2동제7투","대통령선거","서울특별시","노원구",2875,2108,864,499,467,132,130,5,0,1,0,1,0,0,0,2099,9,767
"16222","공릉2동","공릉2동제8투","대통령선거","서울특별시","노원구",1358,989,311,228,242,120,79,2,0,2,0,1,1,0,0,986,3,369
"16223","공릉2동","공릉2동제9투","대통령선거","서울특별시","노원구",2310,1809,777,379,413,122,111,1,1,0,0,0,1,0,1,1806,3,501
"16224","하계1동","관내사전투표","대통령선거","서울특별시","노원구",3211,3211,1462,530,722,250,224,7,0,2,0,2,0,2,4,3205,6,0
"16225","하계1동","하계1동제1투","대통령선거","서울특별시","노원구",2337,1738,662,371,457,137,102,2,0,0,0,3,2,0,0,1736,2,599
"16226","하계1동","하계1동제2투","대통령선거","서울특별시","노원구",2838,2094,864,395,530,136,127,5,0,1,2,4,1,0,4,2069,25,744
"16227","하계1동","하계1동제3투","대통령선거","서울특별시","노원구",3266,2154,766,497,660,117,89,4,0,1,0,0,1,1,3,2139,15,1112
"16228","하계1동","하계1동제4투","대통령선거","서울특별시","노원구",3030,2362,936,453,595,195,171,1,0,1,0,2,1,0,1,2356,6,668
"16229","하계1동","하계1동제5투","대통령선거","서울특별시","노원구",3015,2234,905,368,557,186,202,2,1,2,0,1,1,1,3,2229,5,781
"16230","하계1동","하계1동제6투","대통령선거","서울특별시","노원구",3334,2717,1118,475,723,192,192,4,0,1,1,4,0,2,2,2714,3,617
"16231","하계2동","관내사전투표","대통령선거","서울특별시","노원구",3717,3717,1847,498,812,279,260,4,0,3,0,0,0,0,1,3704,13,0
"16232","하계2동","하계2동제1투","대통령선거","서울특별시","노원구",3031,2162,924,359,573,156,135,2,0,4,1,1,1,0,3,2159,3,869
"16233","하계2동","하계2동제2투","대통령선거","서울특별시","노원구",2283,1454,518,389,396,61,72,4,0,2,0,1,0,1,4,1448,6,829
"16234","하계2동","하계2동제3투","대통령선거","서울특별시","노원구",3352,2877,1255,445,779,216,162,6,0,3,2,1,0,0,0,2869,8,475
"16235","하계2동","하계2동제4투","대통령선거","서울특별시","노원구",2939,2421,1103,381,575,176,176,1,0,1,0,0,0,0,1,2414,7,518
"16236","하계2동","하계2동제5투","대통령선거","서울특별시","노원구",3116,2540,1041,417,680,220,170,2,0,0,0,0,0,0,1,2531,9,576
"16237","중계본동","관내사전투표","대통령선거","서울특별시","노원구",3563,3563,1764,456,767,278,265,5,0,2,1,2,0,0,4,3544,19,0
"16238","중계본동","중계본동제1투","대통령선거","서울특별시","노원구",2089,1433,543,283,411,112,78,1,0,2,0,1,0,1,0,1432,1,656
"16239","중계본동","중계본동제2투","대통령선거","서울특별시","노원구",1470,824,289,210,251,29,38,1,0,1,1,2,0,0,1,823,1,646
"16240","중계본동","중계본동제3투","대통령선거","서울특별시","노원구",2991,2455,1048,335,674,209,176,4,0,0,0,1,0,0,0,2447,8,536
"16241","중계본동","중계본동제4투","대통령선거","서울특별시","노원구",3070,2463,1067,364,647,199,176,4,0,0,0,0,0,0,2,2459,4,607
"16242","중계본동","중계본동제5투","대통령선거","서울특별시","노원구",2723,2056,858,338,532,176,142,1,0,1,0,2,0,0,2,2052,4,667
"16243","중계본동","중계본동제6투","대통령선거","서울특별시","노원구",2875,2265,907,377,628,191,152,1,0,0,1,0,0,0,3,2260,5,610
"16244","중계1동","관내사전투표","대통령선거","서울특별시","노원구",3799,3799,1903,472,837,275,286,3,1,2,0,1,1,1,4,3786,13,0
"16245","중계1동","중계1동제1투","대통령선거","서울특별시","노원구",3018,2250,960,344,606,171,145,9,0,1,1,1,2,1,2,2243,7,768
"16246","중계1동","중계1동제2투","대통령선거","서울특별시","노원구",3288,2448,984,407,671,209,161,1,0,0,0,2,0,2,2,2439,9,840
"16247","중계1동","중계1동제3투","대통령선거","서울특별시","노원구",2864,2357,1030,372,581,199,165,1,0,0,0,1,0,1,1,2351,6,507
"16248","중계1동","중계1동제4투","대통령선거","서울특별시","노원구",3174,2643,1294,305,631,239,165,0,0,0,1,0,0,0,1,2636,7,531
"16249","중계1동","중계1동제5투","대통령선거","서울특별시","노원구",2980,2396,1025,399,617,192,143,5,1,1,0,1,0,3,2,2389,7,584
"16250","중계2·3동","관내사전투표","대통령선거","서울특별시","노원구",5314,5314,2608,721,1204,384,353,5,0,3,1,5,1,4,4,5293,21,0
"16251","중계2·3동","중계2·3동제1투","대통령선거","서울특별시","노원구",2656,2068,971,295,528,141,119,2,0,0,2,1,1,0,2,2062,6,588
"16252","중계2·3동","중계2·3동제2투","대통령선거","서울특별시","노원구",2817,2338,968,456,549,186,166,6,0,0,0,3,0,0,1,2335,3,479
"16253","중계2·3동","중계2·3동제3투","대통령선거","서울특별시","노원구",2311,1763,784,300,450,112,108,1,1,0,2,0,0,3,0,1761,2,548
"16254","중계2·3동","중계2·3동제4투","대통령선거","서울특별시","노원구",2417,1768,738,305,455,138,121,1,0,1,0,0,0,0,2,1761,7,649
"16255","중계2·3동","중계2·3동제5투","대통령선거","서울특별시","노원구",2670,1976,840,339,496,145,144,2,0,1,1,1,0,0,0,1969,7,694
"16256","중계2·3동","중계2·3동제6투","대통령선거","서울특별시","노원구",2383,1886,808,356,476,108,121,9,0,2,1,0,0,0,0,1881,5,497
"16257","중계2·3동","중계2·3동제7투","대통령선거","서울특별시","노원구",2286,1720,634,387,475,114,85,5,1,0,2,0,1,0,5,1709,11,566
"16258","중계2·3동","중계2·3동제8투","대통령선거","서울특별시","노원구",2593,1783,704,386,495,85,88,5,1,3,1,0,0,0,1,1769,14,810
"16259","중계2·3동","중계2·3동제9투","대통령선거","서울특별시","노원구",1809,1232,395,368,379,44,30,2,0,1,1,1,0,2,0,1223,9,577
"16260","중계2·3동","중계2·3동제10투","대통령선거","서울특별시","노원구",2937,1877,704,463,517,84,87,7,1,3,0,0,1,0,1,1868,9,1060
"16261","중계4동","관내사전투표","대통령선거","서울특별시","노원구",2872,2872,1339,497,671,154,190,8,0,1,0,2,1,1,1,2865,7,0
"16262","중계4동","중계4동제1투","대통령선거","서울특별시","노원구",3610,2503,1002,473,713,144,151,3,1,1,1,3,0,0,2,2494,9,1107
"16263","중계4동","중계4동제2투","대통령선거","서울특별시","노원구",2850,1978,704,455,600,93,99,5,0,1,2,2,1,3,2,1967,11,872
"16264","중계4동","중계4동제3투","대통령선거","서울특별시","노원구",3844,3097,1298,539,866,213,169,6,0,0,2,1,0,0,0,3094,3,747
"16265","중계4동","중계4동제4투","대통령선거","서울특별시","노원구",3284,2463,999,528,625,138,163,0,0,2,0,1,0,1,1,2458,5,821
"16266","상계1동","관내사전투표","대통령선거","서울특별시","노원구",6176,6176,2722,1026,1645,343,391,6,0,4,1,6,1,5,3,6153,23,0
"16267","상계1동","상계1동제1투","대통령선거","서울특별시","노원구",3656,2211,827,471,650,128,120,3,1,0,0,0,0,1,0,2201,10,1445
"16268","상계1동","상계1동제2투","대통령선거","서울특별시","노원구",2889,2086,865,350,605,119,132,3,0,2,0,0,1,1,3,2081,5,803
"16269","상계1동","상계1동제3투","대통령선거","서울특별시","노원구",3361,2584,1123,407,740,134,167,1,0,0,0,3,0,1,0,2576,8,777
"16270","상계1동","상계1동제4투","대통령선거","서울특별시","노원구",2998,2101,625,588,662,118,92,8,1,1,0,0,2,0,0,2097,4,897
"16271","상계1동","상계1동제5투","대통령선거","서울특별시","노원구",3127,2316,883,457,680,128,147,3,0,2,1,2,0,1,1,2305,11,811
"16272","상계1동","상계1동제6투","대통령선거","서울특별시","노원구",3108,2459,934,455,765,162,131,2,0,1,0,3,0,2,1,2456,3,649
"16273","상계1동","상계1동제7투","대통령선거","서울특별시","노원구",3035,2291,711,512,825,104,117,5,1,1,2,1,0,0,1,2280,11,744
"16274","상계1동","상계1동제8투","대통령선거","서울특별시","노원구",3461,2622,927,509,839,183,148,5,0,0,0,0,0,0,2,2613,9,839
"16275","상계2동","관내사전투표","대통령선거","서울특별시","노원구",3981,3980,1708,658,1036,261,276,11,1,2,0,0,3,2,4,3962,18,1
"16276","상계2동","상계2동제1투","대통령선거","서울특별시","노원구",3332,2136,741,477,692,93,117,4,0,2,0,2,1,3,0,2132,4,1196
"16277","상계2동","상계2동제2투","대통령선거","서울특별시","노원구",3403,2374,886,461,727,165,123,3,1,0,1,2,0,0,0,2369,5,1029
"16278","상계2동","상계2동제3투","대통령선거","서울특별시","노원구",3204,2214,849,435,647,156,116,2,0,0,0,0,1,1,0,2207,7,990
"16279","상계2동","상계2동제4투","대통령선거","서울특별시","노원구",3330,2383,956,428,663,176,149,1,0,1,1,0,0,1,0,2376,7,947
"16280","상계3·4동","관내사전투표","대통령선거","서울특별시","노원구",3172,3172,1298,589,917,159,180,13,2,0,2,5,0,1,0,3166,6,0
"16281","상계3·4동","상계3·4동제1투","대통령선거","서울특별시","노원구",3463,2181,772,491,727,94,80,3,0,0,0,2,0,1,1,2171,10,1282
"16282","상계3·4동","상계3·4동제2투","대통령선거","서울특별시","노원구",2787,2227,824,487,648,142,112,5,0,0,0,0,0,1,2,2221,6,560
"16283","상계3·4동","상계3·4동제3투","대통령선거","서울특별시","노원구",2536,1808,657,371,570,80,118,0,1,1,1,3,0,1,0,1803,5,728
"16284","상계3·4동","상계3·4동제4투","대통령선거","서울특별시","노원구",2095,1377,478,331,418,55,85,0,0,0,1,2,0,0,0,1370,7,718
"16285","상계3·4동","상계3·4동제5투","대통령선거","서울특별시","노원구",2587,1922,677,475,535,120,107,3,1,0,0,1,0,0,0,1919,3,665
"16286","상계3·4동","상계3·4동제6투","대통령선거","서울특별시","노원구",3035,1622,512,378,569,71,81,2,0,0,1,0,0,3,0,1617,5,1413
"16287","상계3·4동","상계3·4동제7투","대통령선거","서울특별시","노원구",2813,1736,541,415,594,61,115,2,0,1,0,2,0,1,2,1734,2,1077
"16288","상계5동","관내사전투표","대통령선거","서울특별시","노원구",3581,3580,1571,614,969,188,210,6,0,1,3,2,1,0,1,3566,14,1
"16289","상계5동","상계5동제1투","대통령선거","서울특별시","노원구",2950,1661,509,402,561,70,101,4,0,2,0,2,1,1,1,1654,7,1289
"16290","상계5동","상계5동제2투","대통령선거","서울특별시","노원구",3342,2462,941,478,739,144,140,3,0,4,1,4,0,0,0,2454,8,880
"16291","상계5동","상계5동제3투","대통령선거","서울특별시","노원구",2597,1692,570,402,538,88,82,3,0,3,0,0,0,1,0,1687,5,905
"16292","상계5동","상계5동제4투","대통령선거","서울특별시","노원구",3210,2394,902,415,712,196,154,1,0,2,0,0,0,1,1,2384,10,816
"16293","상계5동","상계5동제5투","대통령선거","서울특별시","노원구",2711,1972,677,460,611,89,122,4,0,0,0,3,0,0,1,1967,5,739
"16294","상계5동","상계5동제6투","대통령선거","서울특별시","노원구",2994,2074,708,464,674,108,104,5,0,3,0,2,0,0,3,2071,3,920
"16295","상계6·7동","관내사전투표","대통령선거","서울특별시","노원구",4884,4884,2440,623,1062,337,389,9,0,1,1,5,1,1,1,4870,14,0
"16296","상계6·7동","상계6·7동제1투","대통령선거","서울특별시","노원구",2838,2139,848,458,509,170,138,5,0,0,0,1,0,0,1,2130,9,699
"16297","상계6·7동","상계6·7동제2투","대통령선거","서울특별시","노원구",3121,2377,1003,475,581,160,147,2,0,0,1,0,0,0,0,2369,8,744
"16298","상계6·7동","상계6·7동제3투","대통령선거","서울특별시","노원구",3061,2481,1110,442,607,165,148,1,0,0,0,2,1,1,1,2478,3,580
"16299","상계6·7동","상계6·7동제4투","대통령선거","서울특별시","노원구",3771,2941,1270,488,800,183,182,1,0,2,0,2,1,3,1,2933,8,830
"16300","상계6·7동","상계6·7동제5투","대통령선거","서울특별시","노원구",3515,2602,1038,486,712,172,183,2,0,0,0,2,1,1,1,2598,4,913
"16301","상계6·7동","상계6·7동제6투","대통령선거","서울특별시","노원구",3225,2302,993,429,558,130,171,7,0,4,0,1,0,1,2,2296,6,923
"16302","상계6·7동","상계6·7동제7투","대통령선거","서울특별시","노원구",3092,2556,1070,459,656,192,165,3,0,2,2,0,0,1,0,2550,6,536
"16303","상계8동","관내사전투표","대통령선거","서울특별시","노원구",3859,3859,2069,403,824,262,279,4,0,0,0,3,1,2,3,3850,9,0
"16304","상계8동","상계8동제1투","대통령선거","서울특별시","노원구",2522,1928,802,348,540,106,115,4,0,1,0,2,1,0,2,1921,7,594
"16305","상계8동","상계8동제2투","대통령선거","서울특별시","노원구",3122,2498,1082,383,712,147,156,4,0,3,1,0,0,0,0,2488,10,624
"16306","상계8동","상계8동제3투","대통령선거","서울특별시","노원구",2841,2200,890,408,593,144,154,3,1,1,0,0,1,1,1,2197,3,641
"16307","상계8동","상계8동제4투","대통령선거","서울특별시","노원구",1790,1359,858,78,256,91,75,0,0,0,0,0,0,0,0,1358,1,431
"16308","상계8동","상계8동제5투","대통령선거","서울특별시","노원구",2887,2320,897,398,690,158,166,0,0,1,0,0,0,1,4,2315,5,567
"16309","상계9동","관내사전투표","대통령선거","서울특별시","노원구",3633,3633,1663,600,853,242,266,2,1,0,0,1,1,0,0,3629,4,0
"16310","상계9동","상계9동제1투","대통령선거","서울특별시","노원구",3114,2289,879,423,704,129,131,6,0,4,0,0,1,2,0,2279,10,825
"16311","상계9동","상계9동제2투","대통령선거","서울특별시","노원구",3270,2612,986,503,737,205,170,1,0,0,0,2,0,0,0,2604,8,658
"16312","상계9동","상계9동제3투","대통령선거","서울특별시","노원구",3101,2359,933,426,653,133,206,1,0,1,0,2,0,0,1,2356,3,742
"16313","상계9동","상계9동제4투","대통령선거","서울특별시","노원구",3646,2816,1106,545,750,189,204,3,0,3,0,3,0,0,2,2805,11,830
"16314","상계10동","관내사전투표","대통령선거","서울특별시","노원구",3271,3271,1590,439,794,203,229,6,0,1,0,1,1,0,1,3265,6,0
"16315","상계10동","상계10동제1투","대통령선거","서울특별시","노원구",2963,2214,757,502,634,175,131,4,0,0,3,0,0,1,1,2208,6,749
"16316","상계10동","상계10동제2투","대통령선거","서울특별시","노원구",2860,2172,880,354,637,145,144,2,0,0,1,0,0,3,0,2166,6,688
"16317","상계10동","상계10동제3투","대통령선거","서울특별시","노원구",2522,1836,734,326,515,115,136,2,0,0,0,1,0,0,1,1830,6,686
"16318","상계10동","상계10동제4투","대통령선거","서울특별시","노원구",2865,2241,901,386,659,117,166,4,0,1,0,0,0,0,1,2235,6,624
"16319","잘못 투입·구분된 투표지","잘못 투입·구분된 투표지","대통령선거","서울특별시","노원구",0,4,3,1,0,0,0,0,0,0,0,0,0,0,0,4,0,-4
"16320","거소·선상투표","거소·선상투표","대통령선거","서울특별시","은평구",679,632,219,103,181,34,16,4,2,3,10,3,1,0,8,584,48,47
"16321","관외사전투표","관외사전투표","대통령선거","서울특별시","은평구",36001,35902,17723,4770,7429,2475,3087,39,13,19,73,22,5,9,49,35713,189,99
"16322","재외투표","재외투표","대통령선거","서울특별시","은평구",3886,2963,1793,257,441,96,348,11,0,1,3,2,0,0,1,2953,10,923
"16323","녹번동","관내사전투표","대통령선거","서울특별시","은평구",4701,4701,2304,772,966,279,342,7,0,1,7,4,1,1,2,4686,15,0
"16324","녹번동","녹번동제1투","대통령선거","서울특별시","은평구",4136,2495,1066,539,589,138,139,5,1,0,4,2,0,4,1,2488,7,1641
"16325","녹번동","녹번동제2투","대통령선거","서울특별시","은평구",1443,1058,403,263,239,78,71,1,0,0,1,1,0,0,0,1057,1,385
"16326","녹번동","녹번동제3투","대통령선거","서울특별시","은평구",2652,1713,734,375,425,85,80,3,0,0,1,2,1,1,1,1708,5,939
"16327","녹번동","녹번동제4투","대통령선거","서울특별시","은평구",3027,2070,822,474,509,124,128,1,1,1,3,0,0,0,1,2064,6,957
"16328","녹번동","녹번동제5투","대통령선거","서울특별시","은평구",2759,2222,911,442,538,158,160,2,1,0,3,0,0,0,1,2216,6,537
"16329","녹번동","녹번동제6투","대통령선거","서울특별시","은평구",3129,2043,832,464,483,111,137,5,0,3,2,1,0,1,2,2041,2,1086
"16330","녹번동","녹번동제7투","대통령선거","서울특별시","은평구",3380,2348,988,508,569,128,139,3,0,2,3,2,0,0,1,2343,5,1032
"16331","응암제1동","관내사전투표","대통령선거","서울특별시","은평구",3974,3974,2028,647,801,222,246,7,1,4,3,0,3,1,0,3963,11,0
"16332","응암제1동","응암제1동제1투","대통령선거","서울특별시","은평구",3280,2033,864,420,516,102,124,3,0,0,2,1,1,0,0,2033,0,1247
"16333","응암제1동","응암제1동제2투","대통령선거","서울특별시","은평구",1655,995,399,213,254,64,61,0,1,2,0,0,0,0,1,995,0,660
"16334","응암제1동","응암제1동제3투","대통령선거","서울특별시","은평구",3006,2112,860,452,520,129,133,1,1,2,1,2,0,0,2,2103,9,894
"16335","응암제1동","응암제1동제4투","대통령선거","서울특별시","은평구",3744,2628,1194,520,604,152,142,3,0,3,0,1,0,1,1,2621,7,1116
"16336","응암제1동","응암제1동제5투","대통령선거","서울특별시","은평구",3950,2721,1233,474,634,182,173,2,0,3,2,2,0,2,2,2709,12,1229
"16337","응암제2동","관내사전투표","대통령선거","서울특별시","은평구",2264,2264,1104,381,502,124,140,6,0,0,1,1,0,0,0,2259,5,0
"16338","응암제2동","응암제2동제1투","대통령선거","서울특별시","은평구",3405,2039,929,367,431,148,150,3,0,1,1,1,0,0,1,2032,7,1366
"16339","응암제2동","응암제2동제2투","대통령선거","서울특별시","은평구",1202,726,311,137,194,43,34,3,0,0,0,0,1,1,0,724,2,476
"16340","응암제2동","응암제2동제3투","대통령선거","서울특별시","은평구",1861,1423,690,228,329,87,78,3,0,2,1,0,0,0,0,1418,5,438
"16341","응암제2동","응암제2동제4투","대통령선거","서울특별시","은평구",2505,1794,791,351,409,119,112,5,1,0,2,0,0,0,0,1790,4,711
"16342","응암제2동","응암제2동제5투","대통령선거","서울특별시","은평구",2412,1661,645,420,370,88,124,1,0,2,1,1,1,1,3,1657,4,751
"16343","응암제3동","관내사전투표","대통령선거","서울특별시","은평구",4742,4742,2315,824,1011,252,304,3,0,3,7,4,2,1,4,4730,12,0
"16344","응암제3동","응암제3동제1투","대통령선거","서울특별시","은평구",3436,2050,891,386,482,148,132,2,0,1,0,1,0,1,0,2044,6,1386
"16345","응암제3동","응암제3동제2투","대통령선거","서울특별시","은평구",3056,2003,816,432,512,101,126,2,0,0,2,3,0,2,2,1998,5,1053
"16346","응암제3동","응암제3동제3투","대통령선거","서울특별시","은평구",3068,1955,800,419,484,122,111,3,0,2,0,1,0,1,2,1945,10,1113
"16347","응암제3동","응암제3동제4투","대통령선거","서울특별시","은평구",2300,1359,509,320,351,80,86,4,1,2,0,1,0,1,0,1355,4,941
"16348","응암제3동","응암제3동제5투","대통령선거","서울특별시","은평구",2520,1797,688,394,533,97,69,2,1,1,2,0,0,0,0,1787,10,723
"16349","응암제3동","응암제3동제6투","대통령선거","서울특별시","은평구",2817,1859,730,425,463,117,109,2,0,1,1,0,0,0,2,1850,9,958
"16350","증산동","관내사전투표","대통령선거","서울특별시","은평구",3415,3415,1573,666,731,177,241,7,0,0,0,6,0,4,0,3405,10,0
"16351","증산동","증산동제1투","대통령선거","서울특별시","은평구",2871,1848,746,392,453,122,123,0,0,2,0,2,0,1,1,1842,6,1023
"16352","증산동","증산동제2투","대통령선거","서울특별시","은평구",3264,2262,876,494,565,152,157,2,0,0,1,1,0,1,1,2250,12,1002
"16353","증산동","증산동제3투","대통령선거","서울특별시","은평구",2611,1807,706,435,419,127,108,0,0,2,2,0,0,0,1,1800,7,804
"16354","증산동","증산동제4투","대통령선거","서울특별시","은평구",2490,1776,750,335,428,126,127,1,0,0,4,0,1,0,1,1773,3,714
"16355","수색동","관내사전투표","대통령선거","서울특별시","은평구",2330,2330,1025,457,544,139,141,6,2,2,2,0,1,2,0,2321,9,0
"16356","수색동","수색동제1투","대통령선거","서울특별시","은평구",1947,1260,430,307,346,82,81,2,0,2,0,0,0,1,1,1252,8,687
"16357","수색동","수색동제2투","대통령선거","서울특별시","은평구",2181,1539,560,380,402,105,81,3,0,0,0,1,0,2,0,1534,5,642
"16358","수색동","수색동제3투","대통령선거","서울특별시","은평구",1793,1183,471,266,309,61,65,2,0,1,1,0,0,1,2,1179,4,610
"16359","수색동","수색동제4투","대통령선거","서울특별시","은평구",1550,1006,358,254,267,45,75,3,0,1,0,0,0,0,0,1003,3,544
"16360","수색동","수색동제5투","대통령선거","서울특별시","은평구",2503,1958,821,409,478,126,110,4,0,0,4,0,1,1,0,1954,4,545
"16361","신사제1동","관내사전투표","대통령선거","서울특별시","은평구",5619,5619,2719,955,1211,335,377,1,0,3,2,2,0,0,0,5605,14,0
"16362","신사제1동","신사제1동제1투","대통령선거","서울특별시","은평구",3831,2480,1096,458,612,151,140,4,0,2,2,3,0,1,2,2471,9,1351
"16363","신사제1동","신사제1동제2투","대통령선거","서울특별시","은평구",3594,2491,1085,486,561,167,170,2,1,3,6,0,0,0,3,2484,7,1103
"16364","신사제1동","신사제1동제3투","대통령선거","서울특별시","은평구",3632,2522,1092,462,638,156,149,5,0,1,2,0,1,0,1,2507,15,1110
"16365","신사제1동","신사제1동제4투","대통령선거","서울특별시","은평구",2254,1537,667,302,330,95,125,5,1,0,1,3,0,0,1,1530,7,717
"16366","신사제1동","신사제1동제5투","대통령선거","서울특별시","은평구",3560,2615,1069,522,683,160,164,5,0,1,4,1,1,0,2,2612,3,945
"16367","신사제2동","관내사전투표","대통령선거","서울특별시","은평구",2419,2419,1125,439,517,163,154,8,0,1,0,1,1,1,2,2412,7,0
"16368","신사제2동","신사제2동제1투","대통령선거","서울특별시","은평구",2443,1703,694,357,404,95,137,5,0,0,5,0,0,0,1,1698,5,740
"16369","신사제2동","신사제2동제2투","대통령선거","서울특별시","은평구",2828,2054,872,410,465,159,124,9,0,0,5,1,0,0,2,2047,7,774
"16370","신사제2동","신사제2동제3투","대통령선거","서울특별시","은평구",3144,2003,826,388,515,115,138,3,0,0,1,1,2,0,5,1994,9,1141
"16371","신사제2동","신사제2동제4투","대통령선거","서울특별시","은평구",2416,1744,747,339,422,121,104,0,1,1,1,0,0,1,0,1737,7,672
"16372","신사제2동","신사제2동제5투","대통령선거","서울특별시","은평구",2723,1786,755,379,425,105,110,2,0,1,0,3,0,1,3,1784,2,937
"16373","갈현제2동","관내사전투표","대통령선거","서울특별시","은평구",4719,4719,2286,774,891,287,433,2,0,7,15,4,1,0,3,4703,16,0
"16374","갈현제2동","갈현제2동제1투","대통령선거","서울특별시","은평구",3864,2389,995,499,593,124,153,3,0,2,7,1,0,3,3,2383,6,1475
"16375","갈현제2동","갈현제2동제2투","대통령선거","서울특별시","은평구",3961,2681,1065,551,662,172,196,1,0,4,19,0,0,2,0,2672,9,1280
"16376","갈현제2동","갈현제2동제3투","대통령선거","서울특별시","은평구",4267,2697,1104,555,622,168,216,4,0,2,16,0,0,0,0,2687,10,1570
"16377","갈현제2동","갈현제2동제4투","대통령선거","서울특별시","은평구",3248,2247,870,488,559,139,163,3,1,0,10,1,1,0,2,2237,10,1001
"16378","갈현제2동","갈현제2동제5투","대통령선거","서울특별시","은평구",3335,2415,1052,457,569,151,163,2,2,0,4,0,0,2,1,2403,12,920
"16379","구산동","관내사전투표","대통령선거","서울특별시","은평구",4581,4581,2173,769,970,263,347,4,3,1,12,1,0,3,2,4548,33,0
"16380","구산동","구산동제1투","대통령선거","서울특별시","은평구",4415,2636,1081,584,597,145,199,0,0,4,19,0,0,2,0,2631,5,1779
"16381","구산동","구산동제2투","대통령선거","서울특별시","은평구",4103,2924,1234,559,689,194,219,0,0,1,11,1,1,0,3,2912,12,1179
"16382","구산동","구산동제3투","대통령선거","서울특별시","은평구",3530,2078,837,425,503,122,132,5,1,2,10,2,1,0,2,2042,36,1452
"16383","구산동","구산동제4투","대통령선거","서울특별시","은평구",1902,1312,562,254,326,69,92,0,0,3,1,0,0,0,1,1308,4,590
"16384","구산동","구산동제5투","대통령선거","서울특별시","은평구",3765,2630,1053,570,667,129,181,3,0,4,15,1,0,0,3,2626,4,1135
"16385","구산동","구산동제6투","대통령선거","서울특별시","은평구",3574,2482,922,633,624,125,147,4,0,0,16,3,0,2,0,2476,6,1092
"16386","갈현제1동","관내사전투표","대통령선거","서울특별시","은평구",4246,4246,1928,801,922,239,315,4,1,3,13,1,0,1,2,4230,16,0
"16387","갈현제1동","갈현제1동제1투","대통령선거","서울특별시","은평구",2865,1740,698,417,378,103,120,3,0,3,7,2,0,0,0,1731,9,1125
"16388","갈현제1동","갈현제1동제2투","대통령선거","서울특별시","은평구",2656,1754,647,442,430,96,121,1,0,2,6,0,0,2,2,1749,5,902
"16389","갈현제1동","갈현제1동제3투","대통령선거","서울특별시","은평구",3298,2121,895,452,477,137,143,3,0,1,2,0,0,2,1,2113,8,1177
"16390","갈현제1동","갈현제1동제4투","대통령선거","서울특별시","은평구",3423,2199,880,518,515,137,133,3,0,0,3,1,0,0,0,2190,9,1224
"16391","갈현제1동","갈현제1동제5투","대통령선거","서울특별시","은평구",3432,2408,1034,475,523,172,182,6,1,2,3,2,1,0,1,2402,6,1024
"16392","진관동","관내사전투표","대통령선거","서울특별시","은평구",7812,7812,3963,1276,1441,486,584,11,0,1,14,6,1,3,2,7788,24,0
"16393","진관동","진관동제1투","대통령선거","서울특별시","은평구",3048,2367,932,514,610,140,143,5,0,3,9,0,1,0,0,2357,10,681
"16394","진관동","진관동제2투","대통령선거","서울특별시","은평구",2827,2258,936,476,538,151,147,0,0,1,4,0,0,0,1,2254,4,569
"16395","진관동","진관동제3투","대통령선거","서울특별시","은평구",2759,2146,917,474,491,139,107,3,1,0,7,0,0,1,0,2140,6,613
"16396","진관동","진관동제4투","대통령선거","서울특별시","은평구",2444,1921,835,379,466,102,126,0,0,1,7,0,0,0,0,1916,5,523
"16397","진관동","진관동제5투","대통령선거","서울특별시","은평구",3031,2408,1056,474,527,181,149,2,1,1,8,0,1,3,2,2405,3,623
"16398","진관동","진관동제6투","대통령선거","서울특별시","은평구",2949,2295,969,490,523,162,139,4,0,0,3,0,1,0,0,2291,4,654
"16399","진관동","진관동제7투","대통령선거","서울특별시","은평구",2835,2224,1002,429,497,167,120,3,0,0,2,0,0,2,0,2222,2,611
"16400","진관동","진관동제8투","대통령선거","서울특별시","은평구",2106,1707,697,373,405,118,95,6,0,2,5,0,0,1,0,1702,5,399
"16401","진관동","진관동제9투","대통령선거","서울특별시","은평구",2799,2294,1093,373,524,145,147,1,0,1,1,4,0,0,0,2289,5,505
"16402","진관동","진관동제10투","대통령선거","서울특별시","은평구",2742,2206,1112,299,488,148,144,5,0,1,2,2,1,0,0,2202,4,536
"16403","진관동","진관동제11투","대통령선거","서울특별시","은평구",1990,959,508,94,186,75,87,1,0,1,3,0,0,0,1,956,3,1031
"16404","불광제1동","관내사전투표","대통령선거","서울특별시","은평구",6157,6157,2960,1025,1293,400,437,4,0,4,10,2,1,3,3,6142,15,0
"16405","불광제1동","불광제1동제1투","대통령선거","서울특별시","은평구",3360,1955,828,425,475,104,107,2,0,1,6,1,0,0,1,1950,5,1405
"16406","불광제1동","불광제1동제2투","대통령선거","서울특별시","은평구",3604,2822,1120,677,656,179,168,6,0,1,3,4,0,1,1,2816,6,782
"16407","불광제1동","불광제1동제3투","대통령선거","서울특별시","은평구",3109,2035,866,426,496,98,129,4,0,0,3,0,1,0,2,2025,10,1074
"16408","불광제1동","불광제1동제4투","대통령선거","서울특별시","은평구",2538,2027,791,479,448,156,131,7,1,1,11,0,0,0,0,2025,2,511
"16409","불광제1동","불광제1동제5투","대통령선거","서울특별시","은평구",3507,2753,1231,476,661,185,182,5,0,0,6,1,1,0,0,2748,5,754
"16410","불광제1동","불광제1동제6투","대통령선거","서울특별시","은평구",2871,2015,818,431,507,120,126,1,0,0,3,0,1,3,0,2010,5,856
"16411","불광제1동","불광제1동제7투","대통령선거","서울특별시","은평구",4563,3346,1384,701,776,233,208,6,0,2,14,0,0,3,2,3329,17,1217
"16412","불광제1동","불광제1동제8투","대통령선거","서울특별시","은평구",3198,2224,900,423,578,133,165,3,0,0,10,2,2,0,0,2216,8,974
"16413","불광제2동","관내사전투표","대통령선거","서울특별시","은평구",4040,4040,1795,795,934,203,266,5,0,3,13,1,1,3,4,4023,17,0
"16414","불광제2동","불광제2동제1투","대통령선거","서울특별시","은평구",2624,1578,593,373,422,91,86,3,1,1,3,0,0,0,0,1573,5,1046
"16415","불광제2동","불광제2동제2투","대통령선거","서울특별시","은평구",2801,1875,752,379,482,104,137,2,0,0,3,3,1,0,2,1865,10,926
"16416","불광제2동","불광제2동제3투","대통령선거","서울특별시","은평구",3018,1948,794,412,478,90,156,3,1,0,6,0,1,0,1,1942,6,1070
"16417","불광제2동","불광제2동제4투","대통령선거","서울특별시","은평구",2417,1485,569,366,351,89,91,3,1,1,4,0,1,2,1,1479,6,932
"16418","불광제2동","불광제2동제5투","대통령선거","서울특별시","은평구",2967,1979,755,458,504,102,128,5,0,3,8,0,1,1,1,1966,13,988
"16419","불광제2동","불광제2동제6투","대통령선거","서울특별시","은평구",2534,1777,692,434,421,101,115,2,0,0,6,4,0,0,0,1775,2,757
"16420","불광제2동","불광제2동제7투","대통령선거","서울특별시","은평구",2890,2036,821,468,510,106,114,4,0,2,4,0,0,2,1,2032,4,854
"16421","대조동","관내사전투표","대통령선거","서울특별시","은평구",4690,4690,2245,763,974,311,338,5,0,8,22,1,2,2,1,4672,18,0
"16422","대조동","대조동제1투","대통령선거","서울특별시","은평구",3539,2308,924,494,534,168,164,2,0,3,6,0,0,0,0,2295,13,1231
"16423","대조동","대조동제2투","대통령선거","서울특별시","은평구",4029,2510,1048,451,646,166,175,3,0,1,7,1,0,1,2,2501,9,1519
"16424","대조동","대조동제3투","대통령선거","서울특별시","은평구",3454,2323,928,480,614,132,146,3,0,1,7,3,0,1,0,2315,8,1131
"16425","대조동","대조동제4투","대통령선거","서울특별시","은평구",3234,2154,906,450,529,101,151,1,0,0,4,0,0,1,1,2144,10,1080
"16426","대조동","대조동제5투","대통령선거","서울특별시","은평구",3061,1972,832,395,469,120,136,2,0,1,3,4,2,1,0,1965,7,1089
"16427","대조동","대조동제6투","대통령선거","서울특별시","은평구",3556,2453,1005,517,570,159,179,4,0,1,5,3,1,2,0,2446,7,1103
"16428","역촌동","관내사전투표","대통령선거","서울특별시","은평구",7487,7487,3735,1170,1517,431,583,5,3,5,16,2,1,5,3,7476,11,0
"16429","역촌동","역촌동제1투","대통령선거","서울특별시","은평구",4292,2523,1146,479,547,145,173,1,0,3,8,0,4,3,0,2509,14,1769
"16430","역촌동","역촌동제2투","대통령선거","서울특별시","은평구",3595,2599,1108,479,636,180,169,6,0,0,7,2,0,2,2,2591,8,996
"16431","역촌동","역촌동제3투","대통령선거","서울특별시","은평구",3013,2114,878,471,493,126,126,6,0,1,3,3,1,0,1,2109,5,899
"16432","역촌동","역촌동제4투","대통령선거","서울특별시","은평구",3749,2448,1080,462,575,139,166,7,1,2,2,1,0,2,0,2437,11,1301
"16433","역촌동","역촌동제5투","대통령선거","서울특별시","은평구",2904,1904,776,372,480,122,139,4,0,2,2,0,1,0,0,1898,6,1000
"16434","역촌동","역촌동제6투","대통령선거","서울특별시","은평구",2633,1795,704,396,471,98,111,4,1,1,1,2,1,1,0,1791,4,838
"16435","역촌동","역촌동제7투","대통령선거","서울특별시","은평구",2916,2036,837,442,510,101,123,3,0,1,4,2,3,2,2,2030,6,880
"16436","역촌동","역촌동제8투","대통령선거","서울특별시","은평구",3734,2639,1204,469,635,143,167,2,0,4,8,0,0,0,0,2632,7,1095
"16437","역촌동","역촌동제9투","대통령선거","서울특별시","은평구",4068,2773,1164,528,683,158,218,2,0,0,5,3,0,0,2,2763,10,1295
"16438","잘못 투입·구분된 투표지","잘못 투입·구분된 투표지","대통령선거","서울특별시","은평구",0,0,0,0,0,0,0,0,0,0,0,0,0,0,0,0,0,0
"16439","거소·선상투표","거소·선상투표","대통령선거","서울특별시","서대문구",460,437,138,71,154,40,16,1,0,0,2,1,2,0,0,425,12,23
"16440","관외사전투표","관외사전투표","대통령선거","서울특별시","서대문구",27115,27074,13155,3713,5258,2210,2490,37,4,13,5,26,3,11,24,26949,125,41
"16441","재외투표","재외투표","대통령선거","서울특별시","서대문구",3546,2699,1549,239,408,112,367,17,1,1,0,0,0,2,0,2696,3,847
"16442","충현동","관내사전투표","대통령선거","서울특별시","서대문구",1568,1568,747,305,328,98,81,3,0,1,0,0,0,1,0,1564,4,0
"16443","충현동","충현동제1투","대통령선거","서울특별시","서대문구",3124,1825,730,444,434,105,101,4,0,0,0,1,1,2,1,1823,2,1299
"16444","충현동","충현동제2투","대통령선거","서울특별시","서대문구",2665,1772,669,447,407,123,103,6,0,4,0,4,0,0,1,1764,8,893
"16445","충현동","충현동제3투","대통령선거","서울특별시","서대문구",933,640,263,156,141,40,38,1,0,0,0,0,0,0,0,639,1,293
"16446","충현동","충현동제4투","대통령선거","서울특별시","서대문구",2673,1957,811,466,423,127,116,6,0,0,0,1,0,0,1,1951,6,716
"16447","충현동","충현동제5투","대통령선거","서울특별시","서대문구",2455,1653,703,341,374,120,105,4,0,0,0,0,0,0,1,1648,5,802
"16448","천연동","관내사전투표","대통령선거","서울특별시","서대문구",2602,2602,1270,455,483,166,209,4,0,0,0,4,0,0,0,2591,11,0
"16449","천연동","천연동제1투","대통령선거","서울특별시","서대문구",2842,1886,724,468,443,141,95,6,0,0,1,1,0,0,1,1880,6,956
"16450","천연동","천연동제2투","대통령선거","서울특별시","서대문구",2868,2185,1028,448,444,117,134,1,1,1,0,1,0,0,5,2180,5,683
"16451","천연동","천연동제3투","대통령선거","서울특별시","서대문구",2485,1889,821,388,416,142,112,2,0,1,1,1,1,0,0,1885,4,596
"16452","천연동","천연동제4투","대통령선거","서울특별시","서대문구",599,459,230,83,86,24,33,0,1,1,0,0,0,0,1,459,0,140
"16453","천연동","천연동제5투","대통령선거","서울특별시","서대문구",3100,2477,1011,577,530,201,145,1,0,1,0,0,1,1,1,2469,8,623
"16454","북아현동","관내사전투표","대통령선거","서울특별시","서대문구",2763,2763,1369,474,513,199,199,2,0,0,1,0,0,0,1,2758,5,0
"16455","북아현동","북아현동제1투","대통령선거","서울특별시","서대문구",2376,1473,573,381,305,96,100,1,0,2,0,0,0,1,1,1460,13,903
"16456","북아현동","북아현동제2투","대통령선거","서울특별시","서대문구",2116,1426,629,296,337,63,89,2,0,0,1,2,0,1,1,1421,5,690
"16457","북아현동","북아현동제3투","대통령선거","서울특별시","서대문구",3034,2369,1058,375,551,207,161,5,1,0,1,0,0,1,2,2362,7,665
"16458","북아현동","북아현동제4투","대통령선거","서울특별시","서대문구",1955,1532,642,284,351,156,96,1,0,0,0,0,0,0,1,1531,1,423
"16459","신촌동","관내사전투표","대통령선거","서울특별시","서대문구",1895,1895,966,186,271,230,232,0,1,0,0,1,0,0,1,1888,7,0
"16460","신촌동","신촌동제1투","대통령선거","서울특별시","서대문구",1658,1181,441,295,223,114,94,3,0,2,0,0,0,0,1,1173,8,477
"16461","신촌동","신촌동제2투","대통령선거","서울특별시","서대문구",2559,1658,692,318,347,142,147,7,0,0,1,0,0,1,0,1655,3,901
"16462","신촌동","신촌동제3투","대통령선거","서울특별시","서대문구",1956,1258,532,263,229,111,114,1,0,0,0,0,0,1,0,1251,7,698
"16463","신촌동","신촌동제4투","대통령선거","서울특별시","서대문구",2697,1923,884,329,357,190,154,0,0,0,0,1,0,0,1,1916,7,774
"16464","신촌동","신촌동제5투","대통령선거","서울특별시","서대문구",2652,1901,892,313,369,158,157,2,0,1,0,1,0,0,4,1897,4,751
"16465","연희동","관내사전투표","대통령선거","서울특별시","서대문구",4171,4171,2012,750,668,326,388,3,0,3,2,0,1,1,3,4157,14,0
"16466","연희동","연희동제1투","대통령선거","서울특별시","서대문구",3336,1910,776,459,412,139,116,3,0,0,0,0,0,1,1,1907,3,1426
"16467","연희동","연희동제2투","대통령선거","서울특별시","서대문구",1985,1510,553,446,296,105,104,1,0,0,0,1,0,0,0,1506,4,475
"16468","연희동","연희동제3투","대통령선거","서울특별시","서대문구",2529,1748,728,438,323,112,134,5,0,1,0,1,0,0,0,1742,6,781
"16469","연희동","연희동제4투","대통령선거","서울특별시","서대문구",3054,2150,901,459,525,99,145,4,0,0,1,0,0,1,4,2139,11,904
"16470","연희동","연희동제5투","대통령선거","서울특별시","서대문구",2202,1560,642,373,356,66,109,0,0,2,1,1,0,1,2,1553,7,642
"16471","연희동","연희동제6투","대통령선거","서울특별시","서대문구",2696,2014,821,421,468,144,140,7,0,2,2,0,0,1,0,2006,8,682
"16472","연희동","연희동제7투","대통령선거","서울특별시","서대문구",2672,1978,767,492,437,143,129,6,0,0,0,0,0,0,0,1974,4,694
"16473","연희동","연희동제8투","대통령선거","서울특별시","서대문구",2727,1977,802,393,382,193,198,1,0,0,0,0,0,0,0,1969,8,750
"16474","연희동","연희동제9투","대통령선거","서울특별시","서대문구",2845,2115,926,359,420,188,209,3,0,1,0,1,1,0,0,2108,7,730
"16475","홍제제1동","관내사전투표","대통령선거","서울특별시","서대문구",1974,1974,947,340,383,125,165,2,0,1,1,0,0,1,2,1967,7,0
"16476","홍제제1동","홍제제1동제1투","대통령선거","서울특별시","서대문구",2604,1670,701,366,371,124,96,1,0,1,1,0,0,2,0,1663,7,934
"16477","홍제제1동","홍제제1동제2투","대통령선거","서울특별시","서대문구",2800,2210,879,487,572,129,122,2,1,4,3,3,1,0,2,2205,5,590
"16478","홍제제1동","홍제제1동제3투","대통령선거","서울특별시","서대문구",2604,1973,845,433,446,107,127,5,2,1,0,0,0,0,0,1966,7,631
"16479","홍제제1동","홍제제1동제4투","대통령선거","서울특별시","서대문구",2263,1618,650,387,373,93,107,1,0,0,1,1,0,1,1,1615,3,645
"16480","홍제제1동","홍제제1동제5투","대통령선거","서울특별시","서대문구",1933,1472,642,309,315,91,101,4,1,1,1,1,1,0,2,1469,3,461
"16481","홍제제1동","홍제제1동제6투","대통령선거","서울특별시","서대문구",1769,1415,642,280,298,123,69,2,0,0,0,1,0,0,0,1415,0,354
"16482","홍제제1동","홍제제1동제7투","대통령선거","서울특별시","서대문구",2030,1505,661,287,308,128,112,0,1,1,0,3,0,0,1,1502,3,525
"16483","홍제제2동","관내사전투표","대통령선거","서울특별시","서대문구",3149,3149,1494,628,584,198,226,5,0,1,2,0,0,0,1,3139,10,0
"16484","홍제제2동","홍제제2동제1투","대통령선거","서울특별시","서대문구",1981,1245,486,282,323,70,66,3,0,1,2,2,0,1,1,1237,8,736
"16485","홍제제2동","홍제제2동제2투","대통령선거","서울특별시","서대문구",2743,2152,841,464,496,204,136,4,1,0,1,1,0,0,1,2149,3,591
"16486","홍제제2동","홍제제2동제3투","대통령선거","서울특별시","서대문구",2243,1682,719,361,395,122,76,2,0,2,0,0,0,0,2,1679,3,561
"16487","홍제제2동","홍제제2동제4투","대통령선거","서울특별시","서대문구",2109,1606,654,332,406,105,97,6,0,2,0,1,0,1,0,1604,2,503
"16488","홍제제3동","관내사전투표","대통령선거","서울특별시","서대문구",2295,2295,1125,356,511,134,147,4,0,1,2,0,0,3,0,2283,12,0
"16489","홍제제3동","홍제제3동제1투","대통령선거","서울특별시","서대문구",2539,1538,574,349,425,68,109,2,0,0,0,0,1,3,2,1533,5,1001
"16490","홍제제3동","홍제제3동제2투","대통령선거","서울특별시","서대문구",2356,1720,714,358,398,126,110,3,0,1,4,3,1,1,1,1720,0,636
"16491","홍제제3동","홍제제3동제3투","대통령선거","서울특별시","서대문구",2642,1965,860,358,486,125,123,2,0,1,0,1,0,1,1,1958,7,677
"16492","홍제제3동","홍제제3동제4투","대통령선거","서울특별시","서대문구",1504,989,379,207,263,68,61,1,0,2,1,1,0,1,0,984,5,515
"16493","홍제제3동","홍제제3동제5투","대통령선거","서울특별시","서대문구",2419,1670,661,403,419,79,95,3,0,1,1,0,0,2,1,1665,5,749
"16494","홍은제1동","관내사전투표","대통령선거","서울특별시","서대문구",3375,3375,1565,605,751,198,232,3,2,4,0,4,2,2,0,3368,7,0
"16495","홍은제1동","홍은제1동제1투","대통령선거","서울특별시","서대문구",2668,1596,679,296,443,67,97,4,0,3,0,0,0,0,1,1590,6,1072
"16496","홍은제1동","홍은제1동제2투","대통령선거","서울특별시","서대문구",2326,1741,732,402,390,102,108,2,0,0,0,0,0,1,1,1738,3,585
"16497","홍은제1동","홍은제1동제3투","대통령선거","서울특별시","서대문구",2802,2188,907,466,502,153,143,5,0,1,0,1,0,1,1,2180,8,614
"16498","홍은제1동","홍은제1동제4투","대통령선거","서울특별시","서대문구",1425,1017,435,218,221,57,78,5,0,1,1,0,0,0,1,1017,0,408
"16499","홍은제1동","홍은제1동제5투","대통령선거","서울특별시","서대문구",2793,2102,825,461,528,130,140,1,0,3,1,3,1,0,1,2094,8,691
"16500","홍은제1동","홍은제1동제6투","대통령선거","서울특별시","서대문구",2713,1889,730,394,512,115,120,5,0,2,0,5,2,0,1,1886,3,824
"16501","홍은제2동","관내사전투표","대통령선거","서울특별시","서대문구",3734,3734,1802,673,750,219,264,4,0,4,0,3,1,1,0,3721,13,0
"16502","홍은제2동","홍은제2동제1투","대통령선거","서울특별시","서대문구",3160,1894,799,408,430,123,117,6,0,1,1,1,0,2,0,1888,6,1266
"16503","홍은제2동","홍은제2동제2투","대통령선거","서울특별시","서대문구",2814,2087,852,467,480,142,131,1,0,4,1,4,0,0,1,2083,4,727
"16504","홍은제2동","홍은제2동제3투","대통령선거","서울특별시","서대문구",3414,2612,1103,626,569,153,134,8,1,2,0,0,0,1,3,2600,12,802
"16505","홍은제2동","홍은제2동제4투","대통령선거","서울특별시","서대문구",2780,1881,817,374,461,103,116,0,0,1,0,0,0,1,1,1874,7,899
"16506","홍은제2동","홍은제2동제5투","대통령선거","서울특별시","서대문구",2988,1973,814,442,450,121,138,2,0,0,1,1,0,0,0,1969,4,1015
"16507","홍은제2동","홍은제2동제6투","대통령선거","서울특별시","서대문구",3237,2188,865,488,490,161,167,2,0,0,2,3,1,0,1,2180,8,1049
"16508","남가좌제1동","관내사전투표","대통령선거","서울특별시","서대문구",3502,3501,1787,516,705,253,217,4,0,1,3,4,0,1,1,3492,9,1
"16509","남가좌제1동","남가좌제1동제1투","대통령선거","서울특별시","서대문구",2652,1904,811,361,441,156,128,2,0,0,1,0,0,0,0,1900,4,748
"16510","남가좌제1동","남가좌제1동제2투","대통령선거","서울특별시","서대문구",2257,1824,835,300,450,130,99,0,0,5,0,0,0,0,0,1819,5,433
"16511","남가좌제1동","남가좌제1동제3투","대통령선거","서울특별시","서대문구",2683,2129,957,322,502,190,147,2,0,0,2,1,0,0,1,2124,5,554
"16512","남가좌제1동","남가좌제1동제4투","대통령선거","서울특별시","서대문구",1911,1374,524,346,337,96,60,4,0,0,2,0,0,1,0,1370,4,537
"16513","남가좌제2동","관내사전투표","대통령선거","서울특별시","서대문구",3272,3272,1604,496,637,209,292,3,1,1,4,1,0,1,3,3252,20,0
"16514","남가좌제2동","남가좌제2동제1투","대통령선거","서울특별시","서대문구",2776,1623,628,362,389,105,122,6,0,0,1,0,0,0,1,1614,9,1153
"16515","남가좌제2동","남가좌제2동제2투","대통령선거","서울특별시","서대문구",2193,1551,679,349,355,78,79,0,0,1,1,1,0,0,1,1544,7,642
"16516","남가좌제2동","남가좌제2동제3투","대통령선거","서울특별시","서대문구",2580,2024,786,519,474,124,110,1,0,0,1,0,1,1,2,2019,5,556
"16517","남가좌제2동","남가좌제2동제4투","대통령선거","서울특별시","서대문구",1225,890,380,163,210,66,61,2,0,1,0,1,1,1,0,886,4,335
"16518","남가좌제2동","남가좌제2동제5투","대통령선거","서울특별시","서대문구",2634,2143,929,440,489,145,123,3,2,3,0,2,1,0,1,2138,5,491
"16519","남가좌제2동","남가좌제2동제6투","대통령선거","서울특별시","서대문구",3061,2019,841,359,470,141,175,9,0,1,0,5,0,0,1,2002,17,1042
"16520","북가좌제1동","관내사전투표","대통령선거","서울특별시","서대문구",3926,3926,1962,634,785,272,258,4,0,0,2,0,0,0,0,3917,9,0
"16521","북가좌제1동","북가좌제1동제1투","대통령선거","서울특별시","서대문구",2560,1969,795,422,485,137,116,1,1,2,0,1,0,1,1,1962,7,591
"16522","북가좌제1동","북가좌제1동제2투","대통령선거","서울특별시","서대문구",1946,1386,563,289,355,79,93,2,0,1,1,0,0,0,1,1384,2,560
"16523","북가좌제1동","북가좌제1동제3투","대통령선거","서울특별시","서대문구",2115,1461,587,330,349,85,96,3,2,3,0,0,0,1,2,1458,3,654
"16524","북가좌제1동","북가좌제1동제4투","대통령선거","서울특별시","서대문구",2769,2257,1043,374,505,199,120,7,0,0,0,1,0,0,2,2251,6,512
"16525","북가좌제1동","북가좌제1동제5투","대통령선거","서울특별시","서대문구",1833,1359,542,253,361,120,72,4,0,1,0,1,0,0,1,1355,4,474
"16526","북가좌제2동","관내사전투표","대통령선거","서울특별시","서대문구",4315,4315,2135,715,882,244,305,2,0,2,4,3,1,1,3,4297,18,0
"16527","북가좌제2동","북가좌제2동제1투","대통령선거","서울특별시","서대문구",3595,2337,1026,426,574,157,143,2,0,0,0,0,0,0,2,2330,7,1258
"16528","북가좌제2동","북가좌제2동제2투","대통령선거","서울특별시","서대문구",3167,2209,947,414,551,128,154,7,0,1,0,0,0,0,2,2204,5,958
"16529","북가좌제2동","북가좌제2동제3투","대통령선거","서울특별시","서대문구",2301,1611,647,355,420,86,93,3,0,2,2,0,0,0,0,1608,3,690
"16530","북가좌제2동","북가좌제2동제4투","대통령선거","서울특별시","서대문구",3036,2392,976,490,602,159,143,7,0,0,1,3,0,1,1,2383,9,644
"16531","북가좌제2동","북가좌제2동제5투","대통령선거","서울특별시","서대문구",2603,1852,804,354,441,108,122,3,1,1,1,1,1,0,3,1840,12,751
"16532","북가좌제2동","북가좌제2동제6투","대통령선거","서울특별시","서대문구",3376,2290,974,426,585,139,151,4,0,0,0,2,1,1,3,2286,4,1086
"16533","북가좌제2동","북가좌제2동제7투","대통령선거","서울특별시","서대문구",3600,2675,1139,485,662,179,193,1,0,0,0,0,0,1,4,2664,11,925
"16534","잘못 투입·구분된 투표지","잘못 투입·구분된 투표지","대통령선거","서울특별시","서대문구",0,23,13,1,3,3,3,0,0,0,0,0,0,0,0,23,0,-23
"16535","거소·선상투표","거소·선상투표","대통령선거","서울특별시","마포구",434,412,142,79,136,21,13,3,0,0,0,0,2,1,1,398,14,22
"16536","관외사전투표","관외사전투표","대통령선거","서울특별시","마포구",30862,30811,15188,4250,5765,2593,2771,29,6,9,5,16,12,13,24,30681,130,51
"16537","재외투표","재외투표","대통령선거","서울특별시","마포구",4422,3481,2079,304,554,114,407,14,0,1,0,1,1,0,0,3475,6,941
"16538","공덕동","관내사전투표","대통령선거","서울특별시","마포구",3162,3162,1555,552,616,225,201,2,0,4,0,0,0,0,0,3155,7,0
"16539","공덕동","공덕동제1투","대통령선거","서울특별시","마포구",2545,1779,729,389,479,86,87,0,1,2,0,0,0,0,1,1774,5,766
"16540","공덕동","공덕동제2투","대통령선거","서울특별시","마포구",3603,2776,1119,623,645,240,138,0,0,2,0,1,0,0,1,2769,7,827
"16541","공덕동","공덕동제3투","대통령선거","서울특별시","마포구",2135,1438,606,303,367,66,85,3,0,2,0,0,0,0,2,1434,4,697
"16542","공덕동","공덕동제4투","대통령선거","서울특별시","마포구",3486,1860,841,338,414,148,108,4,0,3,0,0,0,1,1,1858,2,1626
"16543","공덕동","공덕동제5투","대통령선거","서울특별시","마포구",2656,1981,859,412,467,115,113,5,0,1,0,1,0,0,1,1974,7,675
"16544","공덕동","공덕동제6투","대통령선거","서울특별시","마포구",1961,1552,604,340,396,113,93,1,0,0,2,0,0,1,1,1551,1,409
"16545","공덕동","공덕동제7투","대통령선거","서울특별시","마포구",2948,2106,942,400,446,155,150,5,1,0,0,0,0,0,1,2100,6,842
"16546","공덕동","공덕동제8투","대통령선거","서울특별시","마포구",2811,2307,971,465,500,222,137,5,0,1,0,0,2,0,0,2303,4,504
"16547","공덕동","공덕동제9투","대통령선거","서울특별시","마포구",3328,2463,986,531,543,237,158,2,0,1,0,0,0,0,2,2460,3,865
"16548","아현동","관내사전투표","대통령선거","서울특별시","마포구",3928,3928,1900,597,730,392,295,3,1,0,0,1,0,0,2,3921,7,0
"16549","아현동","아현동제1투","대통령선거","서울특별시","마포구",2397,1386,526,369,287,135,67,0,0,0,1,0,0,0,0,1385,1,1011
"16550","아현동","아현동제2투","대통령선거","서울특별시","마포구",1917,1517,662,320,315,119,95,0,0,0,0,0,0,1,0,1512,5,400
"16551","아현동","아현동제3투","대통령선거","서울특별시","마포구",2376,1899,851,369,379,190,102,3,0,2,0,1,0,0,0,1897,2,477
"16552","아현동","아현동제4투","대통령선거","서울특별시","마포구",2190,1393,545,373,292,84,79,9,1,0,0,1,0,2,1,1387,6,797
"16553","아현동","아현동제5투","대통령선거","서울특별시","마포구",3026,2444,1006,427,584,250,165,1,1,3,0,0,1,2,0,2440,4,582
"16554","아현동","아현동제6투","대통령선거","서울특별시","마포구",3458,2825,1190,514,603,341,162,5,0,3,0,1,0,0,0,2819,6,633
"16555","도화동","관내사전투표","대통령선거","서울특별시","마포구",4163,4163,2019,679,799,350,309,3,0,0,2,0,0,0,0,4161,2,0
"16556","도화동","도화동제1투","대통령선거","서울특별시","마포구",2367,1397,611,295,292,108,78,4,0,1,0,0,1,1,2,1393,4,970
"16557","도화동","도화동제2투","대통령선거","서울특별시","마포구",2113,1633,601,356,414,148,110,2,0,0,0,0,0,0,0,1631,2,480
"16558","도화동","도화동제3투","대통령선거","서울특별시","마포구",1735,1412,510,370,300,155,62,5,1,1,0,0,0,2,1,1407,5,323
"16559","도화동","도화동제4투","대통령선거","서울특별시","마포구",1778,1478,610,297,335,144,82,5,1,0,0,0,0,0,0,1474,4,300
"16560","도화동","도화동제5투","대통령선거","서울특별시","마포구",1839,1284,471,321,358,62,60,3,0,1,0,1,1,1,0,1279,5,555
"16561","도화동","도화동제6투","대통령선거","서울특별시","마포구",2357,1912,669,515,435,178,102,7,0,1,1,0,0,3,0,1911,1,445
"16562","도화동","도화동제7투","대통령선거","서울특별시","마포구",1982,1520,628,329,334,108,104,5,0,2,1,0,0,0,0,1511,9,462
"16563","용강동","관내사전투표","대통령선거","서울특별시","마포구",3176,3176,1560,540,581,275,206,5,0,0,0,1,0,1,1,3170,6,0
"16564","용강동","용강동제1투","대통령선거","서울특별시","마포구",2910,2216,973,418,500,197,119,1,0,0,0,0,0,1,1,2210,6,694
"16565","용강동","용강동제2투","대통령선거","서울특별시","마포구",2271,1678,657,367,400,137,105,2,0,2,0,0,0,1,1,1672,6,593
"16566","용강동","용강동제3투","대통령선거","서울특별시","마포구",2821,2162,889,476,445,218,124,3,0,1,0,0,1,0,0,2157,5,659
"16567","용강동","용강동제4투","대통령선거","서울특별시","마포구",2237,1816,740,401,419,154,93,2,0,0,0,0,2,0,0,1811,5,421
"16568","용강동","용강동제5투","대통령선거","서울특별시","마포구",2363,1848,763,424,420,126,102,3,0,1,2,1,0,1,0,1843,5,515
"16569","대흥동","관내사전투표","대통령선거","서울특별시","마포구",1710,1710,839,262,282,140,174,1,0,1,0,2,0,2,3,1706,4,0
"16570","대흥동","대흥동제1투","대통령선거","서울특별시","마포구",2261,1634,675,365,375,119,92,2,0,0,1,0,0,2,1,1632,2,627
"16571","대흥동","대흥동제2투","대통령선거","서울특별시","마포구",1275,850,337,184,191,73,60,0,0,0,0,0,0,1,0,846,4,425
"16572","대흥동","대흥동제3투","대통령선거","서울특별시","마포구",1747,843,346,168,165,68,87,1,0,1,0,0,1,0,0,837,6,904
"16573","대흥동","대흥동제4투","대통령선거","서울특별시","마포구",2584,1732,776,353,338,123,125,5,0,2,0,1,1,1,1,1726,6,852
"16574","염리동","관내사전투표","대통령선거","서울특별시","마포구",2055,2055,992,357,408,137,148,2,0,1,0,2,0,3,1,2051,4,0
"16575","염리동","염리동제1투","대통령선거","서울특별시","마포구",1955,1173,450,278,253,99,73,11,0,0,0,0,0,0,1,1165,8,782
"16576","염리동","염리동제2투","대통령선거","서울특별시","마포구",1557,881,332,242,166,67,68,0,0,1,0,0,0,1,0,877,4,676
"16577","염리동","염리동제3투","대통령선거","서울특별시","마포구",1403,999,434,192,228,67,71,0,0,0,0,1,1,0,0,994,5,404
"16578","염리동","염리동제4투","대통령선거","서울특별시","마포구",1700,1316,540,302,283,93,89,6,0,2,0,0,0,0,0,1315,1,384
"16579","신수동","관내사전투표","대통령선거","서울특별시","마포구",2941,2941,1378,484,579,226,248,9,0,1,0,3,0,2,1,2931,10,0
"16580","신수동","신수동제1투","대통령선거","서울특별시","마포구",2920,1938,840,380,431,154,124,3,0,0,0,0,0,1,1,1934,4,982
"16581","신수동","신수동제2투","대통령선거","서울특별시","마포구",2041,1514,581,341,337,140,100,1,2,2,0,0,0,1,1,1506,8,527
"16582","신수동","신수동제3투","대통령선거","서울특별시","마포구",1932,1383,559,272,326,122,100,0,0,1,0,0,1,0,0,1381,2,549
"16583","신수동","신수동제4투","대통령선거","서울특별시","마포구",3090,2372,931,540,524,191,169,6,0,3,0,1,0,0,1,2366,6,718
"16584","신수동","신수동제5투","대통령선거","서울특별시","마포구",2873,2302,1026,481,484,185,114,2,0,2,0,0,0,1,1,2296,6,571
"16585","서강동","관내사전투표","대통령선거","서울특별시","마포구",3770,3770,1875,543,693,307,333,3,0,0,0,0,0,0,1,3755,15,0
"16586","서강동","서강동제1투","대통령선거","서울특별시","마포구",2458,1662,716,341,313,166,116,5,0,0,0,0,0,0,0,1657,5,796
"16587","서강동","서강동제2투","대통령선거","서울특별시","마포구",2686,2140,847,453,509,180,144,2,0,0,0,0,0,0,1,2136,4,546
"16588","서강동","서강동제3투","대통령선거","서울특별시","마포구",2813,2147,929,411,430,168,196,1,0,0,0,2,1,0,0,2138,9,666
"16589","서강동","서강동제4투","대통령선거","서울특별시","마포구",1784,1329,626,202,251,105,138,1,0,2,0,1,0,1,1,1328,1,455
"16590","서강동","서강동제5투","대통령선거","서울특별시","마포구",2726,2046,902,365,392,157,216,3,0,2,0,0,0,0,1,2038,8,680
"16591","서강동","서강동제6투","대통령선거","서울특별시","마포구",3163,2530,990,557,566,248,152,8,0,0,0,0,0,0,1,2522,8,633
"16592","서교동","관내사전투표","대통령선거","서울특별시","마포구",3406,3406,1821,449,529,195,388,4,0,1,1,1,0,3,3,3395,11,0
"16593","서교동","서교동제1투","대통령선거","서울특별시","마포구",1822,1227,525,278,238,82,92,3,0,0,0,0,0,1,0,1219,8,595
"16594","서교동","서교동제2투","대통령선거","서울특별시","마포구",3181,2310,912,535,502,187,158,7,0,0,1,2,0,1,0,2305,5,871
"16595","서교동","서교동제3투","대통령선거","서울특별시","마포구",2336,1733,818,307,324,125,147,0,0,1,0,1,0,1,1,1725,8,603
"16596","서교동","서교동제4투","대통령선거","서울특별시","마포구",3400,2157,1045,374,403,130,193,2,0,1,0,1,0,1,0,2150,7,1243
"16597","서교동","서교동제5투","대통령선거","서울특별시","마포구",1597,1120,489,225,242,72,87,1,0,0,1,0,0,1,1,1119,1,477
"16598","서교동","서교동제6투","대통령선거","서울특별시","마포구",1771,1268,550,256,228,100,123,2,0,1,1,1,0,0,1,1263,5,503
"16599","서교동","서교동제7투","대통령선거","서울특별시","마포구",2336,1697,774,302,323,131,156,1,0,0,0,1,0,1,3,1692,5,639
"16600","합정동","관내사전투표","대통령선거","서울특별시","마포구",4330,4330,2211,526,758,312,504,9,0,2,0,1,1,0,2,4326,4,0
"16601","합정동","합정동제1투","대통령선거","서울특별시","마포구",2033,1452,677,230,303,100,131,4,0,0,1,0,0,0,2,1448,4,581
"16602","합정동","합정동제2투","대통령선거","서울특별시","마포구",2155,1569,700,311,340,94,116,3,0,2,0,0,0,0,0,1566,3,586
"16603","합정동","합정동제3투","대통령선거","서울특별시","마포구",3141,1934,850,355,413,146,155,6,1,0,0,0,0,2,0,1928,6,1207
"16604","합정동","합정동제4투","대통령선거","서울특별시","마포구",2254,1634,652,368,345,107,139,7,1,2,0,1,0,0,1,1623,11,620
"16605","합정동","합정동제5투","대통령선거","서울특별시","마포구",2370,1757,750,373,347,113,158,5,0,1,1,1,0,1,0,1750,7,613
"16606","망원1동","관내사전투표","대통령선거","서울특별시","마포구",3740,3740,1946,501,654,199,416,2,1,3,0,2,0,1,4,3729,11,0
"16607","망원1동","망원1동제1투","대통령선거","서울특별시","마포구",2850,1753,756,357,377,111,140,1,0,1,1,2,0,0,1,1747,6,1097
"16608","망원1동","망원1동제2투","대통령선거","서울특별시","마포구",2943,2108,937,440,399,124,185,8,0,1,0,2,1,0,1,2098,10,835
"16609","망원1동","망원1동제3투","대통령선거","서울특별시","마포구",2721,1904,838,347,440,100,164,1,1,2,1,3,1,1,2,1901,3,817
"16610","망원1동","망원1동제4투","대통령선거","서울특별시","마포구",3256,2328,1036,458,504,115,198,4,1,0,0,1,2,0,1,2320,8,928
"16611","망원1동","망원1동제5투","대통령선거","서울특별시","마포구",1909,1428,624,279,340,89,86,2,0,0,1,1,0,1,1,1424,4,481
"16612","망원2동","관내사전투표","대통령선거","서울특별시","마포구",3047,3047,1624,400,537,176,291,3,0,4,0,2,1,1,1,3040,7,0
"16613","망원2동","망원2동제1투","대통령선거","서울특별시","마포구",2601,1820,786,388,401,100,131,6,0,1,0,1,0,0,1,1815,5,781
"16614","망원2동","망원2동제2투","대통령선거","서울특별시","마포구",2074,1582,700,325,336,101,106,0,0,6,0,0,0,0,0,1574,8,492
"16615","망원2동","망원2동제3투","대통령선거","서울특별시","마포구",2767,2053,897,427,449,112,151,2,0,2,2,1,2,1,0,2046,7,714
"16616","망원2동","망원2동제4투","대통령선거","서울특별시","마포구",2651,1950,876,398,416,96,144,1,0,3,0,3,1,2,2,1942,8,701
"16617","망원2동","망원2동제5투","대통령선거","서울특별시","마포구",2120,1631,766,305,316,112,119,2,0,1,1,1,0,0,3,1626,5,489
"16618","연남동","관내사전투표","대통령선거","서울특별시","마포구",3271,3271,1740,409,539,195,369,4,1,3,1,1,0,0,0,3262,9,0
"16619","연남동","연남동제1투","대통령선거","서울특별시","마포구",2594,1675,765,355,302,109,133,2,0,0,0,0,1,0,1,1668,7,919
"16620","연남동","연남동제2투","대통령선거","서울특별시","마포구",2235,1604,751,277,291,102,168,4,1,1,0,0,0,2,2,1599,5,631
"16621","연남동","연남동제3투","대통령선거","서울특별시","마포구",2922,2109,966,441,408,127,160,1,1,0,0,0,0,0,1,2105,4,813
"16622","연남동","연남동제4투","대통령선거","서울특별시","마포구",3142,2320,1034,500,456,132,184,0,0,2,0,2,0,1,4,2315,5,822
"16623","성산1동","관내사전투표","대통령선거","서울특별시","마포구",2338,2338,1257,286,395,162,222,4,0,1,0,2,0,0,2,2331,7,0
"16624","성산1동","성산1동제1투","대통령선거","서울특별시","마포구",2384,1496,658,282,333,94,119,1,0,2,1,0,1,1,0,1492,4,888
"16625","성산1동","성산1동제2투","대통령선거","서울특별시","마포구",2874,2111,977,361,460,102,193,5,0,1,1,4,0,0,0,2104,7,763
"16626","성산1동","성산1동제3투","대통령선거","서울특별시","마포구",2206,1585,749,307,280,94,144,3,0,1,0,1,0,0,0,1579,6,621
"16627","성산1동","성산1동제4투","대통령선거","서울특별시","마포구",2530,1755,741,381,399,108,118,2,0,0,0,1,0,0,1,1751,4,775
"16628","성산1동","성산1동제5투","대통령선거","서울특별시","마포구",2618,1867,835,346,419,98,156,4,0,1,0,3,0,1,2,1865,2,751
"16629","성산2동","관내사전투표","대통령선거","서울특별시","마포구",4692,4692,2375,661,858,339,427,5,1,7,4,4,1,1,2,4685,7,0
"16630","성산2동","성산2동제1투","대통령선거","서울특별시","마포구",2790,2245,907,503,512,167,140,3,1,0,0,1,0,0,4,2238,7,545
"16631","성산2동","성산2동제2투","대통령선거","서울특별시","마포구",3316,2209,928,424,535,127,172,2,1,0,0,3,0,4,0,2196,13,1107
"16632","성산2동","성산2동제3투","대통령선거","서울특별시","마포구",3380,2441,1111,433,560,138,191,1,0,0,0,1,0,1,0,2436,5,939
"16633","성산2동","성산2동제4투","대통령선거","서울특별시","마포구",2904,2177,1031,395,458,161,122,1,0,1,0,1,0,1,1,2172,5,727
"16634","성산2동","성산2동제5투","대통령선거","서울특별시","마포구",2005,1408,598,297,320,88,92,1,0,0,1,0,1,1,1,1400,8,597
"16635","성산2동","성산2동제6투","대통령선거","서울특별시","마포구",1632,1159,477,287,289,36,51,1,0,2,0,1,1,2,4,1151,8,473
"16636","성산2동","성산2동제7투","대통령선거","서울특별시","마포구",2470,2075,977,331,434,180,140,2,0,2,0,3,0,0,2,2071,4,395
"16637","성산2동","성산2동제8투","대통령선거","서울특별시","마포구",2921,2305,1063,400,490,171,170,5,0,2,0,0,1,0,0,2302,3,616
"16638","성산2동","성산2동제9투","대통령선거","서울특별시","마포구",2725,2122,1001,375,446,148,142,2,0,1,0,1,1,0,1,2118,4,603
"16639","상암동","관내사전투표","대통령선거","서울특별시","마포구",4065,4065,2254,504,635,292,362,4,0,0,0,2,1,2,2,4058,7,0
"16640","상암동","상암동제1투","대통령선거","서울특별시","마포구",2482,1698,754,344,354,109,119,3,0,1,0,6,0,0,1,1691,7,784
"16641","상암동","상암동제2투","대통령선거","서울특별시","마포구",2473,1829,777,405,416,109,107,5,0,2,0,0,0,0,2,1823,6,644
"16642","상암동","상암동제3투","대통령선거","서울특별시","마포구",1943,1623,760,285,364,128,80,0,0,0,0,0,0,0,0,1617,6,320
"16643","상암동","상암동제4투","대통령선거","서울특별시","마포구",2919,2443,1084,523,511,196,118,3,0,0,0,2,0,2,0,2439,4,476
"16644","상암동","상암동제5투","대통령선거","서울특별시","마포구",2717,2206,1024,385,492,154,140,3,0,1,0,0,0,0,1,2200,6,511
"16645","상암동","상암동제6투","대통령선거","서울특별시","마포구",2747,2157,998,333,494,151,168,5,0,0,2,0,1,0,2,2154,3,590
"16646","상암동","상암동제7투","대통령선거","서울특별시","마포구",3176,2586,1260,387,557,172,191,3,0,3,1,1,1,0,3,2579,7,590
"16647","잘못 투입·구분된 투표지","잘못 투입·구분된 투표지","대통령선거","서울특별시","마포구",0,1,1,0,0,0,0,0,0,0,0,0,0,0,0,1,0,-1
"16648","거소·선상투표","거소·선상투표","대통령선거","서울특별시","양천구",487,460,171,66,165,24,15,1,2,1,2,1,1,0,1,450,10,27
"16649","관외사전투표","관외사전투표","대통령선거","서울특별시","양천구",34400,34398,16175,5092,7533,2746,2536,38,6,18,8,8,13,10,44,34227,171,2
"16650","재외투표","재외투표","대통령선거","서울특별시","양천구",4288,3333,1949,241,557,162,401,10,0,1,1,0,1,0,1,3324,9,955
"16651","목1동","관내사전투표","대통령선거","서울특별시","양천구",4403,4403,2069,700,901,419,295,6,0,0,0,2,1,1,3,4397,6,0
"16652","목1동","목1동제1투","대통령선거","서울특별시","양천구",2866,2213,922,457,517,172,134,6,0,0,0,1,0,0,0,2209,4,653
"16653","목1동","목1동제2투","대통령선거","서울특별시","양천구",3085,2461,988,525,589,238,114,1,0,0,0,0,0,0,1,2456,5,624
"16654","목1동","목1동제3투","대통령선거","서울특별시","양천구",3348,2531,1036,516,612,194,144,7,0,1,1,2,0,2,4,2519,12,817
"16655","목1동","목1동제4투","대통령선거","서울특별시","양천구",2644,2196,961,424,470,189,139,9,0,0,0,1,0,0,0,2193,3,448
"16656","목1동","목1동제5투","대통령선거","서울특별시","양천구",3041,2471,999,478,591,229,162,5,0,0,0,0,0,0,1,2465,6,570
"16657","목1동","목1동제6투","대통령선거","서울특별시","양천구",2822,2187,739,578,555,210,96,4,0,0,0,0,1,0,0,2183,4,635
"16658","목2동","관내사전투표","대통령선거","서울특별시","양천구",5701,5701,2798,904,1121,414,445,7,0,0,0,0,0,3,1,5693,8,0
"16659","목2동","목2동제1투","대통령선거","서울특별시","양천구",2840,1863,856,344,397,120,137,1,0,0,0,1,0,0,0,1856,7,977
"16660","목2동","목2동제2투","대통령선거","서울특별시","양천구",2614,1913,682,453,456,186,121,4,0,2,0,0,0,1,4,1909,4,701
"16661","목2동","목2동제3투","대통령선거","서울특별시","양천구",2644,1952,858,393,386,147,145,5,0,2,2,2,1,2,2,1945,7,692
"16662","목2동","목2동제4투","대통령선거","서울특별시","양천구",2587,2011,837,383,492,185,110,1,0,0,0,0,0,0,1,2009,2,576
"16663","목2동","목2동제5투","대통령선거","서울특별시","양천구",2368,1773,770,328,414,134,121,1,0,3,0,0,0,0,0,1771,2,595
"16664","목2동","목2동제6투","대통령선거","서울특별시","양천구",2786,1964,860,398,406,158,123,6,0,0,0,2,2,1,4,1960,4,822
"16665","목2동","목2동제7투","대통령선거","서울특별시","양천구",2380,1784,763,328,440,121,123,1,0,0,0,2,0,2,0,1780,4,596
"16666","목3동","관내사전투표","대통령선거","서울특별시","양천구",3165,3165,1408,714,618,209,188,5,0,9,0,0,1,0,2,3154,11,0
"16667","목3동","목3동제1투","대통령선거","서울특별시","양천구",2126,1687,538,455,408,197,80,1,0,0,0,0,0,1,0,1680,7,439
"16668","목3동","목3동제2투","대통령선거","서울특별시","양천구",2810,1839,797,399,372,141,118,3,1,2,0,0,0,0,0,1833,6,971
"16669","목3동","목3동제3투","대통령선거","서울특별시","양천구",2785,1744,709,401,406,116,100,0,0,3,0,1,1,1,1,1739,5,1041
"16670","목3동","목3동제4투","대통령선거","서울특별시","양천구",2698,1841,797,325,440,124,142,2,0,1,0,2,0,0,3,1836,5,857
"16671","목3동","목3동제5투","대통령선거","서울특별시","양천구",2696,2045,847,428,493,148,110,2,0,3,1,2,0,1,1,2036,9,651
"16672","목4동","관내사전투표","대통령선거","서울특별시","양천구",4215,4215,2029,690,818,336,313,6,0,2,2,3,0,2,5,4206,9,0
"16673","목4동","목4동제1투","대통령선거","서울특별시","양천구",2626,1789,760,377,423,114,106,2,0,0,0,0,0,0,1,1783,6,837
"16674","목4동","목4동제2투","대통령선거","서울특별시","양천구",2240,1542,640,318,386,105,81,1,0,3,0,0,0,0,0,1534,8,698
"16675","목4동","목4동제3투","대통령선거","서울특별시","양천구",2875,2125,865,445,464,186,150,4,0,2,3,0,0,0,1,2120,5,750
"16676","목4동","목4동제4투","대통령선거","서울특별시","양천구",2663,1962,860,359,443,133,145,4,1,7,1,1,1,0,1,1956,6,701
"16677","목4동","목4동제5투","대통령선거","서울특별시","양천구",2629,1927,743,397,497,160,110,1,0,8,0,0,0,0,2,1918,9,702
"16678","목4동","목4동제6투","대통령선거","서울특별시","양천구",2888,2254,1006,415,501,165,153,3,0,2,1,3,0,1,0,2250,4,634
"16679","목5동","관내사전투표","대통령선거","서울특별시","양천구",5678,5678,2525,1076,1202,481,368,11,0,2,3,0,0,2,1,5671,7,0
"16680","목5동","목5동제1투","대통령선거","서울특별시","양천구",2351,1809,694,396,433,172,100,4,0,1,2,2,0,0,1,1805,4,542
"16681","목5동","목5동제2투","대통령선거","서울특별시","양천구",2987,2468,959,553,589,224,132,2,0,0,0,1,0,2,0,2462,6,519
"16682","목5동","목5동제3투","대통령선거","서울특별시","양천구",2881,2266,870,528,511,217,121,11,0,1,0,0,1,1,0,2261,5,615
"16683","목5동","목5동제4투","대통령선거","서울특별시","양천구",2476,2082,724,575,474,209,93,1,0,0,0,1,0,0,1,2078,4,394
"16684","목5동","목5동제5투","대통령선거","서울특별시","양천구",2658,1966,738,462,440,205,115,1,0,0,0,0,0,1,2,1964,2,692
"16685","목5동","목5동제6투","대통령선거","서울특별시","양천구",1999,1699,615,404,400,177,96,2,0,0,0,0,0,1,1,1696,3,300
"16686","목5동","목5동제7투","대통령선거","서울특별시","양천구",2658,2188,756,512,585,226,100,2,0,0,2,0,0,1,0,2184,4,470
"16687","목5동","목5동제8투","대통령선거","서울특별시","양천구",2291,1880,742,408,409,193,123,1,1,0,0,0,0,0,0,1877,3,411
"16688","목5동","목5동제9투","대통령선거","서울특별시","양천구",2937,2543,1098,435,586,234,182,0,0,0,0,0,1,2,0,2538,5,394
"16689","신월1동","관내사전투표","대통령선거","서울특별시","양천구",2886,2886,1285,593,687,136,153,1,0,10,0,1,1,0,2,2869,17,0
"16690","신월1동","신월1동제1투","대통령선거","서울특별시","양천구",3373,2039,792,437,568,125,95,3,1,3,2,1,0,0,1,2028,11,1334
"16691","신월1동","신월1동제2투","대통령선거","서울특별시","양천구",3057,1916,754,437,496,100,116,1,0,4,0,2,0,0,1,1911,5,1141
"16692","신월1동","신월1동제3투","대통령선거","서울특별시","양천구",2445,1568,646,337,406,81,80,2,0,5,0,1,0,4,2,1564,4,877
"16693","신월1동","신월1동제4투","대통령선거","서울특별시","양천구",2896,1779,698,409,494,86,79,3,0,2,0,0,0,1,2,1774,5,1117
"16694","신월1동","신월1동제5투","대통령선거","서울특별시","양천구",3374,2335,962,482,585,144,146,3,0,2,2,0,1,0,0,2327,8,1039
"16695","신월2동","관내사전투표","대통령선거","서울특별시","양천구",3179,3179,1382,667,742,197,167,5,0,3,2,5,0,1,1,3172,7,0
"16696","신월2동","신월2동제1투","대통령선거","서울특별시","양천구",2854,1922,781,396,475,153,107,0,0,1,0,0,1,0,0,1914,8,932
"16697","신월2동","신월2동제2투","대통령선거","서울특별시","양천구",1992,1422,552,335,371,88,64,0,0,3,0,0,0,0,1,1414,8,570
"16698","신월2동","신월2동제3투","대통령선거","서울특별시","양천구",3738,2907,1201,624,696,210,157,4,2,2,0,0,1,0,4,2901,6,831
"16699","신월2동","신월2동제4투","대통령선거","서울특별시","양천구",2971,2182,945,466,528,136,97,2,0,1,0,2,0,0,0,2177,5,789
"16700","신월2동","신월2동제5투","대통령선거","서울특별시","양천구",2716,1809,738,378,448,131,102,5,0,1,1,0,0,0,1,1805,4,907
"16701","신월3동","관내사전투표","대통령선거","서울특별시","양천구",2325,2325,1009,477,569,124,122,7,0,1,0,0,0,4,0,2313,12,0
"16702","신월3동","신월3동제1투","대통령선거","서울특별시","양천구",2747,1479,574,312,432,68,77,5,1,2,0,0,1,0,0,1472,7,1268
"16703","신월3동","신월3동제2투","대통령선거","서울특별시","양천구",2652,1674,702,311,427,118,106,2,0,0,0,0,0,0,1,1667,7,978
"16704","신월3동","신월3동제3투","대통령선거","서울특별시","양천구",2674,1574,649,337,421,78,78,0,0,3,0,2,0,1,2,1571,3,1100
"16705","신월3동","신월3동제4투","대통령선거","서울특별시","양천구",2925,1864,697,435,495,120,96,2,0,1,0,1,2,0,4,1853,11,1061
"16706","신월4동","관내사전투표","대통령선거","서울특별시","양천구",2920,2920,1369,564,632,182,153,1,1,2,1,0,2,1,2,2910,10,0
"16707","신월4동","신월4동제1투","대통령선거","서울특별시","양천구",3392,2466,1050,490,605,165,142,2,1,3,0,0,0,0,3,2461,5,926
"16708","신월4동","신월4동제2투","대통령선거","서울특별시","양천구",2861,2149,896,477,520,112,134,2,0,2,1,2,1,0,1,2148,1,712
"16709","신월4동","신월4동제3투","대통령선거","서울특별시","양천구",3388,2445,1011,508,627,136,142,3,0,3,0,1,1,1,1,2434,11,943
"16710","신월4동","신월4동제4투","대통령선거","서울특별시","양천구",2331,1685,713,292,436,118,117,0,0,1,0,0,0,1,2,1680,5,646
"16711","신월5동","관내사전투표","대통령선거","서울특별시","양천구",3284,3284,1528,621,668,207,223,2,1,1,1,8,3,1,2,3266,18,0
"16712","신월5동","신월5동제1투","대통령선거","서울특별시","양천구",3049,2186,917,444,504,153,153,1,2,0,0,3,0,2,3,2182,4,863
"16713","신월5동","신월5동제2투","대통령선거","서울특별시","양천구",3285,2156,860,443,579,138,109,10,0,1,1,2,2,0,4,2149,7,1129
"16714","신월5동","신월5동제3투","대통령선거","서울특별시","양천구",3066,1979,793,406,505,135,127,0,0,0,0,0,0,0,0,1966,13,1087
"16715","신월6동","관내사전투표","대통령선거","서울특별시","양천구",1896,1896,934,285,417,115,134,0,0,0,1,2,0,1,1,1890,6,0
"16716","신월6동","신월6동제1투","대통령선거","서울특별시","양천구",1573,1171,492,228,299,70,77,2,0,0,0,0,0,0,1,1169,2,402
"16717","신월6동","신월6동제2투","대통령선거","서울특별시","양천구",1360,831,307,232,207,37,43,2,0,0,0,0,1,0,0,829,2,529
"16718","신월6동","신월6동제3투","대통령선거","서울특별시","양천구",1436,1044,425,227,265,55,55,3,0,1,0,0,0,1,1,1033,11,392
"16719","신월7동","관내사전투표","대통령선거","서울특별시","양천구",3358,3358,1585,620,722,200,209,5,1,2,0,2,0,0,2,3348,10,0
"16720","신월7동","신월7동제1투","대통령선거","서울특별시","양천구",2828,1766,696,383,451,110,108,1,0,3,0,0,1,0,1,1754,12,1062
"16721","신월7동","신월7동제2투","대통령선거","서울특별시","양천구",2569,1765,703,394,449,102,109,1,0,0,0,1,1,0,1,1761,4,804
"16722","신월7동","신월7동제3투","대통령선거","서울특별시","양천구",2271,1502,514,379,436,80,81,1,0,0,1,1,0,0,1,1494,8,769
"16723","신월7동","신월7동제4투","대통령선거","서울특별시","양천구",2085,1397,530,338,345,80,93,1,0,1,0,0,1,0,1,1390,7,688
"16724","신월7동","신월7동제5투","대통령선거","서울특별시","양천구",2767,2095,907,407,516,123,123,0,0,2,1,3,2,0,3,2087,8,672
"16725","신월7동","신월7동제6투","대통령선거","서울특별시","양천구",2505,1907,839,373,447,132,105,3,0,1,0,2,0,0,1,1903,4,598
"16726","신정1동","관내사전투표","대통령선거","서울특별시","양천구",4231,4231,1993,783,854,313,256,11,0,2,0,3,1,3,0,4219,12,0
"16727","신정1동","신정1동제1투","대통령선거","서울특별시","양천구",2755,1950,779,429,486,156,91,0,0,2,0,1,0,1,0,1945,5,805
"16728","신정1동","신정1동제2투","대통령선거","서울특별시","양천구",2740,2155,870,464,526,176,108,2,0,0,0,0,0,0,1,2147,8,585
"16729","신정1동","신정1동제3투","대통령선거","서울특별시","양천구",2216,1858,674,480,428,178,89,3,0,0,0,1,0,0,0,1853,5,358
"16730","신정1동","신정1동제4투","대통령선거","서울특별시","양천구",2166,1811,678,413,438,175,100,2,0,0,0,0,0,2,1,1809,2,355
"16731","신정1동","신정1동제5투","대통령선거","서울특별시","양천구",1844,1431,568,308,333,139,72,5,0,1,0,1,0,0,0,1427,4,413
"16732","신정2동","관내사전투표","대통령선거","서울특별시","양천구",4422,4422,2186,676,863,383,294,5,0,0,1,0,0,0,1,4409,13,0
"16733","신정2동","신정2동제1투","대통령선거","서울특별시","양천구",3293,2344,981,443,580,166,156,4,2,0,0,1,2,0,1,2336,8,949
"16734","신정2동","신정2동제2투","대통령선거","서울특별시","양천구",2872,2204,953,448,494,151,147,3,0,1,1,1,0,1,0,2200,4,668
"16735","신정2동","신정2동제3투","대통령선거","서울특별시","양천구",3047,2400,1008,426,614,193,145,3,0,2,0,1,0,1,2,2395,5,647
"16736","신정2동","신정2동제4투","대통령선거","서울특별시","양천구",2743,2075,798,450,499,182,132,4,0,2,0,2,1,0,0,2070,5,668
"16737","신정3동","관내사전투표","대통령선거","서울특별시","양천구",4075,4075,1966,748,843,268,219,10,0,3,2,0,1,2,4,4066,9,0
"16738","신정3동","신정3동제1투","대통령선거","서울특별시","양천구",2328,1702,722,343,431,106,92,1,1,1,0,3,0,1,0,1701,1,626
"16739","신정3동","신정3동제2투","대통령선거","서울특별시","양천구",1088,658,285,124,164,42,38,0,0,0,0,0,0,0,2,655,3,430
"16740","신정3동","신정3동제3투","대통령선거","서울특별시","양천구",1358,796,292,194,227,40,39,2,0,0,0,0,0,0,0,794,2,562
"16741","신정3동","신정3동제4투","대통령선거","서울특별시","양천구",985,542,194,154,138,23,32,0,0,0,0,0,0,0,0,541,1,443
"16742","신정3동","신정3동제5투","대통령선거","서울특별시","양천구",2329,1303,502,327,332,70,60,5,0,3,0,1,0,0,0,1300,3,1026
"16743","신정3동","신정3동제6투","대통령선거","서울특별시","양천구",2477,1766,766,376,419,92,100,1,0,1,1,2,0,0,1,1759,7,711
"16744","신정3동","신정3동제7투","대통령선거","서울특별시","양천구",3005,2420,1018,456,578,201,157,2,0,1,1,0,0,0,1,2415,5,585
"16745","신정3동","신정3동제8투","대통령선거","서울특별시","양천구",2706,2107,944,394,469,154,132,3,1,0,0,0,0,0,2,2099,8,599
"16746","신정3동","신정3동제9투","대통령선거","서울특별시","양천구",2642,2052,821,415,507,168,134,1,0,0,0,0,0,0,1,2047,5,590
"16747","신정3동","신정3동제10투","대통령선거","서울특별시","양천구",3056,2434,1061,440,601,186,133,4,0,1,0,0,1,3,2,2432,2,622
"16748","신정3동","신정3동제11투","대통령선거","서울특별시","양천구",2501,1937,915,364,439,103,105,4,1,1,0,1,0,0,0,1933,4,564
"16749","신정3동","신정3동제12투","대통령선거","서울특별시","양천구",2406,1934,902,333,465,108,116,2,0,1,0,3,0,0,0,1930,4,472
"16750","신정3동","신정3동제13투","대통령선거","서울특별시","양천구",1917,1586,785,270,325,105,91,1,1,0,0,1,0,0,1,1580,6,331
"16751","신정3동","신정3동제14투","대통령선거","서울특별시","양천구",1931,1589,734,256,387,100,104,0,0,0,1,1,0,1,0,1584,5,342
"16752","신정4동","관내사전투표","대통령선거","서울특별시","양천구",4654,4654,2367,708,960,269,319,9,1,3,2,2,0,0,1,4641,13,0
"16753","신정4동","신정4동제1투","대통령선거","서울특별시","양천구",3087,2191,963,418,530,133,135,3,0,3,0,1,0,0,0,2186,5,896
"16754","신정4동","신정4동제2투","대통령선거","서울특별시","양천구",2537,1770,722,401,434,92,109,1,1,1,0,0,2,2,1,1766,4,767
"16755","신정4동","신정4동제3투","대통령선거","서울특별시","양천구",2623,1556,577,380,394,93,97,3,0,3,0,1,0,1,1,1550,6,1067
"16756","신정4동","신정4동제4투","대통령선거","서울특별시","양천구",2670,1974,862,365,479,125,131,2,0,1,0,0,0,1,1,1967,7,696
"16757","신정4동","신정4동제5투","대통령선거","서울특별시","양천구",3044,2243,937,484,556,124,126,3,0,1,0,1,0,1,1,2234,9,801
"16758","신정4동","신정4동제6투","대통령선거","서울특별시","양천구",2811,1938,796,402,483,110,134,0,0,1,0,0,1,1,2,1930,8,873
"16759","신정4동","신정4동제7투","대통령선거","서울특별시","양천구",2716,1922,794,388,490,129,116,3,0,1,0,1,0,0,0,1922,0,794
"16760","신정4동","신정4동제8투","대통령선거","서울특별시","양천구",3208,2330,956,539,547,145,132,4,0,0,0,0,1,1,1,2326,4,878
"16761","신정6동","관내사전투표","대통령선거","서울특별시","양천구",3711,3711,1763,644,734,323,237,3,0,3,0,0,0,1,0,3708,3,0
"16762","신정6동","신정6동제1투","대통령선거","서울특별시","양천구",2175,1743,602,465,400,174,94,4,2,0,1,0,0,0,1,1743,0,432
"16763","신정6동","신정6동제2투","대통령선거","서울특별시","양천구",1914,1516,584,397,331,112,84,3,0,0,0,0,0,0,0,1511,5,398
"16764","신정6동","신정6동제3투","대통령선거","서울특별시","양천구",2965,2507,943,566,604,224,154,4,0,1,0,3,0,1,1,2501,6,458
"16765","신정6동","신정6동제4투","대통령선거","서울특별시","양천구",2848,2424,1052,431,537,221,173,2,0,1,0,2,0,0,1,2420,4,424
"16766","신정6동","신정6동제5투","대통령선거","서울특별시","양천구",2522,2154,982,315,485,206,154,3,0,1,1,2,0,0,0,2149,5,368
"16767","신정6동","신정6동제6투","대통령선거","서울특별시","양천구",1720,1389,477,338,387,104,78,0,0,0,0,0,0,2,0,1386,3,331
"16768","신정7동","관내사전투표","대통령선거","서울특별시","양천구",3325,3325,1586,542,678,287,215,4,0,2,2,1,1,0,2,3320,5,0
"16769","신정7동","신정7동제1투","대통령선거","서울특별시","양천구",2270,1596,637,352,371,139,95,0,1,0,0,0,0,0,0,1595,1,674
"16770","신정7동","신정7동제2투","대통령선거","서울특별시","양천구",1964,1641,722,311,361,138,98,2,0,1,2,0,0,1,1,1637,4,323
"16771","신정7동","신정7동제3투","대통령선거","서울특별시","양천구",3205,2304,919,525,547,168,128,2,0,1,1,0,0,2,1,2294,10,901
"16772","신정7동","신정7동제4투","대통령선거","서울특별시","양천구",2557,2037,943,364,447,153,121,4,0,0,0,0,1,1,0,2034,3,520
"16773","신정7동","신정7동제5투","대통령선거","서울특별시","양천구",2343,1656,593,489,398,87,74,2,0,4,0,2,0,0,2,1651,5,687
"16774","신정7동","신정7동제6투","대통령선거","서울특별시","양천구",2392,1705,616,468,424,91,78,7,0,2,0,0,1,1,1,1689,16,687
"16775","신정7동","신정7동제7투","대통령선거","서울특별시","양천구",2460,2092,916,404,468,164,127,6,0,0,0,1,0,0,2,2088,4,368
"16776","신정7동","신정7동제8투","대통령선거","서울특별시","양천구",1875,1536,560,380,361,133,92,3,0,1,1,1,1,0,0,1533,3,339
"16777","잘못 투입·구분된 투표지","잘못 투입·구분된 투표지","대통령선거","서울특별시","양천구",0,0,0,0,0,0,0,0,0,0,0,0,0,0,0,0,0,0
"16778","거소·선상투표","거소·선상투표","대통령선거","서울특별시","강서구",731,685,235,139,218,50,15,0,3,0,1,1,0,2,4,668,17,46
"16779","관외사전투표","관외사전투표","대통령선거","서울특별시","강서구",44281,44261,21545,6236,9025,3407,3592,58,12,20,13,31,10,12,65,44026,235,20
"16780","재외투표","재외투표","대통령선거","서울특별시","강서구",4736,3693,2205,308,563,160,429,17,0,0,0,0,1,1,1,3685,8,1043
"16781","염창동","관내사전투표","대통령선거","서울특별시","강서구",5895,5895,3069,828,1133,427,412,9,0,0,2,3,0,2,2,5887,8,0
"16782","염창동","염창동제1투","대통령선거","서울특별시","강서구",2520,1924,777,458,423,147,106,2,0,2,0,0,0,0,2,1917,7,596
"16783","염창동","염창동제2투","대통령선거","서울특별시","강서구",2989,2423,996,515,547,213,142,3,0,0,0,0,1,0,2,2419,4,566
"16784","염창동","염창동제3투","대통령선거","서울특별시","강서구",3129,2522,1177,412,534,218,158,7,0,2,1,3,0,1,0,2513,9,607
"16785","염창동","염창동제4투","대통령선거","서울특별시","강서구",2768,2266,1090,364,464,194,144,2,0,0,0,1,0,0,0,2259,7,502
"16786","염창동","염창동제5투","대통령선거","서울특별시","강서구",2517,1853,839,315,422,144,125,4,0,1,0,1,0,0,1,1852,1,664
"16787","염창동","염창동제6투","대통령선거","서울특별시","강서구",3392,2775,1268,483,628,218,170,2,0,0,0,1,0,0,0,2770,5,617
"16788","염창동","염창동제7투","대통령선거","서울특별시","강서구",2414,2036,926,375,466,140,118,3,2,0,1,0,0,0,0,2031,5,378
"16789","염창동","염창동제8투","대통령선거","서울특별시","강서구",2859,2318,1027,442,522,199,117,2,0,2,1,0,0,2,0,2314,4,541
"16790","등촌제1동","관내사전투표","대통령선거","서울특별시","강서구",4408,4408,2170,691,762,377,389,4,0,1,1,2,0,1,0,4398,10,0
"16791","등촌제1동","등촌제1동제1투","대통령선거","서울특별시","강서구",3031,2298,1025,440,490,185,142,3,1,2,1,0,0,0,0,2289,9,733
"16792","등촌제1동","등촌제1동제2투","대통령선거","서울특별시","강서구",3526,2443,867,672,562,188,139,3,0,0,0,0,0,1,1,2433,10,1083
"16793","등촌제1동","등촌제1동제3투","대통령선거","서울특별시","강서구",3519,2533,1156,406,515,232,215,3,0,1,0,0,0,0,0,2528,5,986
"16794","등촌제1동","등촌제1동제4투","대통령선거","서울특별시","강서구",3060,2199,985,359,481,192,174,2,0,1,0,1,0,0,0,2195,4,861
"16795","등촌제2동","관내사전투표","대통령선거","서울특별시","강서구",3747,3747,1798,681,701,294,253,5,0,1,1,2,0,1,4,3741,6,0
"16796","등촌제2동","등촌제2동제1투","대통령선거","서울특별시","강서구",3102,2207,893,472,540,158,125,3,0,5,0,2,1,0,0,2199,8,895
"16797","등촌제2동","등촌제2동제2투","대통령선거","서울특별시","강서구",3580,2592,1159,512,553,182,166,2,0,4,0,2,0,0,2,2582,10,988
"16798","등촌제2동","등촌제2동제3투","대통령선거","서울특별시","강서구",3126,2135,816,506,500,145,157,2,0,0,0,1,0,3,1,2131,4,991
"16799","등촌제2동","등촌제2동제4투","대통령선거","서울특별시","강서구",3236,2676,860,723,671,249,140,10,0,1,0,2,2,1,6,2665,11,560
"16800","등촌제3동","관내사전투표","대통령선거","서울특별시","강서구",5245,5245,2527,908,1066,374,337,7,0,2,2,3,0,3,2,5231,14,0
"16801","등촌제3동","등촌제3동제1투","대통령선거","서울특별시","강서구",2810,1889,723,471,470,120,85,5,0,2,0,1,1,2,3,1883,6,921
"16802","등촌제3동","등촌제3동제2투","대통령선거","서울특별시","강서구",2981,2419,1029,447,574,206,154,1,1,0,0,1,0,1,0,2414,5,562
"16803","등촌제3동","등촌제3동제3투","대통령선거","서울특별시","강서구",2864,2279,1043,443,471,180,133,5,0,1,0,0,0,1,0,2277,2,585
"16804","등촌제3동","등촌제3동제4투","대통령선거","서울특별시","강서구",2272,1474,496,426,362,85,79,4,0,3,0,1,0,2,2,1460,14,798
"16805","등촌제3동","등촌제3동제5투","대통령선거","서울특별시","강서구",2231,1541,614,371,361,95,80,3,0,1,0,0,0,1,2,1528,13,690
"16806","등촌제3동","등촌제3동제6투","대통령선거","서울특별시","강서구",2559,1732,658,433,406,122,97,2,0,3,0,2,0,2,0,1725,7,827
"16807","등촌제3동","등촌제3동제7투","대통령선거","서울특별시","강서구",2596,2070,974,390,438,139,124,0,1,1,0,0,0,1,1,2069,1,526
"16808","등촌제3동","등촌제3동제8투","대통령선거","서울특별시","강서구",2284,1513,517,451,357,82,81,3,1,2,0,2,1,1,4,1502,11,771
"16809","등촌제3동","등촌제3동제9투","대통령선거","서울특별시","강서구",1746,1430,620,284,311,113,95,1,0,0,0,3,0,0,0,1427,3,316
"16810","화곡본동","관내사전투표","대통령선거","서울특별시","강서구",4550,4550,2372,709,847,268,328,7,0,1,0,2,1,3,1,4539,11,0
"16811","화곡본동","화곡본동제1투","대통령선거","서울특별시","강서구",3761,2275,967,455,525,144,163,1,1,1,0,5,0,1,4,2267,8,1486
"16812","화곡본동","화곡본동제2투","대통령선거","서울특별시","강서구",4131,2525,1140,474,582,144,162,6,0,2,0,1,0,0,3,2514,11,1606
"16813","화곡본동","화곡본동제3투","대통령선거","서울특별시","강서구",3437,2370,1068,444,571,136,129,7,0,3,0,2,1,0,1,2362,8,1067
"16814","화곡본동","화곡본동제4투","대통령선거","서울특별시","강서구",3121,2249,999,440,493,154,152,0,0,1,0,1,0,0,1,2241,8,872
"16815","화곡본동","화곡본동제5투","대통령선거","서울특별시","강서구",3667,2417,1096,380,617,122,187,2,1,1,0,1,0,0,1,2408,9,1250
"16816","화곡본동","화곡본동제6투","대통령선거","서울특별시","강서구",3762,2526,1142,403,628,165,159,8,0,1,0,4,1,0,3,2514,12,1236
"16817","화곡제1동","관내사전투표","대통령선거","서울특별시","강서구",6575,6575,3181,1087,1386,401,476,10,1,3,2,7,0,0,7,6561,14,0
"16818","화곡제1동","화곡제1동제1투","대통령선거","서울특별시","강서구",4232,2445,1029,494,622,139,151,2,0,2,0,0,0,0,2,2441,4,1787
"16819","화곡제1동","화곡제1동제2투","대통령선거","서울특별시","강서구",3605,2403,1042,449,580,147,165,8,0,0,1,2,0,1,1,2396,7,1202
"16820","화곡제1동","화곡제1동제3투","대통령선거","서울특별시","강서구",4132,2591,1129,505,612,171,157,2,1,2,0,1,1,2,0,2583,8,1541
"16821","화곡제1동","화곡제1동제4투","대통령선거","서울특별시","강서구",3617,2354,932,510,593,148,151,3,0,3,0,0,0,2,2,2344,10,1263
"16822","화곡제1동","화곡제1동제5투","대통령선거","서울특별시","강서구",2771,2011,826,403,524,124,127,1,0,2,0,0,1,1,1,2010,1,760
"16823","화곡제1동","화곡제1동제6투","대통령선거","서울특별시","강서구",2950,1908,846,330,456,131,129,1,0,1,0,0,1,3,2,1900,8,1042
"16824","화곡제1동","화곡제1동제7투","대통령선거","서울특별시","강서구",3217,2209,943,431,570,136,116,3,0,1,3,1,0,0,0,2204,5,1008
"16825","화곡제1동","화곡제1동제8투","대통령선거","서울특별시","강서구",3109,2165,942,442,476,149,141,1,0,4,0,3,0,0,4,2162,3,944
"16826","화곡제1동","화곡제1동제9투","대통령선거","서울특별시","강서구",3283,2217,966,462,545,105,127,0,0,3,0,0,0,4,2,2214,3,1066
"16827","화곡제1동","화곡제1동제10투","대통령선거","서울특별시","강서구",3551,2478,1085,422,591,177,186,0,1,1,2,0,1,0,3,2469,9,1073
"16828","화곡제2동","관내사전투표","대통령선거","서울특별시","강서구",2994,2994,1522,439,623,163,212,1,0,17,0,1,0,1,3,2982,12,0
"16829","화곡제2동","화곡제2동제1투","대통령선거","서울특별시","강서구",2182,1503,601,368,354,78,90,1,1,1,1,1,1,0,1,1498,5,679
"16830","화곡제2동","화곡제2동제2투","대통령선거","서울특별시","강서구",2889,1765,743,379,433,104,98,0,0,5,1,0,1,0,0,1764,1,1124
"16831","화곡제2동","화곡제2동제3투","대통령선거","서울특별시","강서구",3461,2286,1065,382,553,132,142,1,0,2,0,0,0,1,1,2279,7,1175
"16832","화곡제2동","화곡제2동제4투","대통령선거","서울특별시","강서구",3471,2274,1005,405,563,140,134,1,0,4,1,4,1,2,1,2261,13,1197
"16833","화곡제3동","관내사전투표","대통령선거","서울특별시","강서구",4628,4628,2236,759,949,300,356,7,1,3,0,1,0,1,1,4614,14,0
"16834","화곡제3동","화곡제3동제1투","대통령선거","서울특별시","강서구",2696,1836,751,397,449,127,100,5,0,1,0,0,0,0,0,1830,6,860
"16835","화곡제3동","화곡제3동제2투","대통령선거","서울특별시","강서구",2954,1831,751,387,436,118,118,6,1,1,0,0,0,1,2,1821,10,1123
"16836","화곡제3동","화곡제3동제3투","대통령선거","서울특별시","강서구",2915,2190,928,488,471,130,155,11,0,2,0,1,0,0,1,2187,3,725
"16837","화곡제3동","화곡제3동제4투","대통령선거","서울특별시","강서구",3035,2545,784,848,593,200,109,3,0,1,0,1,1,0,0,2540,5,490
"16838","화곡제3동","화곡제3동제5투","대통령선거","서울특별시","강서구",2954,2313,859,548,605,168,124,5,0,0,0,0,0,0,1,2310,3,641
"16839","화곡제4동","관내사전투표","대통령선거","서울특별시","강서구",3672,3672,1789,667,768,174,246,5,1,0,0,4,0,0,2,3656,16,0
"16840","화곡제4동","화곡제4동제1투","대통령선거","서울특별시","강서구",2880,1848,736,456,463,86,91,1,0,3,1,1,1,1,0,1840,8,1032
"16841","화곡제4동","화곡제4동제2투","대통령선거","서울특별시","강서구",2823,1765,700,423,420,103,108,3,0,2,0,0,0,1,0,1760,5,1058
"16842","화곡제4동","화곡제4동제3투","대통령선거","서울특별시","강서구",3203,1856,781,357,466,111,127,2,0,1,1,1,2,1,1,1851,5,1347
"16843","화곡제4동","화곡제4동제4투","대통령선거","서울특별시","강서구",2403,1584,629,339,399,84,116,5,0,4,0,0,0,0,1,1577,7,819
"16844","화곡제4동","화곡제4동제5투","대통령선거","서울특별시","강서구",2941,2144,878,490,519,116,121,3,0,2,0,3,1,1,1,2135,9,797
"16845","화곡제6동","관내사전투표","대통령선거","서울특별시","강서구",4671,4671,2328,756,901,306,348,8,1,2,1,4,0,1,4,4660,11,0
"16846","화곡제6동","화곡제6동제1투","대통령선거","서울특별시","강서구",3540,2223,977,463,491,126,144,8,0,3,1,1,0,0,3,2217,6,1317
"16847","화곡제6동","화곡제6동제2투","대통령선거","서울특별시","강서구",2789,1854,728,416,477,108,98,4,0,0,1,0,0,0,2,1834,20,935
"16848","화곡제6동","화곡제6동제3투","대통령선거","서울특별시","강서구",2782,1932,719,482,460,123,127,3,0,2,0,0,0,0,2,1918,14,850
"16849","화곡제6동","화곡제6동제4투","대통령선거","서울특별시","강서구",4009,2807,1178,570,672,190,182,2,0,0,0,1,0,3,1,2799,8,1202
"16850","화곡제6동","화곡제6동제5투","대통령선거","서울특별시","강서구",2550,2115,661,669,502,178,91,5,0,1,1,0,0,1,1,2110,5,435
"16851","화곡제8동","관내사전투표","대통령선거","서울특별시","강서구",4837,4837,2436,750,1030,272,324,6,0,2,1,4,0,1,3,4829,8,0
"16852","화곡제8동","화곡제8동제1투","대통령선거","서울특별시","강서구",3746,2369,1032,466,585,132,136,4,1,2,3,0,0,0,0,2361,8,1377
"16853","화곡제8동","화곡제8동제2투","대통령선거","서울특별시","강서구",2948,2003,862,389,493,112,125,3,0,3,0,3,0,1,3,1994,9,945
"16854","화곡제8동","화곡제8동제3투","대통령선거","서울특별시","강서구",3432,2371,1037,461,593,116,142,1,0,1,1,3,1,0,7,2363,8,1061
"16855","화곡제8동","화곡제8동제4투","대통령선거","서울특별시","강서구",2969,2071,921,367,521,116,139,0,0,1,0,0,0,0,0,2065,6,898
"16856","화곡제8동","화곡제8동제5투","대통령선거","서울특별시","강서구",3403,2368,1048,452,545,142,155,6,1,1,1,4,2,1,1,2359,9,1035
"16857","우장산동","관내사전투표","대통령선거","서울특별시","강서구",5373,5373,2605,931,1081,379,355,5,0,2,0,2,0,0,1,5361,12,0
"16858","우장산동","우장산동제1투","대통령선거","서울특별시","강서구",3554,2414,1066,476,545,179,142,3,0,0,0,0,0,0,1,2412,2,1140
"16859","우장산동","우장산동제2투","대통령선거","서울특별시","강서구",2769,1966,819,395,471,134,131,5,0,1,0,0,0,2,0,1958,8,803
"16860","우장산동","우장산동제3투","대통령선거","서울특별시","강서구",3327,2413,931,537,598,159,172,5,0,2,0,1,0,0,2,2407,6,914
"16861","우장산동","우장산동제4투","대통령선거","서울특별시","강서구",2928,2455,1066,498,538,215,121,9,0,2,0,0,0,0,1,2450,5,473
"16862","우장산동","우장산동제5투","대통령선거","서울특별시","강서구",3518,2703,1194,520,635,174,160,7,0,3,0,1,0,2,2,2698,5,815
"16863","우장산동","우장산동제6투","대통령선거","서울특별시","강서구",3517,2865,1159,631,671,243,153,4,0,0,0,1,1,0,0,2863,2,652
"16864","우장산동","우장산동제7투","대통령선거","서울특별시","강서구",3431,2681,1119,536,656,211,143,4,1,3,0,0,1,0,1,2675,6,750
"16865","우장산동","우장산동제8투","대통령선거","서울특별시","강서구",3419,2795,1104,632,649,246,149,6,0,1,0,0,1,1,0,2789,6,624
"16866","가양제1동","관내사전투표","대통령선거","서울특별시","강서구",3693,3693,1846,586,688,298,259,2,0,2,1,2,0,1,2,3687,6,0
"16867","가양제1동","가양제1동제1투","대통령선거","서울특별시","강서구",2261,1736,678,384,424,123,114,6,1,0,1,1,0,1,0,1733,3,525
"16868","가양제1동","가양제1동제2투","대통령선거","서울특별시","강서구",1678,1209,539,260,276,71,56,1,0,1,0,0,0,0,0,1204,5,469
"16869","가양제1동","가양제1동제3투","대통령선거","서울특별시","강서구",2584,1845,647,518,397,165,111,2,0,0,0,1,0,0,0,1841,4,739
"16870","가양제1동","가양제1동제4투","대통령선거","서울특별시","강서구",2027,1433,664,269,279,109,99,2,1,3,0,1,1,1,1,1430,3,594
"16871","가양제1동","가양제1동제5투","대통령선거","서울특별시","강서구",1723,1377,539,330,310,126,68,0,0,1,0,1,0,0,0,1375,2,346
"16872","가양제1동","가양제1동제6투","대통령선거","서울특별시","강서구",2020,1658,667,356,394,140,93,2,0,0,0,1,0,1,0,1654,4,362
"16873","가양제1동","가양제1동제7투","대통령선거","서울특별시","강서구",2123,1508,755,150,332,133,127,2,0,0,0,0,0,1,1,1501,7,615
"16874","가양제1동","가양제1동제8투","대통령선거","서울특별시","강서구",2823,1768,966,134,286,189,190,1,0,0,0,1,0,0,0,1767,1,1055
"16875","가양제2동","관내사전투표","대통령선거","서울특별시","강서구",2940,2940,1352,610,552,218,184,3,0,1,2,3,1,0,5,2931,9,0
"16876","가양제2동","가양제2동제1투","대통령선거","서울특별시","강서구",1985,1357,425,459,309,100,56,2,1,0,0,0,0,1,2,1355,2,628
"16877","가양제2동","가양제2동제2투","대통령선거","서울특별시","강서구",2090,1659,781,300,334,125,110,1,0,0,0,1,1,0,1,1654,5,431
"16878","가양제2동","가양제2동제3투","대통령선거","서울특별시","강서구",2598,1703,617,439,444,99,85,3,1,3,0,1,3,2,1,1698,5,895
"16879","가양제2동","가양제2동제4투","대통령선거","서울특별시","강서구",2058,1368,486,402,334,80,45,5,2,1,0,1,0,1,2,1359,9,690
"16880","가양제2동","가양제2동제5투","대통령선거","서울특별시","강서구",2728,1984,784,508,434,108,122,3,0,2,0,3,1,3,4,1972,12,744
"16881","가양제3동","관내사전투표","대통령선거","서울특별시","강서구",3127,3127,1540,517,623,209,209,6,0,1,0,5,0,3,1,3114,13,0
"16882","가양제3동","가양제3동제1투","대통령선거","서울특별시","강서구",2388,1708,642,447,414,92,97,5,0,0,0,1,0,1,2,1701,7,680
"16883","가양제3동","가양제3동제2투","대통령선거","서울특별시","강서구",2350,1539,580,401,379,95,74,2,0,0,0,1,0,0,2,1534,5,811
"16884","가양제3동","가양제3동제3투","대통령선거","서울특별시","강서구",2198,1651,699,380,359,118,84,2,1,0,2,1,0,0,1,1647,4,547
"16885","가양제3동","가양제3동제4투","대통령선거","서울특별시","강서구",1946,1238,442,335,327,62,53,2,0,1,0,3,2,1,1,1229,9,708
"16886","가양제3동","가양제3동제5투","대통령선거","서울특별시","강서구",2130,1777,802,349,380,135,102,1,0,1,0,2,0,0,2,1774,3,353
"16887","발산제1동","관내사전투표","대통령선거","서울특별시","강서구",5530,5530,2704,791,1185,389,424,10,2,3,1,1,0,3,4,5517,13,0
"16888","발산제1동","발산제1동제1투","대통령선거","서울특별시","강서구",2596,1973,882,355,478,118,130,3,0,0,0,0,1,0,2,1969,4,623
"16889","발산제1동","발산제1동제2투","대통령선거","서울특별시","강서구",2275,1536,673,285,351,109,109,0,0,0,0,0,0,0,1,1528,8,739
"16890","발산제1동","발산제1동제3투","대통령선거","서울특별시","강서구",2896,2167,914,447,514,144,135,3,0,1,0,0,1,2,0,2161,6,729
"16891","발산제1동","발산제1동제4투","대통령선거","서울특별시","강서구",3249,2596,1160,469,608,185,159,1,0,0,0,0,1,1,1,2585,11,653
"16892","발산제1동","발산제1동제5투","대통령선거","서울특별시","강서구",3409,2588,1079,507,634,188,156,6,0,5,0,1,1,2,1,2580,8,821
"16893","발산제1동","발산제1동제6투","대통령선거","서울특별시","강서구",3325,2680,1328,379,606,187,168,1,0,0,0,3,1,3,0,2676,4,645
"16894","발산제1동","발산제1동제7투","대통령선거","서울특별시","강서구",2443,1999,986,296,455,121,129,3,0,1,2,0,0,0,2,1995,4,444
"16895","발산제1동","발산제1동제8투","대통령선거","서울특별시","강서구",2115,1794,866,280,404,125,110,1,0,2,0,0,0,0,2,1790,4,321
"16896","공항동","관내사전투표","대통령선거","서울특별시","강서구",3509,3509,1616,667,736,232,239,2,0,7,2,0,1,1,3,3506,3,0
"16897","공항동","공항동제1투","대통령선거","서울특별시","강서구",2420,1730,651,436,456,94,82,0,0,1,2,0,0,1,2,1725,5,690
"16898","공항동","공항동제2투","대통령선거","서울특별시","강서구",2774,1764,690,406,408,129,117,1,0,0,1,2,1,2,3,1760,4,1010
"16899","공항동","공항동제3투","대통령선거","서울특별시","강서구",2730,1538,608,379,328,92,109,1,1,2,0,1,0,3,2,1526,12,1192
"16900","공항동","공항동제4투","대통령선거","서울특별시","강서구",2237,1332,529,298,339,64,85,2,1,0,0,2,0,0,3,1323,9,905
"16901","공항동","공항동제5투","대통령선거","서울특별시","강서구",2367,1544,623,361,372,86,92,0,0,2,0,0,0,1,1,1538,6,823
"16902","공항동","공항동제6투","대통령선거","서울특별시","강서구",2038,1681,854,202,382,134,100,0,0,1,0,3,0,1,1,1678,3,357
"16903","방화제1동","관내사전투표","대통령선거","서울특별시","강서구",6314,6314,2798,1254,1406,400,420,4,3,1,2,4,0,1,2,6295,19,0
"16904","방화제1동","방화제1동제1투","대통령선거","서울특별시","강서구",2304,1659,675,393,372,96,111,2,0,0,0,1,0,1,1,1652,7,645
"16905","방화제1동","방화제1동제2투","대통령선거","서울특별시","강서구",2786,1881,725,467,427,140,110,3,1,1,0,0,0,1,0,1875,6,905
"16906","방화제1동","방화제1동제3투","대통령선거","서울특별시","강서구",2263,1511,591,384,319,121,81,3,0,1,4,1,0,0,2,1507,4,752
"16907","방화제1동","방화제1동제4투","대통령선거","서울특별시","강서구",2311,1373,486,373,324,94,86,3,1,1,0,1,0,0,1,1370,3,938
"16908","방화제1동","방화제1동제5투","대통령선거","서울특별시","강서구",2600,1971,843,418,453,156,91,1,0,2,0,0,0,0,2,1966,5,629
"16909","방화제1동","방화제1동제6투","대통령선거","서울특별시","강서구",2985,2375,1037,487,507,178,149,5,0,0,1,0,0,1,1,2366,9,610
"16910","방화제1동","방화제1동제7투","대통령선거","서울특별시","강서구",2338,1749,704,421,377,130,103,5,0,0,0,1,0,0,0,1741,8,589
"16911","방화제1동","방화제1동제8투","대통령선거","서울특별시","강서구",2919,2299,1051,421,518,177,125,1,0,0,0,2,0,0,0,2295,4,620
"16912","방화제1동","방화제1동제9투","대통령선거","서울특별시","강서구",2793,2355,1110,368,542,174,147,1,0,1,0,2,0,2,1,2348,7,438
"16913","방화제1동","방화제1동제10투","대통령선거","서울특별시","강서구",3980,3279,1500,591,724,242,211,2,0,0,0,1,0,3,1,3275,4,701
"16914","방화제2동","관내사전투표","대통령선거","서울특별시","강서구",2493,2493,1169,507,486,149,164,3,1,2,2,1,0,0,2,2486,7,0
"16915","방화제2동","방화제2동제1투","대통령선거","서울특별시","강서구",2854,1862,743,419,404,154,131,0,0,1,0,1,0,1,1,1855,7,992
"16916","방화제2동","방화제2동제2투","대통령선거","서울특별시","강서구",2826,1597,561,440,374,114,88,1,1,4,0,3,1,0,2,1589,8,1229
"16917","방화제2동","방화제2동제3투","대통령선거","서울특별시","강서구",2811,1980,767,468,484,126,114,6,0,2,0,0,1,2,3,1973,7,831
"16918","방화제2동","방화제2동제4투","대통령선거","서울특별시","강서구",2354,1728,686,423,381,109,118,5,0,1,1,1,0,0,1,1726,2,626
"16919","방화제2동","방화제2동제5투","대통령선거","서울특별시","강서구",2140,1491,560,362,370,92,80,6,1,1,0,0,2,2,3,1479,12,649
"16920","방화제2동","방화제2동제6투","대통령선거","서울특별시","강서구",1423,1016,310,365,207,64,57,2,1,3,2,0,0,0,0,1011,5,407
"16921","방화제2동","방화제2동제7투","대통령선거","서울특별시","강서구",1769,1289,473,344,312,63,87,4,0,0,1,0,0,2,1,1287,2,480
"16922","방화제3동","관내사전투표","대통령선거","서울특별시","강서구",4979,4979,2430,915,949,317,324,8,0,4,2,5,0,1,2,4957,22,0
"16923","방화제3동","방화제3동제1투","대통령선거","서울특별시","강서구",2809,1959,784,409,482,156,119,0,0,1,0,0,0,3,2,1956,3,850
"16924","방화제3동","방화제3동제2투","대통령선거","서울특별시","강서구",2023,1568,752,256,346,107,93,2,0,2,0,1,0,1,2,1562,6,455
"16925","방화제3동","방화제3동제3투","대통령선거","서울특별시","강서구",2154,1424,484,391,391,69,61,4,2,3,1,3,2,0,0,1411,13,730
"16926","방화제3동","방화제3동제4투","대통령선거","서울특별시","강서구",2571,1912,734,470,444,140,115,5,0,1,0,0,0,0,2,1911,1,659
"16927","방화제3동","방화제3동제5투","대통령선거","서울특별시","강서구",2062,1656,611,430,355,161,92,2,0,1,0,0,0,2,0,1654,2,406
"16928","방화제3동","방화제3동제6투","대통령선거","서울특별시","강서구",1926,1322,449,388,324,92,50,4,0,2,0,3,0,1,2,1315,7,604
"16929","방화제3동","방화제3동제7투","대통령선거","서울특별시","강서구",2392,1745,690,413,386,140,108,3,0,0,0,2,0,0,0,1742,3,647
"16930","잘못 투입·구분된 투표지","잘못 투입·구분된 투표지","대통령선거","서울특별시","강서구",0,13,8,2,1,0,1,0,0,0,0,0,0,0,0,12,1,-13
"16931","거소·선상투표","거소·선상투표","대통령선거","서울특별시","구로구",524,487,165,85,154,30,15,3,3,1,1,0,3,1,0,461,26,37
"16932","관외사전투표","관외사전투표","대통령선거","서울특별시","구로구",30689,30683,14980,4508,6272,2198,2425,36,7,12,11,21,10,13,39,30532,151,6
"16933","재외투표","재외투표","대통령선거","서울특별시","구로구",2994,2380,1459,199,352,101,253,6,2,1,0,3,0,0,1,2377,3,614
"16934","신도림동","관내사전투표","대통령선거","서울특별시","구로구",5818,5818,2821,963,1208,421,372,13,0,1,1,1,0,0,4,5805,13,0
"16935","신도림동","신도림동제1투","대통령선거","서울특별시","구로구",2499,1831,748,387,412,157,108,3,0,2,0,0,1,0,3,1821,10,668
"16936","신도림동","신도림동제2투","대통령선거","서울특별시","구로구",2538,2158,888,457,525,158,118,3,0,2,1,0,0,0,1,2153,5,380
"16937","신도림동","신도림동제3투","대통령선거","서울특별시","구로구",2285,1923,816,359,463,149,124,4,0,1,1,0,0,1,2,1920,3,362
"16938","신도림동","신도림동제4투","대통령선거","서울특별시","구로구",2551,1890,791,378,451,141,118,4,0,0,0,0,0,1,0,1884,6,661
"16939","신도림동","신도림동제5투","대통령선거","서울특별시","구로구",2867,2387,1031,474,538,195,143,0,0,1,0,1,1,0,0,2384,3,480
"16940","신도림동","신도림동제6투","대통령선거","서울특별시","구로구",2781,2312,985,493,506,189,128,5,1,0,0,1,0,0,2,2310,2,469
"16941","신도림동","신도림동제7투","대통령선거","서울특별시","구로구",3124,2440,994,491,593,213,135,1,0,0,1,2,0,1,1,2432,8,684
"16942","신도림동","신도림동제8투","대통령선거","서울특별시","구로구",2801,2325,887,580,550,183,112,4,0,0,0,0,0,1,0,2317,8,476
"16943","구로제1동","관내사전투표","대통령선거","서울특별시","구로구",4056,4056,2043,663,744,293,291,4,0,2,0,6,0,0,1,4047,9,0
"16944","구로제1동","구로제1동제1투","대통령선거","서울특별시","구로구",2439,1905,806,421,406,142,118,2,0,0,0,0,0,1,2,1898,7,534
"16945","구로제1동","구로제1동제2투","대통령선거","서울특별시","구로구",2287,1840,766,364,432,137,129,1,0,1,0,3,0,0,1,1834,6,447
"16946","구로제1동","구로제1동제3투","대통령선거","서울특별시","구로구",2276,1787,777,345,398,149,105,3,0,0,0,2,0,0,1,1780,7,489
"16947","구로제1동","구로제1동제4투","대통령선거","서울특별시","구로구",2016,1596,688,283,397,118,105,0,0,0,0,3,0,0,1,1595,1,420
"16948","구로제1동","구로제1동제5투","대통령선거","서울특별시","구로구",2879,2249,1128,342,464,151,152,4,0,2,1,1,2,0,0,2247,2,630
"16949","구로제2동","관내사전투표","대통령선거","서울특별시","구로구",3236,3236,1538,671,689,123,190,4,0,2,2,3,1,3,0,3226,10,0
"16950","구로제2동","구로제2동제1투","대통령선거","서울특별시","구로구",2657,1416,584,331,360,57,78,0,1,0,0,0,0,0,1,1412,4,1241
"16951","구로제2동","구로제2동제2투","대통령선거","서울특별시","구로구",1810,1104,453,299,244,53,44,1,0,0,3,1,0,0,1,1099,5,706
"16952","구로제2동","구로제2동제3투","대통령선거","서울특별시","구로구",2043,1226,460,326,323,46,57,2,1,0,1,0,0,1,1,1218,8,817
"16953","구로제2동","구로제2동제4투","대통령선거","서울특별시","구로구",2287,1449,613,317,364,68,76,2,0,2,0,0,2,0,0,1444,5,838
"16954","구로제2동","구로제2동제5투","대통령선거","서울특별시","구로구",1855,1277,535,327,287,54,67,3,0,1,0,0,0,1,0,1275,2,578
"16955","구로제2동","구로제2동제6투","대통령선거","서울특별시","구로구",3220,2389,1001,551,548,137,139,2,0,1,0,1,0,1,1,2382,7,831
"16956","구로제2동","구로제2동제7투","대통령선거","서울특별시","구로구",1837,1099,451,279,243,65,50,2,0,1,0,2,0,0,1,1094,5,738
"16957","구로제2동","구로제2동제8투","대통령선거","서울특별시","구로구",2343,1592,654,421,363,65,79,2,0,1,0,3,0,0,0,1588,4,751
"16958","구로제2동","구로제2동제9투","대통령선거","서울특별시","구로구",831,566,225,111,145,51,28,2,0,2,0,0,0,1,0,565,1,265
"16959","구로제3동","관내사전투표","대통령선거","서울특별시","구로구",4549,4549,2480,550,884,277,331,4,0,1,0,6,0,1,4,4538,11,0
"16960","구로제3동","구로제3동제1투","대통령선거","서울특별시","구로구",2080,1269,660,170,292,69,66,1,0,0,1,1,0,1,2,1263,6,811
"16961","구로제3동","구로제3동제2투","대통령선거","서울특별시","구로구",2220,1433,664,247,367,58,88,2,0,1,1,1,0,0,0,1429,4,787
"16962","구로제3동","구로제3동제3투","대통령선거","서울특별시","구로구",2447,1885,865,352,424,131,106,2,0,3,0,0,0,0,1,1884,1,562
"16963","구로제3동","구로제3동제4투","대통령선거","서울특별시","구로구",2405,1816,882,296,370,134,126,0,0,0,0,2,1,1,1,1813,3,589
"16964","구로제3동","구로제3동제5투","대통령선거","서울특별시","구로구",1832,1376,718,162,250,122,119,0,0,1,0,1,0,0,2,1375,1,456
"16965","구로제3동","구로제3동제6투","대통령선거","서울특별시","구로구",2222,1811,807,348,436,100,96,1,0,1,0,8,1,1,1,1800,11,411
"16966","구로제3동","구로제3동제7투","대통령선거","서울특별시","구로구",2931,1991,1132,202,339,147,165,1,1,1,0,0,0,0,0,1988,3,940
"16967","구로제4동","관내사전투표","대통령선거","서울특별시","구로구",2829,2829,1341,505,678,130,149,5,2,2,0,5,0,2,1,2820,9,0
"16968","구로제4동","구로제4동제1투","대통령선거","서울특별시","구로구",2809,1871,806,363,493,95,97,0,1,2,0,0,2,2,1,1862,9,938
"16969","구로제4동","구로제4동제2투","대통령선거","서울특별시","구로구",2289,1512,579,366,407,69,75,1,0,0,1,4,1,1,1,1505,7,777
"16970","구로제4동","구로제4동제3투","대통령선거","서울특별시","구로구",2893,2167,977,363,554,125,130,4,0,0,0,2,0,1,2,2158,9,726
"16971","구로제4동","구로제4동제4투","대통령선거","서울특별시","구로구",2243,1304,530,311,343,63,48,2,0,2,1,1,0,0,0,1301,3,939
"16972","구로제4동","구로제4동제5투","대통령선거","서울특별시","구로구",3356,2336,1058,413,530,134,181,6,1,2,1,1,0,0,0,2327,9,1020
"16973","구로제4동","구로제4동제6투","대통령선거","서울특별시","구로구",1924,1340,535,304,339,84,68,4,1,0,1,0,0,0,1,1337,3,584
"16974","구로제5동","관내사전투표","대통령선거","서울특별시","구로구",4994,4994,2482,831,992,309,339,6,1,2,2,6,3,1,4,4978,16,0
"16975","구로제5동","구로제5동제1투","대통령선거","서울특별시","구로구",2843,2025,841,475,467,107,118,2,1,1,1,1,2,1,0,2017,8,818
"16976","구로제5동","구로제5동제2투","대통령선거","서울특별시","구로구",3027,2347,971,529,535,164,135,0,0,4,0,0,0,0,0,2338,9,680
"16977","구로제5동","구로제5동제3투","대통령선거","서울특별시","구로구",2987,2050,899,430,460,134,117,5,0,0,0,0,0,0,1,2046,4,937
"16978","구로제5동","구로제5동제4투","대통령선거","서울특별시","구로구",3592,2351,1095,431,503,133,160,1,0,3,1,5,1,1,0,2334,17,1241
"16979","구로제5동","구로제5동제5투","대통령선거","서울특별시","구로구",3760,2807,1291,474,603,212,211,5,0,1,0,0,0,0,1,2798,9,953
"16980","구로제5동","구로제5동제6투","대통령선거","서울특별시","구로구",3128,2597,1054,581,629,183,134,3,0,1,0,1,0,1,2,2589,8,531
"16981","가리봉동","관내사전투표","대통령선거","서울특별시","구로구",534,534,260,101,117,20,28,1,0,0,0,4,0,0,0,531,3,0
"16982","가리봉동","가리봉동제1투","대통령선거","서울특별시","구로구",2375,1448,604,350,354,60,57,6,2,2,1,1,1,1,2,1441,7,927
"16983","가리봉동","가리봉동제2투","대통령선거","서울특별시","구로구",2841,1689,820,318,401,61,68,4,1,6,1,1,0,2,1,1684,5,1152
"16984","가리봉동","가리봉동제3투","대통령선거","서울특별시","구로구",2501,1271,530,289,334,57,54,1,0,1,0,0,0,1,1,1268,3,1230
"16985","고척제1동","관내사전투표","대통령선거","서울특별시","구로구",4007,4007,1797,835,835,237,267,3,0,4,0,4,0,4,3,3989,18,0
"16986","고척제1동","고척제1동제1투","대통령선거","서울특별시","구로구",3198,2316,834,639,544,141,141,2,0,1,0,0,1,3,3,2309,7,882
"16987","고척제1동","고척제1동제2투","대통령선거","서울특별시","구로구",3242,2314,913,526,587,139,129,6,0,1,0,2,1,0,1,2305,9,928
"16988","고척제1동","고척제1동제3투","대통령선거","서울특별시","구로구",3624,2811,1173,596,631,209,182,2,0,3,0,1,0,0,0,2797,14,813
"16989","고척제1동","고척제1동제4투","대통령선거","서울특별시","구로구",2364,1642,578,416,433,110,92,3,0,2,0,0,2,1,1,1638,4,722
"16990","고척제1동","고척제1동제5투","대통령선거","서울특별시","구로구",2883,2182,843,519,511,149,133,3,2,2,1,1,0,0,0,2164,18,701
"16991","고척제2동","관내사전투표","대통령선거","서울특별시","구로구",3358,3358,1529,640,712,219,235,4,0,1,1,4,0,1,0,3346,12,0
"16992","고척제2동","고척제2동제1투","대통령선거","서울특별시","구로구",2798,1989,770,456,514,120,109,1,0,2,0,2,1,0,2,1977,12,809
"16993","고척제2동","고척제2동제2투","대통령선거","서울특별시","구로구",2846,2163,838,540,484,152,134,5,0,1,0,1,0,1,0,2156,7,683
"16994","고척제2동","고척제2동제3투","대통령선거","서울특별시","구로구",2918,1969,761,473,484,106,127,1,1,5,0,0,0,0,1,1959,10,949
"16995","고척제2동","고척제2동제4투","대통령선거","서울특별시","구로구",2433,1546,594,386,375,83,82,1,0,2,0,1,0,3,3,1530,16,887
"16996","고척제2동","고척제2동제5투","대통령선거","서울특별시","구로구",2471,1620,593,445,411,83,72,0,0,0,0,1,1,2,0,1608,12,851
"16997","고척제2동","고척제2동제6투","대통령선거","서울특별시","구로구",3105,2561,1023,554,617,180,172,3,0,0,0,0,0,1,0,2550,11,544
"16998","고척제2동","고척제2동제7투","대통령선거","서울특별시","구로구",2098,1550,660,319,338,117,107,3,0,0,0,0,0,0,2,1546,4,548
"16999","개봉제1동","관내사전투표","대통령선거","서울특별시","구로구",4304,4304,1881,934,937,242,273,5,0,2,1,4,0,0,5,4284,20,0
"17000","개봉제1동","개봉제1동제1투","대통령선거","서울특별시","구로구",2833,1910,718,516,451,105,99,1,0,1,1,2,2,0,1,1897,13,923
"17001","개봉제1동","개봉제1동제2투","대통령선거","서울특별시","구로구",2427,1763,693,455,414,83,98,3,1,1,1,3,0,0,2,1754,9,664
"17002","개봉제1동","개봉제1동제3투","대통령선거","서울특별시","구로구",2360,1482,528,414,340,102,85,0,0,1,1,0,3,1,0,1475,7,878
"17003","개봉제1동","개봉제1동제4투","대통령선거","서울특별시","구로구",2524,1783,673,468,434,91,99,2,1,0,0,1,0,1,4,1774,9,741
"17004","개봉제1동","개봉제1동제5투","대통령선거","서울특별시","구로구",3312,2055,816,488,475,153,113,1,1,0,0,2,0,0,1,2050,5,1257
"17005","개봉제1동","개봉제1동제6투","대통령선거","서울특별시","구로구",2386,1573,571,432,386,68,96,1,1,1,0,1,1,1,1,1560,13,813
"17006","개봉제1동","개봉제1동제7투","대통령선거","서울특별시","구로구",2366,1689,661,432,420,75,87,1,1,0,0,0,0,2,1,1680,9,677
"17007","개봉제1동","개봉제1동제8투","대통령선거","서울특별시","구로구",4101,3436,1413,742,833,230,201,4,0,2,1,1,0,0,1,3428,8,665
"17008","개봉제2동","관내사전투표","대통령선거","서울특별시","구로구",4741,4741,2308,943,919,261,280,7,1,0,1,0,0,1,2,4723,18,0
"17009","개봉제2동","개봉제2동제1투","대통령선거","서울특별시","구로구",2930,2019,819,434,517,114,124,3,0,1,0,0,0,0,0,2012,7,911
"17010","개봉제2동","개봉제2동제2투","대통령선거","서울특별시","구로구",2751,1953,851,399,444,104,139,3,1,0,0,0,0,0,2,1943,10,798
"17011","개봉제2동","개봉제2동제3투","대통령선거","서울특별시","구로구",2519,2078,792,540,506,125,93,12,0,1,0,0,1,0,0,2070,8,441
"17012","개봉제2동","개봉제2동제4투","대통령선거","서울특별시","구로구",3007,2440,1033,537,575,161,117,4,0,0,0,0,0,0,2,2429,11,567
"17013","개봉제2동","개봉제2동제5투","대통령선거","서울특별시","구로구",2898,2452,948,651,558,151,129,2,0,2,0,1,0,0,2,2444,8,446
"17014","개봉제2동","개봉제2동제6투","대통령선거","서울특별시","구로구",2727,2155,884,523,475,145,109,7,0,1,1,1,0,0,3,2149,6,572
"17015","개봉제2동","개봉제2동제7투","대통령선거","서울특별시","구로구",2868,2055,872,430,483,114,139,3,0,3,1,0,0,1,1,2047,8,813
"17016","개봉제2동","개봉제2동제8투","대통령선거","서울특별시","구로구",2033,1457,580,344,327,96,103,1,0,0,1,0,0,0,0,1452,5,576
"17017","개봉제3동","관내사전투표","대통령선거","서울특별시","구로구",2618,2618,1219,498,558,164,160,2,0,0,0,0,2,2,4,2609,9,0
"17018","개봉제3동","개봉제3동제1투","대통령선거","서울특별시","구로구",2779,1924,793,451,492,76,96,4,0,0,0,0,0,1,2,1915,9,855
"17019","개봉제3동","개봉제3동제2투","대통령선거","서울특별시","구로구",2959,2026,819,431,515,114,131,3,1,0,0,0,0,1,3,2018,8,933
"17020","개봉제3동","개봉제3동제3투","대통령선거","서울특별시","구로구",3033,1931,766,397,511,107,128,1,0,1,3,0,0,2,1,1917,14,1102
"17021","개봉제3동","개봉제3동제4투","대통령선거","서울특별시","구로구",2723,2281,919,577,521,130,119,1,0,1,0,0,0,1,2,2271,10,442
"17022","개봉제3동","개봉제3동제5투","대통령선거","서울특별시","구로구",2570,1852,785,363,487,109,95,2,0,1,0,1,0,2,0,1845,7,718
"17023","오류제1동","관내사전투표","대통령선거","서울특별시","구로구",4128,4127,1804,1014,752,232,297,7,0,0,1,1,1,1,2,4112,15,1
"17024","오류제1동","오류제1동제1투","대통령선거","서울특별시","구로구",4022,2605,1144,545,546,159,195,4,0,2,0,2,1,0,1,2599,6,1417
"17025","오류제1동","오류제1동제2투","대통령선거","서울특별시","구로구",3444,2432,931,675,501,127,170,5,1,2,0,0,0,1,3,2416,16,1012
"17026","오류제1동","오류제1동제3투","대통령선거","서울특별시","구로구",3142,2165,709,734,453,135,106,4,0,1,0,1,0,2,6,2151,14,977
"17027","오류제1동","오류제1동제4투","대통령선거","서울특별시","구로구",2709,2192,795,603,535,117,129,4,0,0,0,1,0,0,1,2185,7,517
"17028","오류제2동","관내사전투표","대통령선거","서울특별시","구로구",5357,5357,2405,1284,1042,256,330,3,3,2,0,3,3,2,5,5338,19,0
"17029","오류제2동","오류제2동제1투","대통령선거","서울특별시","구로구",3455,2478,858,798,572,118,110,1,0,4,2,1,0,3,1,2468,10,977
"17030","오류제2동","오류제2동제2투","대통령선거","서울특별시","구로구",3285,2153,821,620,468,119,113,1,0,0,2,0,0,1,3,2148,5,1132
"17031","오류제2동","오류제2동제3투","대통령선거","서울특별시","구로구",3154,2428,957,655,507,143,149,0,0,3,0,2,0,0,3,2419,9,726
"17032","오류제2동","오류제2동제4투","대통령선거","서울특별시","구로구",3448,2544,982,627,578,145,182,13,0,0,1,1,1,0,3,2533,11,904
"17033","오류제2동","오류제2동제5투","대통령선거","서울특별시","구로구",3213,2465,1065,573,529,143,135,2,0,2,0,1,0,4,1,2455,10,748
"17034","오류제2동","오류제2동제6투","대통령선거","서울특별시","구로구",3476,2703,1219,536,573,160,189,6,0,2,0,1,1,2,1,2690,13,773
"17035","오류제2동","오류제2동제7투","대통령선거","서울특별시","구로구",3441,2775,1347,476,591,151,193,2,0,0,0,2,0,1,1,2764,11,666
"17036","오류제2동","오류제2동제8투","대통령선거","서울특별시","구로구",2680,2120,911,388,540,123,147,2,0,0,0,3,0,0,0,2114,6,560
"17037","수궁동","관내사전투표","대통령선거","서울특별시","구로구",3808,3808,1467,1315,576,203,214,9,2,2,1,4,0,1,2,3796,12,0
"17038","수궁동","수궁동제1투","대통령선거","서울특별시","구로구",2566,1694,401,804,304,101,79,0,0,0,0,0,0,1,0,1690,4,872
"17039","수궁동","수궁동제2투","대통령선거","서울특별시","구로구",2649,1918,737,539,399,116,110,1,1,1,0,1,0,0,2,1907,11,731
"17040","수궁동","수궁동제3투","대통령선거","서울특별시","구로구",3504,2565,920,805,520,111,182,10,0,1,0,0,0,2,3,2554,11,939
"17041","수궁동","수궁동제4투","대통령선거","서울특별시","구로구",2460,2036,854,488,478,115,92,0,0,1,1,0,0,0,0,2029,7,424
"17042","수궁동","수궁동제5투","대통령선거","서울특별시","구로구",2987,2178,887,550,469,125,132,3,0,2,0,1,2,0,1,2172,6,809
"17043","수궁동","수궁동제6투","대통령선거","서울특별시","구로구",1328,1029,446,233,214,61,63,3,1,0,0,1,0,1,2,1025,4,299
"17044","잘못 투입·구분된 투표지","잘못 투입·구분된 투표지","대통령선거","서울특별시","구로구",0,5,1,3,1,0,0,0,0,0,0,0,0,0,0,5,0,-5
"17045","거소·선상투표","거소·선상투표","대통령선거","서울특별시","금천구",321,301,128,48,86,13,10,1,2,1,0,1,1,0,2,293,8,20
"17046","관외사전투표","관외사전투표","대통령선거","서울특별시","금천구",17514,17504,8753,2354,3699,1189,1323,13,6,7,5,27,6,6,23,17411,93,10
"17047","재외투표","재외투표","대통령선거","서울특별시","금천구",1330,1033,632,88,148,37,122,3,0,0,0,1,0,0,0,1031,2,297
"17048","가산동","관내사전투표","대통령선거","서울특별시","금천구",3081,3081,1662,421,565,172,240,2,0,3,2,1,0,1,2,3071,10,0
"17049","가산동","가산동제1투","대통령선거","서울특별시","금천구",3052,1757,811,296,398,130,104,0,0,1,0,1,0,1,1,1743,14,1295
"17050","가산동","가산동제2투","대통령선거","서울특별시","금천구",2401,1576,763,239,336,114,106,1,0,2,0,2,1,2,0,1566,10,825
"17051","가산동","가산동제3투","대통령선거","서울특별시","금천구",2823,2229,966,442,542,141,126,2,1,0,0,0,1,0,2,2223,6,594
"17052","가산동","가산동제4투","대통령선거","서울특별시","금천구",2848,1846,931,313,357,105,123,1,0,2,1,0,0,0,5,1838,8,1002
"17053","가산동","가산동제5투","대통령선거","서울특별시","금천구",1043,694,311,172,134,33,37,0,0,0,0,0,1,0,0,688,6,349
"17054","가산동","가산동제6투","대통령선거","서울특별시","금천구",618,399,180,71,86,30,27,0,0,0,0,0,0,0,0,394,5,219
"17055","독산제1동","관내사전투표","대통령선거","서울특별시","금천구",3426,3426,1741,452,733,217,263,0,1,7,2,2,0,2,2,3422,4,0
"17056","독산제1동","독산제1동제1투","대통령선거","서울특별시","금천구",2734,1591,716,263,360,123,116,0,0,2,0,1,4,0,0,1585,6,1143
"17057","독산제1동","독산제1동제2투","대통령선거","서울특별시","금천구",2426,1511,723,279,308,94,95,3,0,1,0,0,0,1,1,1505,6,915
"17058","독산제1동","독산제1동제3투","대통령선거","서울특별시","금천구",4669,3148,1432,553,695,221,214,7,0,1,0,4,1,3,0,3131,17,1521
"17059","독산제1동","독산제1동제4투","대통령선거","서울특별시","금천구",3685,2998,1253,637,719,201,174,2,0,0,1,1,1,0,2,2991,7,687
"17060","독산제1동","독산제1동제5투","대통령선거","서울특별시","금천구",3262,2338,940,584,558,114,110,3,0,6,0,1,2,4,4,2326,12,924
"17061","독산제1동","독산제1동제6투","대통령선거","서울특별시","금천구",3817,2911,1144,712,670,181,187,3,0,4,0,0,1,0,3,2905,6,906
"17062","독산제1동","독산제1동제7투","대통령선거","서울특별시","금천구",3302,2799,1226,494,694,188,177,3,0,1,0,4,1,0,0,2788,11,503
"17063","독산제2동","관내사전투표","대통령선거","서울특별시","금천구",2178,2178,1029,373,501,117,139,6,0,2,2,1,0,0,1,2171,7,0
"17064","독산제2동","독산제2동제1투","대통령선거","서울특별시","금천구",2270,1345,516,299,368,71,80,3,0,3,0,2,0,0,1,1343,2,925
"17065","독산제2동","독산제2동제2투","대통령선거","서울특별시","금천구",2276,1479,575,345,387,82,76,2,0,1,1,4,0,1,1,1475,4,797
"17066","독산제2동","독산제2동제3투","대통령선거","서울특별시","금천구",2199,1437,586,300,360,82,100,1,0,2,0,2,0,0,0,1433,4,762
"17067","독산제2동","독산제2동제4투","대통령선거","서울특별시","금천구",2246,1507,596,335,401,72,89,2,0,1,1,2,0,1,1,1501,6,739
"17068","독산제2동","독산제2동제5투","대통령선거","서울특별시","금천구",2350,1397,585,275,389,74,64,5,0,0,2,0,0,1,0,1395,2,953
"17069","독산제2동","독산제2동제6투","대통령선거","서울특별시","금천구",2698,1789,752,376,436,91,116,6,0,2,0,2,2,1,2,1786,3,909
"17070","독산제3동","관내사전투표","대통령선거","서울특별시","금천구",3720,3720,1769,719,792,176,241,2,1,3,3,2,0,0,2,3710,10,0
"17071","독산제3동","독산제3동제1투","대통령선거","서울특별시","금천구",2946,1902,802,412,481,97,99,0,0,1,0,0,0,2,1,1895,7,1044
"17072","독산제3동","독산제3동제2투","대통령선거","서울특별시","금천구",3128,2141,876,464,559,113,118,3,0,0,0,0,0,2,1,2136,5,987
"17073","독산제3동","독산제3동제3투","대통령선거","서울특별시","금천구",3248,2137,905,449,518,105,144,2,0,2,0,5,0,1,2,2133,4,1111
"17074","독산제3동","독산제3동제4투","대통령선거","서울특별시","금천구",2839,1463,623,324,348,74,76,3,0,1,1,2,0,1,3,1456,7,1376
"17075","독산제3동","독산제3동제5투","대통령선거","서울특별시","금천구",2524,1693,748,378,410,81,68,1,0,0,1,0,0,0,1,1688,5,831
"17076","독산제3동","독산제3동제6투","대통령선거","서울특별시","금천구",2611,1795,753,404,430,90,103,1,2,2,1,0,0,1,1,1788,7,816
"17077","독산제4동","관내사전투표","대통령선거","서울특별시","금천구",3484,3484,1556,665,864,145,232,1,0,2,0,3,3,1,4,3476,8,0
"17078","독산제4동","독산제4동제1투","대통령선거","서울특별시","금천구",2892,1704,688,389,420,83,113,0,0,2,0,1,0,0,1,1697,7,1188
"17079","독산제4동","독산제4동제2투","대통령선거","서울특별시","금천구",2855,1845,722,418,482,79,129,2,1,2,0,3,0,2,1,1841,4,1010
"17080","독산제4동","독산제4동제3투","대통령선거","서울특별시","금천구",2292,1414,595,303,377,59,73,0,0,2,0,0,0,0,2,1411,3,878
"17081","독산제4동","독산제4동제4투","대통령선거","서울특별시","금천구",2937,2012,834,394,536,95,136,0,2,0,1,0,1,0,2,2001,11,925
"17082","시흥제1동","관내사전투표","대통령선거","서울특별시","금천구",5221,5221,2253,1129,1202,282,323,5,0,5,0,0,0,1,3,5203,18,0
"17083","시흥제1동","시흥제1동제1투","대통령선거","서울특별시","금천구",2609,1871,763,396,470,116,110,5,1,2,0,3,0,0,0,1866,5,738
"17084","시흥제1동","시흥제1동제2투","대통령선거","서울특별시","금천구",3205,2276,967,468,567,128,133,4,0,2,0,1,0,0,1,2271,5,929
"17085","시흥제1동","시흥제1동제3투","대통령선거","서울특별시","금천구",4497,3520,1526,698,858,227,195,0,1,0,0,3,0,2,2,3512,8,977
"17086","시흥제1동","시흥제1동제4투","대통령선거","서울특별시","금천구",2342,1379,530,288,396,70,84,3,1,0,0,0,1,0,1,1374,5,963
"17087","시흥제1동","시흥제1동제5투","대통령선거","서울특별시","금천구",2584,1575,608,401,395,81,79,0,0,1,2,2,1,1,0,1571,4,1009
"17088","시흥제1동","시흥제1동제6투","대통령선거","서울특별시","금천구",2323,1479,631,357,340,67,69,5,0,3,1,0,0,0,3,1476,3,844
"17089","시흥제1동","시흥제1동제7투","대통령선거","서울특별시","금천구",2176,1399,568,335,348,60,70,5,2,1,0,0,0,1,3,1393,6,777
"17090","시흥제1동","시흥제1동제8투","대통령선거","서울특별시","금천구",2749,1449,540,340,386,75,96,2,0,2,0,0,0,0,1,1442,7,1300
"17091","시흥제2동","관내사전투표","대통령선거","서울특별시","금천구",3494,3494,1634,669,767,182,222,4,1,3,0,6,1,0,2,3491,3,0
"17092","시흥제2동","시흥제2동제1투","대통령선거","서울특별시","금천구",2374,1437,570,329,361,81,82,0,0,1,0,3,0,0,1,1428,9,937
"17093","시흥제2동","시흥제2동제2투","대통령선거","서울특별시","금천구",2359,1775,692,389,477,99,109,2,0,0,0,2,0,1,0,1771,4,584
"17094","시흥제2동","시흥제2동제3투","대통령선거","서울특별시","금천구",2599,2146,758,605,515,140,113,6,0,0,0,1,0,1,2,2141,5,453
"17095","시흥제2동","시흥제2동제4투","대통령선거","서울특별시","금천구",2681,2236,886,530,548,141,122,2,0,0,0,2,0,0,0,2231,5,445
"17096","시흥제2동","시흥제2동제5투","대통령선거","서울특별시","금천구",2479,1993,945,320,444,159,112,5,0,2,0,1,0,1,0,1989,4,486
"17097","시흥제2동","시흥제2동제6투","대통령선거","서울특별시","금천구",1834,1235,479,275,329,71,68,1,0,1,1,1,0,1,3,1230,5,599
"17098","시흥제3동","관내사전투표","대통령선거","서울특별시","금천구",2213,2213,988,464,507,117,122,2,0,4,1,1,0,1,3,2210,3,0
"17099","시흥제3동","시흥제3동제1투","대통령선거","서울특별시","금천구",2472,1635,640,383,419,85,97,2,0,2,0,0,0,1,2,1631,4,837
"17100","시흥제3동","시흥제3동제2투","대통령선거","서울특별시","금천구",1864,1315,509,288,351,77,81,2,0,1,1,0,0,1,2,1313,2,549
"17101","시흥제3동","시흥제3동제3투","대통령선거","서울특별시","금천구",1814,1320,504,317,329,67,94,2,0,2,1,0,0,1,0,1317,3,494
"17102","시흥제3동","시흥제3동제4투","대통령선거","서울특별시","금천구",1241,954,344,261,238,57,51,0,0,1,0,0,0,0,1,953,1,287
"17103","시흥제4동","관내사전투표","대통령선거","서울특별시","금천구",3316,3316,1518,669,738,178,202,0,0,1,0,1,0,4,1,3312,4,0
"17104","시흥제4동","시흥제4동제1투","대통령선거","서울특별시","금천구",2389,1551,594,369,422,77,80,0,0,3,0,0,0,0,0,1545,6,838
"17105","시흥제4동","시흥제4동제2투","대통령선거","서울특별시","금천구",2206,1177,443,281,318,57,67,0,0,0,0,1,2,0,2,1171,6,1029
"17106","시흥제4동","시흥제4동제3투","대통령선거","서울특별시","금천구",2066,1406,570,353,338,50,83,1,0,2,0,1,0,0,1,1399,7,660
"17107","시흥제4동","시흥제4동제4투","대통령선거","서울특별시","금천구",2454,1846,757,417,437,107,115,2,0,1,2,2,0,0,0,1840,6,608
"17108","시흥제4동","시흥제4동제5투","대통령선거","서울특별시","금천구",2535,1712,647,384,467,91,108,0,1,3,0,0,0,0,4,1705,7,823
"17109","시흥제4동","시흥제4동제6투","대통령선거","서울특별시","금천구",2512,1770,722,386,428,102,114,2,1,3,0,1,0,1,3,1763,7,742
"17110","시흥제5동","관내사전투표","대통령선거","서울특별시","금천구",3637,3637,1594,770,826,188,228,2,0,5,0,3,0,2,3,3621,16,0
"17111","시흥제5동","시흥제5동제1투","대통령선거","서울특별시","금천구",2444,1570,582,371,381,114,103,2,0,1,2,0,2,0,3,1561,9,874
"17112","시흥제5동","시흥제5동제2투","대통령선거","서울특별시","금천구",3198,2004,785,463,518,117,99,7,0,2,0,1,2,1,0,1995,9,1194
"17113","시흥제5동","시흥제5동제3투","대통령선거","서울특별시","금천구",3153,2226,879,487,596,118,121,3,0,0,0,1,2,1,4,2212,14,927
"17114","시흥제5동","시흥제5동제4투","대통령선거","서울특별시","금천구",2663,1733,626,434,465,77,104,4,0,5,1,1,0,3,2,1722,11,930
"17115","시흥제5동","시흥제5동제5투","대통령선거","서울특별시","금천구",2384,1556,549,440,367,88,92,1,0,0,1,4,2,2,1,1547,9,828
"17116","잘못 투입·구분된 투표지","잘못 투입·구분된 투표지","대통령선거","서울특별시","금천구",0,0,0,0,0,0,0,0,0,0,0,0,0,0,0,0,0,0
"17117","거소·선상투표","거소·선상투표","대통령선거","서울특별시","영등포구",430,410,152,74,125,24,18,2,3,0,0,0,0,1,0,399,11,20
"17118","관외사전투표","관외사전투표","대통령선거","서울특별시","영등포구",29545,29516,14034,4400,5984,2457,2381,30,4,8,2,18,6,11,32,29367,149,29
"17119","재외투표","재외투표","대통령선거","서울특별시","영등포구",3835,2980,1672,316,481,135,341,16,2,1,0,2,0,1,0,2967,13,855
"17120","영등포본동","관내사전투표","대통령선거","서울특별시","영등포구",3341,3341,1547,652,686,210,222,4,2,0,1,6,0,0,0,3330,11,0
"17121","영등포본동","영등포본동제1투","대통령선거","서울특별시","영등포구",2524,1869,772,488,385,99,109,3,0,0,0,0,1,0,5,1862,7,655
"17122","영등포본동","영등포본동제2투","대통령선거","서울특별시","영등포구",2110,1446,531,385,346,102,68,2,0,2,0,1,0,2,4,1443,3,664
"17123","영등포본동","영등포본동제3투","대통령선거","서울특별시","영등포구",1553,942,361,260,226,41,51,0,0,1,0,1,1,0,0,942,0,611
"17124","영등포본동","영등포본동제4투","대통령선거","서울특별시","영등포구",1908,1060,398,270,275,54,52,1,1,2,0,0,0,0,2,1055,5,848
"17125","영등포본동","영등포본동제5투","대통령선거","서울특별시","영등포구",1371,933,382,248,209,42,44,2,0,0,0,0,0,0,1,928,5,438
"17126","영등포본동","영등포본동제6투","대통령선거","서울특별시","영등포구",2532,2055,880,408,476,145,133,7,0,0,0,0,2,0,1,2052,3,477
"17127","영등포본동","영등포본동제7투","대통령선거","서울특별시","영등포구",2853,2419,1149,407,531,188,133,2,0,2,1,1,0,0,0,2414,5,434
"17128","영등포동","관내사전투표","대통령선거","서울특별시","영등포구",2187,2187,954,504,417,138,151,2,1,1,0,4,0,2,1,2175,12,0
"17129","영등포동","영등포동제1투","대통령선거","서울특별시","영등포구",2276,1258,538,251,250,101,109,3,0,0,2,1,0,0,1,1256,2,1018
"17130","영등포동","영등포동제2투","대통령선거","서울특별시","영등포구",2979,1481,569,337,415,82,69,0,0,1,0,1,0,1,1,1476,5,1498
"17131","영등포동","영등포동제3투","대통령선거","서울특별시","영등포구",2689,1909,779,488,401,112,110,4,0,4,0,0,1,0,0,1899,10,780
"17132","영등포동","영등포동제4투","대통령선거","서울특별시","영등포구",2424,1161,537,217,232,100,65,2,0,0,1,1,0,1,1,1157,4,1263
"17133","영등포동","영등포동제5투","대통령선거","서울특별시","영등포구",2954,2206,866,458,498,201,160,7,1,0,1,2,0,1,1,2196,10,748
"17134","여의동","관내사전투표","대통령선거","서울특별시","영등포구",5110,5110,1869,1470,945,536,262,7,0,3,0,2,0,1,4,5099,11,0
"17135","여의동","여의동제1투","대통령선거","서울특별시","영등포구",2594,1975,667,601,392,184,103,15,0,0,4,1,0,2,1,1970,5,619
"17136","여의동","여의동제2투","대통령선거","서울특별시","영등포구",3019,1762,488,614,390,191,76,1,0,0,0,0,0,1,0,1761,1,1257
"17137","여의동","여의동제3투","대통령선거","서울특별시","영등포구",2595,2072,617,682,460,231,70,3,0,1,0,0,0,1,0,2065,7,523
"17138","여의동","여의동제4투","대통령선거","서울특별시","영등포구",2489,1830,505,686,375,185,68,5,0,0,0,0,1,0,0,1825,5,659
"17139","여의동","여의동제5투","대통령선거","서울특별시","영등포구",2514,2007,575,656,462,203,94,6,0,1,0,1,0,0,1,1999,8,507
"17140","여의동","여의동제6투","대통령선거","서울특별시","영등포구",2733,2108,622,713,463,225,75,5,0,0,0,0,0,3,0,2106,2,625
"17141","여의동","여의동제7투","대통령선거","서울특별시","영등포구",2958,2204,435,968,478,237,79,3,0,0,0,1,0,0,0,2201,3,754
"17142","여의동","여의동제8투","대통령선거","서울특별시","영등포구",1184,840,331,191,193,89,31,2,0,2,0,1,0,0,0,840,0,344
"17143","당산제1동","관내사전투표","대통령선거","서울특별시","영등포구",4207,4207,2145,659,765,308,311,5,0,0,1,1,0,0,1,4196,11,0
"17144","당산제1동","당산제1동제1투","대통령선거","서울특별시","영등포구",1543,1040,414,255,230,69,61,1,1,0,0,3,1,1,1,1037,3,503
"17145","당산제1동","당산제1동제2투","대통령선거","서울특별시","영등포구",2850,2064,805,496,452,155,139,4,0,2,2,0,0,2,3,2060,4,786
"17146","당산제1동","당산제1동제3투","대통령선거","서울특별시","영등포구",2816,2173,891,459,505,185,121,0,0,0,1,2,0,2,0,2166,7,643
"17147","당산제1동","당산제1동제4투","대통령선거","서울특별시","영등포구",3639,2447,922,637,549,186,136,4,1,3,0,1,1,0,0,2440,7,1192
"17148","당산제1동","당산제1동제5투","대통령선거","서울특별시","영등포구",2329,1768,789,344,353,140,127,7,0,2,0,0,0,0,0,1762,6,561
"17149","당산제2동","관내사전투표","대통령선거","서울특별시","영등포구",5210,5210,2502,891,915,476,408,6,0,1,0,2,0,0,1,5202,8,0
"17150","당산제2동","당산제2동제1투","대통령선거","서울특별시","영등포구",3372,2428,1099,444,457,221,189,4,0,1,0,3,0,1,1,2420,8,944
"17151","당산제2동","당산제2동제2투","대통령선거","서울특별시","영등포구",3449,2387,969,541,501,202,158,4,0,2,0,0,0,0,2,2379,8,1062
"17152","당산제2동","당산제2동제3투","대통령선거","서울특별시","영등포구",3623,2762,1169,522,626,239,184,6,0,0,3,4,0,1,0,2754,8,861
"17153","당산제2동","당산제2동제4투","대통령선거","서울특별시","영등포구",2668,2107,893,413,491,172,121,5,0,0,1,0,1,1,0,2098,9,561
"17154","당산제2동","당산제2동제5투","대통령선거","서울특별시","영등포구",3219,2692,817,863,648,240,116,1,0,0,1,2,0,0,0,2688,4,527
"17155","당산제2동","당산제2동제6투","대통령선거","서울특별시","영등포구",3102,2520,1079,522,535,234,141,2,1,0,0,0,1,1,0,2516,4,582
"17156","당산제2동","당산제2동제7투","대통령선거","서울특별시","영등포구",1614,1243,660,128,203,135,113,0,1,0,0,0,0,0,1,1241,2,371
"17157","도림동","관내사전투표","대통령선거","서울특별시","영등포구",3029,3029,1534,454,603,186,236,1,0,3,0,1,0,0,1,3019,10,0
"17158","도림동","도림동제1투","대통령선거","서울특별시","영등포구",3294,2142,836,567,533,107,82,3,1,0,1,1,1,1,1,2134,8,1152
"17159","도림동","도림동제2투","대통령선거","서울특별시","영등포구",2968,1998,776,501,502,108,91,4,1,2,1,2,1,1,2,1992,6,970
"17160","도림동","도림동제3투","대통령선거","서울특별시","영등포구",3237,2136,1009,360,464,158,129,4,0,4,0,2,1,0,1,2132,4,1101
"17161","도림동","도림동제4투","대통령선거","서울특별시","영등포구",3039,2243,959,479,540,139,112,5,0,2,0,1,1,0,1,2239,4,796
"17162","문래동","관내사전투표","대통령선거","서울특별시","영등포구",4900,4899,2404,902,899,355,312,9,0,3,1,1,0,2,4,4892,7,1
"17163","문래동","문래동제1투","대통령선거","서울특별시","영등포구",1861,912,333,255,208,60,47,0,0,2,1,0,0,1,2,909,3,949
"17164","문래동","문래동제2투","대통령선거","서울특별시","영등포구",2049,1702,637,431,389,149,93,1,0,0,1,0,0,1,0,1702,0,347
"17165","문래동","문래동제3투","대통령선거","서울특별시","영등포구",2920,2319,1055,449,479,163,159,2,0,4,0,0,0,2,2,2315,4,601
"17166","문래동","문래동제4투","대통령선거","서울특별시","영등포구",2495,2054,617,663,488,190,86,4,0,0,0,2,1,0,1,2052,2,441
"17167","문래동","문래동제5투","대통령선거","서울특별시","영등포구",3157,2460,989,601,506,176,167,2,0,2,0,1,3,0,4,2451,9,697
"17168","문래동","문래동제6투","대통령선거","서울특별시","영등포구",2895,2445,1249,337,519,180,155,1,0,2,0,0,0,0,0,2443,2,450
"17169","문래동","문래동제7투","대통령선거","서울특별시","영등포구",2965,2468,1125,461,523,192,149,4,0,4,0,1,0,1,1,2461,7,497
"17170","양평제1동","관내사전투표","대통령선거","서울특별시","영등포구",2935,2935,1440,483,572,213,211,2,0,0,2,1,0,2,1,2927,8,0
"17171","양평제1동","양평제1동제1투","대통령선거","서울특별시","영등포구",2416,1530,496,472,371,78,96,1,0,0,1,1,2,1,3,1522,8,886
"17172","양평제1동","양평제1동제2투","대통령선거","서울특별시","영등포구",2890,2250,1144,329,446,185,138,0,0,1,0,0,0,0,2,2245,5,640
"17173","양평제1동","양평제1동제3투","대통령선거","서울특별시","영등포구",2326,1649,721,385,313,132,84,5,0,0,0,0,0,2,2,1644,5,677
"17174","양평제1동","양평제1동제4투","대통령선거","서울특별시","영등포구",2585,1993,962,333,418,143,129,0,0,3,0,0,0,1,2,1991,2,592
"17175","양평제2동","관내사전투표","대통령선거","서울특별시","영등포구",3045,3045,1527,486,581,201,224,1,2,0,0,2,1,1,2,3028,17,0
"17176","양평제2동","양평제2동제1투","대통령선거","서울특별시","영등포구",2749,2251,1072,408,444,169,149,3,0,0,0,0,0,1,0,2246,5,498
"17177","양평제2동","양평제2동제2투","대통령선거","서울특별시","영등포구",2471,1900,812,378,415,154,127,1,1,1,1,0,0,1,0,1891,9,571
"17178","양평제2동","양평제2동제3투","대통령선거","서울특별시","영등포구",2383,1536,703,299,289,138,99,1,0,0,0,2,0,0,0,1531,5,847
"17179","양평제2동","양평제2동제4투","대통령선거","서울특별시","영등포구",2577,2174,965,436,471,155,134,3,0,1,0,1,1,2,2,2171,3,403
"17180","양평제2동","양평제2동제5투","대통령선거","서울특별시","영등포구",2807,2170,1026,352,436,168,174,0,0,1,1,1,0,0,1,2160,10,637
"17181","신길제1동","관내사전투표","대통령선거","서울특별시","영등포구",2520,2520,1198,497,480,152,176,2,0,2,1,0,1,1,2,2512,8,0
"17182","신길제1동","신길제1동제1투","대통령선거","서울특별시","영등포구",2731,1886,821,369,426,123,129,8,0,2,0,0,0,0,0,1878,8,845
"17183","신길제1동","신길제1동제2투","대통령선거","서울특별시","영등포구",2208,1427,591,345,303,95,86,0,0,0,0,1,0,2,0,1423,4,781
"17184","신길제1동","신길제1동제3투","대통령선거","서울특별시","영등포구",2694,1607,673,389,355,88,87,0,0,1,1,0,1,1,1,1597,10,1087
"17185","신길제1동","신길제1동제4투","대통령선거","서울특별시","영등포구",2532,1764,659,489,401,100,97,3,0,2,0,2,0,1,3,1757,7,768
"17186","신길제1동","신길제1동제5투","대통령선거","서울특별시","영등포구",2481,1739,652,404,457,114,107,0,0,1,0,0,1,0,0,1736,3,742
"17187","신길제3동","관내사전투표","대통령선거","서울특별시","영등포구",1770,1770,811,406,369,82,88,4,0,1,0,0,1,0,1,1763,7,0
"17188","신길제3동","신길제3동제1투","대통령선거","서울특별시","영등포구",2179,1415,511,389,371,62,66,1,1,0,2,1,0,1,5,1410,5,764
"17189","신길제3동","신길제3동제2투","대통령선거","서울특별시","영등포구",2570,1597,639,413,338,93,101,1,0,0,0,1,1,0,2,1589,8,973
"17190","신길제3동","신길제3동제3투","대통령선거","서울특별시","영등포구",2309,1893,758,462,430,120,116,0,0,0,0,0,0,1,0,1887,6,416
"17191","신길제3동","신길제3동제4투","대통령선거","서울특별시","영등포구",1633,1073,425,307,232,55,38,3,2,0,2,0,1,0,1,1066,7,560
"17192","신길제3동","신길제3동제5투","대통령선거","서울특별시","영등포구",2127,1642,703,350,381,111,87,2,1,5,0,1,0,0,0,1641,1,485
"17193","신길제4동","관내사전투표","대통령선거","서울특별시","영등포구",1465,1465,687,298,300,84,81,1,0,1,1,3,0,1,1,1458,7,0
"17194","신길제4동","신길제4동제1투","대통령선거","서울특별시","영등포구",2189,1316,526,313,331,59,66,5,1,3,1,1,0,2,0,1308,8,873
"17195","신길제4동","신길제4동제2투","대통령선거","서울특별시","영등포구",2327,1407,524,412,310,64,80,4,0,0,0,2,0,3,3,1402,5,920
"17196","신길제4동","신길제4동제3투","대통령선거","서울특별시","영등포구",2228,1759,673,414,436,129,93,8,0,0,0,1,1,0,1,1756,3,469
"17197","신길제5동","관내사전투표","대통령선거","서울특별시","영등포구",1812,1812,808,362,428,99,104,2,0,1,0,0,0,0,1,1805,7,0
"17198","신길제5동","신길제5동제1투","대통령선거","서울특별시","영등포구",1818,1032,421,274,237,39,52,0,0,0,0,1,0,1,1,1026,6,786
"17199","신길제5동","신길제5동제2투","대통령선거","서울특별시","영등포구",612,443,169,115,106,29,24,0,0,0,0,0,0,0,0,443,0,169
"17200","신길제5동","신길제5동제3투","대통령선거","서울특별시","영등포구",2112,1413,551,360,344,74,71,3,0,0,0,1,0,2,0,1406,7,699
"17201","신길제5동","신길제5동제4투","대통령선거","서울특별시","영등포구",1672,1106,444,279,281,52,39,4,0,3,0,0,0,2,0,1104,2,566
"17202","신길제5동","신길제5동제5투","대통령선거","서울특별시","영등포구",1629,1072,436,251,278,49,49,2,0,0,0,1,0,0,0,1066,6,557
"17203","신길제6동","관내사전투표","대통령선거","서울특별시","영등포구",3324,3323,1475,680,734,203,207,3,0,3,1,3,1,1,1,3312,11,1
"17204","신길제6동","신길제6동제1투","대통령선거","서울특별시","영등포구",1971,986,365,251,248,49,68,0,0,1,0,0,0,0,0,982,4,985
"17205","신길제6동","신길제6동제2투","대통령선거","서울특별시","영등포구",2431,1905,741,438,446,145,122,6,1,0,1,1,0,0,0,1901,4,526
"17206","신길제6동","신길제6동제3투","대통령선거","서울특별시","영등포구",2522,1972,832,419,463,139,111,1,0,0,0,0,1,0,0,1966,6,550
"17207","신길제6동","신길제6동제4투","대통령선거","서울특별시","영등포구",2845,2019,835,440,463,137,130,0,0,1,2,2,2,0,1,2013,6,826
"17208","신길제6동","신길제6동제5투","대통령선거","서울특별시","영등포구",2128,1460,567,378,336,75,93,3,0,1,1,2,0,0,2,1458,2,668
"17209","신길제7동","관내사전투표","대통령선거","서울특별시","영등포구",2300,2300,846,546,520,213,159,4,0,1,0,1,0,1,3,2294,6,0
"17210","신길제7동","신길제7동제1투","대통령선거","서울특별시","영등포구",538,414,103,76,150,68,15,0,0,0,0,0,0,0,0,412,2,124
"17211","신길제7동","신길제7동제2투","대통령선거","서울특별시","영등포구",1156,809,275,250,175,63,42,1,0,0,0,1,0,0,0,807,2,347
"17212","신길제7동","신길제7동제3투","대통령선거","서울특별시","영등포구",2373,1410,580,291,301,122,105,3,0,0,0,0,1,0,1,1404,6,963
"17213","신길제7동","신길제7동제4투","대통령선거","서울특별시","영등포구",2519,2021,679,538,480,207,108,1,1,1,0,0,2,0,1,2018,3,498
"17214","대림제1동","관내사전투표","대통령선거","서울특별시","영등포구",2136,2136,946,432,503,110,132,4,0,1,0,0,0,1,1,2130,6,0
"17215","대림제1동","대림제1동제1투","대통령선거","서울특별시","영등포구",2180,1295,485,326,322,64,83,1,1,6,1,1,0,1,0,1291,4,885
"17216","대림제1동","대림제1동제2투","대통령선거","서울특별시","영등포구",2235,1537,613,364,382,76,91,0,0,2,0,2,1,0,2,1533,4,698
"17217","대림제1동","대림제1동제3투","대통령선거","서울특별시","영등포구",922,634,262,129,160,47,34,1,0,0,0,0,0,0,0,633,1,288
"17218","대림제1동","대림제1동제4투","대통령선거","서울특별시","영등포구",2289,1521,625,300,413,80,94,3,0,0,0,3,0,1,0,1519,2,768
"17219","대림제1동","대림제1동제5투","대통령선거","서울특별시","영등포구",1558,935,381,230,230,40,39,7,0,2,0,1,0,0,0,930,5,623
"17220","대림제2동","관내사전투표","대통령선거","서울특별시","영등포구",1846,1846,955,308,396,81,87,6,0,2,0,1,1,1,0,1838,8,0
"17221","대림제2동","대림제2동제1투","대통령선거","서울특별시","영등포구",1341,664,281,173,150,33,22,0,0,0,0,0,0,0,1,660,4,677
"17222","대림제2동","대림제2동제2투","대통령선거","서울특별시","영등포구",1296,815,328,205,203,33,42,1,0,1,0,0,0,0,0,813,2,481
"17223","대림제2동","대림제2동제3투","대통령선거","서울특별시","영등포구",1889,1252,513,323,274,69,57,3,1,1,0,0,1,1,1,1244,8,637
"17224","대림제2동","대림제2동제4투","대통령선거","서울특별시","영등포구",2843,2027,866,472,450,123,102,4,1,1,1,0,1,0,0,2021,6,816
"17225","대림제2동","대림제2동제5투","대통령선거","서울특별시","영등포구",1763,1087,484,237,252,53,53,4,0,0,1,0,0,0,2,1086,1,676
"17226","대림제3동","관내사전투표","대통령선거","서울특별시","영등포구",3051,3051,1430,519,720,158,194,4,1,7,0,3,0,1,3,3040,11,0
"17227","대림제3동","대림제3동제1투","대통령선거","서울특별시","영등포구",2685,1956,802,434,473,106,110,7,0,2,1,3,3,2,2,1945,11,729
"17228","대림제3동","대림제3동제2투","대통령선거","서울특별시","영등포구",2294,1529,589,368,404,94,66,0,1,0,0,0,1,0,2,1525,4,765
"17229","대림제3동","대림제3동제3투","대통령선거","서울특별시","영등포구",2004,1433,585,317,363,75,82,1,0,1,1,0,0,0,1,1426,7,571
"17230","대림제3동","대림제3동제4투","대통령선거","서울특별시","영등포구",1871,1194,500,284,285,53,66,1,1,0,1,0,0,0,1,1192,2,677
"17231","대림제3동","대림제3동제5투","대통령선거","서울특별시","영등포구",2396,1489,607,342,377,72,76,2,1,3,0,0,0,0,1,1481,8,907
"17232","대림제3동","대림제3동제6투","대통령선거","서울특별시","영등포구",2384,1861,786,388,460,102,111,2,0,2,0,0,1,0,3,1855,6,523
"17233","대림제3동","대림제3동제7투","대통령선거","서울특별시","영등포구",2962,2424,1042,520,533,186,119,8,0,2,0,0,1,1,2,2414,10,538
"17234","잘못 투입·구분된 투표지","잘못 투입·구분된 투표지","대통령선거","서울특별시","영등포구",0,1,1,0,0,0,0,0,0,0,0,0,0,0,0,1,0,-1
"17235","거소·선상투표","거소·선상투표","대통령선거","서울특별시","동작구",464,441,156,85,140,28,13,2,2,0,1,1,0,1,3,432,9,23
"17236","관외사전투표","관외사전투표","대통령선거","서울특별시","동작구",35518,35518,17239,5079,6980,2996,2930,46,6,13,9,21,3,9,31,35362,156,0
"17237","재외투표","재외투표","대통령선거","서울특별시","동작구",4197,3255,1896,313,543,120,357,13,0,0,0,0,0,0,0,3242,13,942
"17238","노량진제1동","관내사전투표","대통령선거","서울특별시","동작구",3490,3490,1732,592,650,273,223,4,0,1,1,1,0,1,2,3480,10,0
"17239","노량진제1동","노량진제1동제1투","대통령선거","서울특별시","동작구",2846,2304,925,543,514,186,123,5,0,1,0,0,0,0,1,2298,6,542
"17240","노량진제1동","노량진제1동제2투","대통령선거","서울특별시","동작구",2611,1940,891,409,388,131,111,0,0,1,0,0,1,0,0,1932,8,671
"17241","노량진제1동","노량진제1동제3투","대통령선거","서울특별시","동작구",2168,1743,671,388,425,152,97,2,0,0,0,0,0,0,0,1735,8,425
"17242","노량진제1동","노량진제1동제4투","대통령선거","서울특별시","동작구",2670,1531,688,330,301,101,94,7,0,0,0,0,0,1,1,1523,8,1139
"17243","노량진제1동","노량진제1동제5투","대통령선거","서울특별시","동작구",2065,1508,547,425,353,104,70,0,0,1,0,2,0,1,0,1503,5,557
"17244","노량진제1동","노량진제1동제6투","대통령선거","서울특별시","동작구",2919,2099,819,463,515,152,127,5,0,3,0,4,1,3,1,2093,6,820
"17245","노량진제1동","노량진제1동제7투","대통령선거","서울특별시","동작구",1557,1298,506,317,275,130,61,4,0,1,1,0,0,0,1,1296,2,259
"17246","노량진제1동","노량진제1동제8투","대통령선거","서울특별시","동작구",1678,1288,487,296,314,105,82,1,0,2,0,1,0,0,0,1288,0,390
"17247","노량진제1동","노량진제1동제9투","대통령선거","서울특별시","동작구",1757,1424,561,334,310,126,85,3,0,1,0,1,0,0,2,1423,1,333
"17248","노량진제2동","관내사전투표","대통령선거","서울특별시","동작구",4454,4454,2188,724,851,351,306,9,0,2,0,3,0,2,0,4436,18,0
"17249","노량진제2동","노량진제2동제1투","대통령선거","서울특별시","동작구",1435,1000,394,269,241,55,40,1,0,0,0,0,0,0,0,1000,0,435
"17250","노량진제2동","노량진제2동제2투","대통령선거","서울특별시","동작구",2891,1853,737,476,412,111,95,5,0,4,0,1,0,1,1,1843,10,1038
"17251","노량진제2동","노량진제2동제3투","대통령선거","서울특별시","동작구",2564,1691,656,412,424,95,84,2,1,2,0,2,0,4,0,1682,9,873
"17252","노량진제2동","노량진제2동제4투","대통령선거","서울특별시","동작구",2171,1408,567,366,310,73,76,3,0,2,0,2,1,2,1,1403,5,763
"17253","상도제1동","관내사전투표","대통령선거","서울특별시","동작구",7975,7975,3716,1410,1555,688,555,9,0,5,1,5,0,1,2,7947,28,0
"17254","상도제1동","상도제1동제1투","대통령선거","서울특별시","동작구",3845,2740,1168,569,567,229,186,4,1,3,0,2,1,1,1,2732,8,1105
"17255","상도제1동","상도제1동제2투","대통령선거","서울특별시","동작구",3584,2552,1016,534,551,261,175,3,0,0,0,0,0,0,2,2542,10,1032
"17256","상도제1동","상도제1동제3투","대통령선거","서울특별시","동작구",3127,2335,989,472,547,160,153,5,0,0,2,1,0,0,1,2330,5,792
"17257","상도제1동","상도제1동제4투","대통령선거","서울특별시","동작구",2938,2198,844,474,586,162,115,4,1,1,1,4,0,0,0,2192,6,740
"17258","상도제1동","상도제1동제5투","대통령선거","서울특별시","동작구",3371,2263,810,565,563,199,115,2,0,0,0,1,0,2,0,2257,6,1108
"17259","상도제1동","상도제1동제6투","대통령선거","서울특별시","동작구",2908,2166,828,502,506,178,135,3,1,1,1,0,0,0,1,2156,10,742
"17260","상도제1동","상도제1동제7투","대통령선거","서울특별시","동작구",2821,2010,895,337,417,189,150,6,0,3,1,1,1,0,0,2000,10,811
"17261","상도제1동","상도제1동제8투","대통령선거","서울특별시","동작구",3660,3090,1433,489,679,315,166,0,0,0,1,0,0,1,1,3085,5,570
"17262","상도제2동","관내사전투표","대통령선거","서울특별시","동작구",4956,4956,2465,824,1005,343,298,8,0,1,0,0,0,3,0,4947,9,0
"17263","상도제2동","상도제2동제1투","대통령선거","서울특별시","동작구",3992,3014,1246,643,729,218,152,9,0,0,0,0,0,2,2,3001,13,978
"17264","상도제2동","상도제2동제2투","대통령선거","서울특별시","동작구",2997,1925,773,426,462,138,119,1,0,0,0,0,0,2,3,1924,1,1072
"17265","상도제2동","상도제2동제3투","대통령선거","서울특별시","동작구",3211,2479,1059,485,567,194,152,1,0,2,0,1,0,2,2,2465,14,732
"17266","상도제2동","상도제2동제4투","대통령선거","서울특별시","동작구",3049,2481,997,522,599,240,113,1,0,1,1,0,1,1,1,2477,4,568
"17267","상도제2동","상도제2동제5투","대통령선거","서울특별시","동작구",2821,1948,778,451,480,112,121,1,0,0,0,0,0,0,1,1944,4,873
"17268","상도제3동","관내사전투표","대통령선거","서울특별시","동작구",6204,6204,3032,1059,1267,363,441,6,0,4,0,4,1,1,5,6183,21,0
"17269","상도제3동","상도제3동제1투","대통령선거","서울특별시","동작구",3719,2665,1105,561,620,197,166,3,0,1,0,1,0,0,4,2658,7,1054
"17270","상도제3동","상도제3동제2투","대통령선거","서울특별시","동작구",3008,1911,823,423,415,119,116,3,0,0,0,2,1,1,1,1904,7,1097
"17271","상도제3동","상도제3동제3투","대통령선거","서울특별시","동작구",2578,1769,787,310,447,94,120,0,1,1,1,2,0,0,1,1764,5,809
"17272","상도제3동","상도제3동제4투","대통령선거","서울특별시","동작구",2386,1689,755,336,386,105,99,0,0,1,1,1,0,1,0,1685,4,697
"17273","상도제3동","상도제3동제5투","대통령선거","서울특별시","동작구",3738,2759,1259,469,717,148,147,3,1,4,0,1,1,0,1,2751,8,979
"17274","상도제4동","관내사전투표","대통령선거","서울특별시","동작구",2830,2830,1413,482,575,166,176,0,1,3,0,1,1,0,2,2820,10,0
"17275","상도제4동","상도제4동제1투","대통령선거","서울특별시","동작구",2406,1527,689,300,339,86,95,2,0,1,1,2,0,1,2,1518,9,879
"17276","상도제4동","상도제4동제2투","대통령선거","서울특별시","동작구",2714,1754,752,366,409,109,102,2,0,1,2,0,0,0,2,1745,9,960
"17277","상도제4동","상도제4동제3투","대통령선거","서울특별시","동작구",2939,1956,834,375,463,127,143,5,1,0,0,0,0,0,1,1949,7,983
"17278","상도제4동","상도제4동제4투","대통령선거","서울특별시","동작구",2570,1743,783,342,388,118,99,1,0,3,0,1,0,0,2,1737,6,827
"17279","상도제4동","상도제4동제5투","대통령선거","서울특별시","동작구",4127,3185,1274,742,743,231,174,3,0,4,0,2,0,1,3,3177,8,942
"17280","상도제4동","상도제4동제6투","대통령선거","서울특별시","동작구",3672,2641,1196,531,577,159,161,3,0,3,0,1,0,2,2,2635,6,1031
"17281","흑석동","관내사전투표","대통령선거","서울특별시","동작구",5857,5857,2492,1266,1197,466,400,11,0,4,0,1,1,2,2,5842,15,0
"17282","흑석동","흑석동제1투","대통령선거","서울특별시","동작구",2816,2130,703,586,498,230,104,4,0,0,0,0,0,0,0,2125,5,686
"17283","흑석동","흑석동제2투","대통령선거","서울특별시","동작구",2672,1431,542,384,308,108,77,1,0,1,0,0,1,0,1,1423,8,1241
"17284","흑석동","흑석동제3투","대통령선거","서울특별시","동작구",1691,1134,433,303,260,67,65,0,0,1,0,0,1,1,2,1133,1,557
"17285","흑석동","흑석동제4투","대통령선거","서울특별시","동작구",2612,1668,680,375,405,90,103,3,0,4,0,1,0,0,0,1661,7,944
"17286","흑석동","흑석동제5투","대통령선거","서울특별시","동작구",2060,1455,576,317,315,126,108,2,0,1,0,1,0,1,0,1447,8,605
"17287","흑석동","흑석동제6투","대통령선거","서울특별시","동작구",2092,1426,532,324,350,114,93,1,0,2,0,1,0,1,0,1418,8,666
"17288","흑석동","흑석동제7투","대통령선거","서울특별시","동작구",3139,2447,1041,472,547,221,155,2,0,3,0,0,0,1,1,2443,4,692
"17289","흑석동","흑석동제8투","대통령선거","서울특별시","동작구",2333,1804,704,372,411,189,110,4,0,4,1,1,0,0,0,1796,8,529
"17290","사당제1동","관내사전투표","대통령선거","서울특별시","동작구",3598,3598,1784,552,719,241,271,3,1,1,2,2,4,3,2,3585,13,0
"17291","사당제1동","사당제1동제1투","대통령선거","서울특별시","동작구",3857,2942,1333,568,646,200,186,1,0,0,0,0,0,0,0,2934,8,915
"17292","사당제1동","사당제1동제2투","대통령선거","서울특별시","동작구",2895,2185,989,371,504,151,153,4,0,1,0,0,0,3,2,2178,7,710
"17293","사당제1동","사당제1동제3투","대통령선거","서울특별시","동작구",2450,1737,689,384,407,113,126,8,0,2,1,3,0,0,0,1733,4,713
"17294","사당제1동","사당제1동제4투","대통령선거","서울특별시","동작구",2455,1787,808,356,410,96,107,1,0,0,1,3,0,0,1,1783,4,668
"17295","사당제1동","사당제1동제5투","대통령선거","서울특별시","동작구",2909,1941,824,391,448,132,132,7,0,1,1,0,1,0,0,1937,4,968
"17296","사당제2동","관내사전투표","대통령선거","서울특별시","동작구",6243,6243,2841,1299,1289,403,379,5,0,4,0,1,4,2,3,6230,13,0
"17297","사당제2동","사당제2동제1투","대통령선거","서울특별시","동작구",3094,2360,824,599,572,219,133,4,0,1,0,0,0,0,1,2353,7,734
"17298","사당제2동","사당제2동제2투","대통령선거","서울특별시","동작구",2053,1321,544,303,316,74,70,3,0,1,0,1,0,0,0,1312,9,732
"17299","사당제2동","사당제2동제3투","대통령선거","서울특별시","동작구",2181,1518,657,295,355,107,92,1,0,2,0,1,0,1,3,1514,4,663
"17300","사당제2동","사당제2동제4투","대통령선거","서울특별시","동작구",2793,1756,659,440,400,155,96,2,1,0,0,0,1,0,0,1754,2,1037
"17301","사당제2동","사당제2동제5투","대통령선거","서울특별시","동작구",1830,1291,568,251,298,105,66,1,0,0,0,0,0,0,0,1289,2,539
"17302","사당제2동","사당제2동제6투","대통령선거","서울특별시","동작구",2213,1798,719,396,425,147,96,7,0,0,1,0,0,2,0,1793,5,415
"17303","사당제2동","사당제2동제7투","대통령선거","서울특별시","동작구",2127,1677,566,458,382,170,90,4,0,0,1,0,0,0,0,1671,6,450
"17304","사당제3동","관내사전투표","대통령선거","서울특별시","동작구",3363,3363,1533,701,682,208,217,3,0,1,0,3,1,0,2,3351,12,0
"17305","사당제3동","사당제3동제1투","대통령선거","서울특별시","동작구",2781,2071,888,389,489,159,131,5,1,1,1,0,0,0,1,2065,6,710
"17306","사당제3동","사당제3동제2투","대통령선거","서울특별시","동작구",1984,1356,576,283,319,93,77,2,0,2,0,0,0,1,0,1353,3,628
"17307","사당제3동","사당제3동제3투","대통령선거","서울특별시","동작구",2489,1726,613,477,388,145,87,5,0,0,0,2,0,0,1,1718,8,763
"17308","사당제3동","사당제3동제4투","대통령선거","서울특별시","동작구",2097,1466,604,274,368,109,97,0,1,3,0,1,1,0,1,1459,7,631
"17309","사당제3동","사당제3동제5투","대통령선거","서울특별시","동작구",2559,2058,829,479,481,139,123,1,0,1,1,0,0,0,2,2056,2,501
"17310","사당제3동","사당제3동제6투","대통령선거","서울특별시","동작구",2662,2177,795,552,556,162,107,0,0,1,0,0,0,0,1,2174,3,485
"17311","사당제4동","관내사전투표","대통령선거","서울특별시","동작구",3093,3093,1504,539,654,166,208,6,0,4,0,1,1,0,2,3085,8,0
"17312","사당제4동","사당제4동제1투","대통령선거","서울특별시","동작구",2174,1537,671,297,370,82,102,1,0,0,0,1,0,0,2,1526,11,637
"17313","사당제4동","사당제4동제2투","대통령선거","서울특별시","동작구",2065,1551,655,334,344,117,97,2,0,1,0,0,0,0,0,1550,1,514
"17314","사당제4동","사당제4동제3투","대통령선거","서울특별시","동작구",2554,1822,851,313,429,111,109,0,1,0,0,1,0,1,0,1816,6,732
"17315","사당제4동","사당제4동제4투","대통령선거","서울특별시","동작구",1989,1410,576,317,326,94,86,0,0,0,0,3,0,0,1,1403,7,579
"17316","사당제5동","관내사전투표","대통령선거","서울특별시","동작구",2503,2503,1282,395,493,169,155,0,0,0,0,0,1,0,0,2495,8,0
"17317","사당제5동","사당제5동제1투","대통령선거","서울특별시","동작구",783,512,238,83,119,40,29,0,0,1,0,0,0,0,1,511,1,271
"17318","사당제5동","사당제5동제2투","대통령선거","서울특별시","동작구",2416,1870,811,387,412,147,106,2,0,1,0,0,0,0,0,1866,4,546
"17319","사당제5동","사당제5동제3투","대통령선거","서울특별시","동작구",2358,1592,690,312,346,137,95,4,0,0,1,2,1,0,1,1589,3,766
"17320","사당제5동","사당제5동제4투","대통령선거","서울특별시","동작구",2052,1513,696,286,350,91,79,3,0,0,1,0,1,0,3,1510,3,539
"17321","대방동","관내사전투표","대통령선거","서울특별시","동작구",5096,5096,2379,931,1025,415,318,13,1,2,1,4,0,1,1,5091,5,0
"17322","대방동","대방동제1투","대통령선거","서울특별시","동작구",2751,1927,802,485,410,109,108,1,0,2,1,1,1,1,1,1922,5,824
"17323","대방동","대방동제2투","대통령선거","서울특별시","동작구",2674,2085,798,498,473,201,102,5,0,1,0,1,0,2,0,2081,4,589
"17324","대방동","대방동제3투","대통령선거","서울특별시","동작구",3311,2648,1094,533,596,253,160,2,0,0,0,2,0,1,1,2642,6,663
"17325","대방동","대방동제4투","대통령선거","서울특별시","동작구",2829,1949,802,425,483,126,94,5,0,1,1,0,0,1,5,1943,6,880
"17326","대방동","대방동제5투","대통령선거","서울특별시","동작구",2712,2161,840,499,517,187,103,7,0,0,0,2,0,0,0,2155,6,551
"17327","대방동","대방동제6투","대통령선거","서울특별시","동작구",2155,1579,680,324,338,114,118,0,0,0,0,1,0,1,1,1577,2,576
"17328","대방동","대방동제7투","대통령선거","서울특별시","동작구",3009,2250,1039,388,494,161,158,1,0,3,0,1,0,0,0,2245,5,759
"17329","대방동","대방동제8투","대통령선거","서울특별시","동작구",3046,2208,998,400,495,155,146,4,0,1,0,0,0,0,3,2202,6,838
"17330","신대방제1동","관내사전투표","대통령선거","서울특별시","동작구",3002,3002,1411,562,604,203,206,3,1,0,0,1,2,0,2,2995,7,0
"17331","신대방제1동","신대방제1동제1투","대통령선거","서울특별시","동작구",1902,1293,556,275,314,66,70,1,0,0,0,3,2,0,1,1288,5,609
"17332","신대방제1동","신대방제1동제2투","대통령선거","서울특별시","동작구",2429,1591,622,397,357,119,79,3,0,1,0,5,1,1,1,1586,5,838
"17333","신대방제1동","신대방제1동제3투","대통령선거","서울특별시","동작구",3650,3124,1377,586,693,239,215,6,0,2,0,0,0,2,1,3121,3,526
"17334","신대방제1동","신대방제1동제4투","대통령선거","서울특별시","동작구",3447,2461,1021,532,563,168,161,6,0,1,0,4,0,1,1,2458,3,986
"17335","신대방제1동","신대방제1동제5투","대통령선거","서울특별시","동작구",3494,2933,1088,801,694,193,145,3,0,0,0,3,0,0,2,2929,4,561
"17336","신대방제2동","관내사전투표","대통령선거","서울특별시","동작구",3196,3196,1705,504,563,194,219,5,0,1,0,0,0,0,0,3191,5,0
"17337","신대방제2동","신대방제2동제1투","대통령선거","서울특별시","동작구",2630,2057,926,352,472,176,121,0,0,1,0,2,2,0,0,2052,5,573
"17338","신대방제2동","신대방제2동제2투","대통령선거","서울특별시","동작구",2978,2053,954,411,384,148,141,2,1,1,0,1,2,3,3,2051,2,925
"17339","신대방제2동","신대방제2동제3투","대통령선거","서울특별시","동작구",3283,2450,1085,441,573,189,154,1,0,1,0,0,0,1,0,2445,5,833
"17340","신대방제2동","신대방제2동제4투","대통령선거","서울특별시","동작구",3347,2486,846,787,564,147,128,3,1,1,0,0,0,0,0,2477,9,861
"17341","잘못 투입·구분된 투표지","잘못 투입·구분된 투표지","대통령선거","서울특별시","동작구",0,0,0,0,0,0,0,0,0,0,0,0,0,0,0,0,0,0
"17342","거소·선상투표","거소·선상투표","대통령선거","서울특별시","관악구",601,559,199,111,175,30,22,2,2,0,2,1,0,0,1,545,14,42
"17343","관외사전투표","관외사전투표","대통령선거","서울특별시","관악구",44994,44965,23056,5121,8648,3579,4141,56,11,7,8,54,7,17,46,44751,214,29
"17344","재외투표","재외투표","대통령선거","서울특별시","관악구",3981,3084,1833,232,511,100,395,9,0,0,0,0,0,1,0,3081,3,897
"17345","보라매동","관내사전투표","대통령선거","서울특별시","관악구",3300,3300,1657,458,716,192,249,6,0,2,1,3,0,2,3,3289,11,0
"17346","보라매동","보라매동제1투","대통령선거","서울특별시","관악구",3099,2402,924,593,576,172,123,9,0,3,0,0,2,0,0,2402,0,697
"17347","보라매동","보라매동제2투","대통령선거","서울특별시","관악구",3002,2203,874,459,585,147,119,1,0,2,0,3,0,4,3,2197,6,799
"17348","보라매동","보라매동제3투","대통령선거","서울특별시","관악구",3527,2541,1007,601,638,123,151,1,1,3,1,0,2,3,4,2535,6,986
"17349","보라매동","보라매동제4투","대통령선거","서울특별시","관악구",3293,2046,889,375,519,129,121,1,1,2,0,0,2,0,1,2040,6,1247
"17350","보라매동","보라매동제5투","대통령선거","서울특별시","관악구",3502,2425,1029,447,625,132,175,3,1,0,1,2,0,0,2,2417,8,1077
"17351","은천동","관내사전투표","대통령선거","서울특별시","관악구",5034,5034,2522,762,1063,307,341,8,1,0,0,5,3,2,3,5017,17,0
"17352","은천동","은천동제1투","대통령선거","서울특별시","관악구",2882,2067,846,429,513,139,126,7,1,2,0,1,0,0,0,2064,3,815
"17353","은천동","은천동제2투","대통령선거","서울특별시","관악구",3068,2220,898,486,538,137,143,6,0,2,0,1,0,0,1,2212,8,848
"17354","은천동","은천동제3투","대통령선거","서울특별시","관악구",3032,2239,891,448,613,153,111,1,1,4,1,1,0,2,0,2226,13,793
"17355","은천동","은천동제4투","대통령선거","서울특별시","관악구",3015,2530,1218,373,613,168,152,0,0,0,0,1,0,1,0,2526,4,485
"17356","은천동","은천동제5투","대통령선거","서울특별시","관악구",3025,2364,1075,454,558,135,126,4,0,1,1,0,2,1,2,2359,5,661
"17357","은천동","은천동제6투","대통령선거","서울특별시","관악구",3254,2280,1009,445,526,120,162,1,0,3,0,0,0,1,2,2269,11,974
"17358","은천동","은천동제7투","대통령선거","서울특별시","관악구",3382,2118,880,349,630,110,128,1,2,2,2,6,0,0,2,2112,6,1264
"17359","성현동","관내사전투표","대통령선거","서울특별시","관악구",3970,3970,1972,572,875,260,264,3,0,2,1,5,0,1,0,3955,15,0
"17360","성현동","성현동제1투","대통령선거","서울특별시","관악구",2949,2192,898,377,662,119,119,3,1,2,4,1,2,1,0,2189,3,757
"17361","성현동","성현동제2투","대통령선거","서울특별시","관악구",3580,2730,1164,475,708,183,182,5,0,0,0,2,0,0,1,2720,10,850
"17362","성현동","성현동제3투","대통령선거","서울특별시","관악구",2533,2185,909,437,526,173,133,2,0,1,0,0,1,1,0,2183,2,348
"17363","성현동","성현동제4투","대통령선거","서울특별시","관악구",2929,2429,968,536,600,169,143,1,0,1,1,1,0,1,1,2422,7,500
"17364","성현동","성현동제5투","대통령선거","서울특별시","관악구",2786,2283,1061,395,526,176,115,6,0,0,0,1,0,0,0,2280,3,503
"17365","성현동","성현동제6투","대통령선거","서울특별시","관악구",2773,1717,722,352,448,114,75,2,0,0,0,0,0,0,2,1715,2,1056
"17366","성현동","성현동제7투","대통령선거","서울특별시","관악구",3139,2262,803,547,652,106,128,5,0,2,4,0,1,0,3,2251,11,877
"17367","중앙동","관내사전투표","대통령선거","서울특별시","관악구",2782,2782,1455,306,574,202,215,5,0,2,0,1,1,0,5,2766,16,0
"17368","중앙동","중앙동제1투","대통령선거","서울특별시","관악구",2833,1899,835,316,492,119,122,3,0,2,0,1,0,1,0,1891,8,934
"17369","중앙동","중앙동제2투","대통령선거","서울특별시","관악구",2855,2105,948,359,534,112,135,1,0,1,0,1,1,0,0,2092,13,750
"17370","중앙동","중앙동제3투","대통령선거","서울특별시","관악구",3544,2264,1039,319,560,164,170,1,2,0,0,1,1,0,1,2258,6,1280
"17371","청림동","관내사전투표","대통령선거","서울특별시","관악구",2565,2565,1248,442,548,155,156,7,0,0,0,3,0,0,2,2561,4,0
"17372","청림동","청림동제1투","대통령선거","서울특별시","관악구",3127,2403,965,534,594,170,128,3,0,0,0,2,0,1,1,2398,5,724
"17373","청림동","청림동제2투","대통령선거","서울특별시","관악구",3359,2281,881,484,649,141,103,5,1,4,0,1,0,2,1,2272,9,1078
"17374","청림동","청림동제3투","대통령선거","서울특별시","관악구",3502,2980,1460,472,644,215,180,0,0,0,0,1,0,1,0,2973,7,522
"17375","행운동","관내사전투표","대통령선거","서울특별시","관악구",5271,5271,2645,659,1045,404,481,3,0,4,0,9,1,1,4,5256,15,0
"17376","행운동","행운동제1투","대통령선거","서울특별시","관악구",2811,2118,1034,360,415,135,161,0,0,1,0,1,0,1,3,2111,7,693
"17377","행운동","행운동제2투","대통령선거","서울특별시","관악구",3296,2514,1201,413,519,171,196,4,1,0,0,0,0,1,0,2506,8,782
"17378","행운동","행운동제3투","대통령선거","서울특별시","관악구",3560,2615,1205,393,621,201,179,1,0,3,0,1,1,0,3,2608,7,945
"17379","행운동","행운동제4투","대통령선거","서울특별시","관악구",2958,1872,805,298,481,110,162,6,0,1,0,0,1,2,0,1866,6,1086
"17380","행운동","행운동제5투","대통령선거","서울특별시","관악구",2337,1638,698,275,408,126,125,1,0,0,1,0,0,1,2,1637,1,699
"17381","행운동","행운동제6투","대통령선거","서울특별시","관악구",3499,2771,1060,607,747,188,146,3,0,4,1,2,0,2,0,2760,11,728
"17382","청룡동","관내사전투표","대통령선거","서울특별시","관악구",4284,4284,2153,604,884,290,318,13,0,2,0,3,1,3,2,4273,11,0
"17383","청룡동","청룡동제1투","대통령선거","서울특별시","관악구",3290,2235,971,430,565,119,138,1,1,0,0,1,0,0,1,2227,8,1055
"17384","청룡동","청룡동제2투","대통령선거","서울특별시","관악구",3283,2332,1006,433,584,130,160,1,1,1,0,3,0,0,0,2319,13,951
"17385","청룡동","청룡동제3투","대통령선거","서울특별시","관악구",4079,3016,1422,336,642,271,324,5,0,1,1,2,0,1,4,3009,7,1063
"17386","청룡동","청룡동제4투","대통령선거","서울특별시","관악구",3950,2598,1107,489,670,170,141,2,0,2,0,1,0,1,2,2585,13,1352
"17387","청룡동","청룡동제5투","대통령선거","서울특별시","관악구",3076,2370,1054,384,568,151,200,3,0,2,0,1,1,1,0,2365,5,706
"17388","낙성대동","관내사전투표","대통령선거","서울특별시","관악구",3449,3449,1781,389,638,261,360,2,0,3,2,2,0,0,0,3438,11,0
"17389","낙성대동","낙성대동제1투","대통령선거","서울특별시","관악구",3554,2610,1226,365,551,232,222,6,0,1,0,0,0,0,2,2605,5,944
"17390","낙성대동","낙성대동제2투","대통령선거","서울특별시","관악구",3469,2350,990,415,571,154,197,9,0,1,0,2,0,1,0,2340,10,1119
"17391","낙성대동","낙성대동제3투","대통령선거","서울특별시","관악구",2870,2181,1000,294,489,191,184,5,0,1,0,2,1,1,1,2169,12,689
"17392","인헌동","관내사전투표","대통령선거","서울특별시","관악구",6137,6137,3086,886,1255,384,490,2,2,3,1,8,2,1,2,6122,15,0
"17393","인헌동","인헌동제1투","대통령선거","서울특별시","관악구",2774,1912,909,256,440,144,152,2,0,2,0,0,0,1,2,1908,4,862
"17394","인헌동","인헌동제2투","대통령선거","서울특별시","관악구",3447,2328,1097,359,502,162,184,10,1,0,1,1,0,0,5,2322,6,1119
"17395","인헌동","인헌동제3투","대통령선거","서울특별시","관악구",3146,2255,994,424,497,174,156,2,1,0,0,0,1,0,0,2249,6,891
"17396","인헌동","인헌동제4투","대통령선거","서울특별시","관악구",3248,2287,978,388,587,150,171,4,1,0,0,2,0,0,1,2282,5,961
"17397","인헌동","인헌동제5투","대통령선거","서울특별시","관악구",3144,2482,1110,441,593,153,168,4,0,4,0,2,0,1,2,2478,4,662
"17398","남현동","관내사전투표","대통령선거","서울특별시","관악구",3490,3490,1682,581,722,244,233,9,2,2,0,0,0,1,0,3476,14,0
"17399","남현동","남현동제1투","대통령선거","서울특별시","관악구",2707,1989,805,393,479,158,138,6,0,3,0,0,0,0,1,1983,6,718
"17400","남현동","남현동제2투","대통령선거","서울특별시","관악구",2582,1955,841,450,425,119,113,2,1,0,0,0,0,0,1,1952,3,627
"17401","남현동","남현동제3투","대통령선거","서울특별시","관악구",2714,1830,780,350,409,150,129,1,0,2,1,1,0,0,0,1823,7,884
"17402","남현동","남현동제4투","대통령선거","서울특별시","관악구",2671,1935,742,442,457,162,119,4,0,1,0,1,0,1,2,1931,4,736
"17403","신림동","관내사전투표","대통령선거","서울특별시","관악구",4622,4622,2559,472,737,361,462,2,0,0,2,2,1,1,3,4602,20,0
"17404","신림동","신림동제1투","대통령선거","서울특별시","관악구",4003,2549,1271,311,494,229,216,7,1,1,1,1,1,0,1,2534,15,1454
"17405","신림동","신림동제2투","대통령선거","서울특별시","관악구",3223,1977,996,270,352,152,185,1,1,2,1,1,1,0,6,1968,9,1246
"17406","신림동","신림동제3투","대통령선거","서울특별시","관악구",3089,1928,940,285,377,141,168,4,0,0,1,2,0,0,3,1921,7,1161
"17407","신림동","신림동제4투","대통령선거","서울특별시","관악구",2876,2010,909,384,407,151,140,1,1,0,2,4,1,1,2,2003,7,866
"17408","신사동","관내사전투표","대통령선거","서울특별시","관악구",3805,3805,1912,633,772,197,268,4,0,5,1,1,0,1,2,3796,9,0
"17409","신사동","신사동제1투","대통령선거","서울특별시","관악구",2588,1814,787,362,410,133,105,5,0,0,0,3,0,1,2,1808,6,774
"17410","신사동","신사동제2투","대통령선거","서울특별시","관악구",2958,1985,904,379,416,128,141,2,0,1,0,0,0,0,2,1973,12,973
"17411","신사동","신사동제3투","대통령선거","서울특별시","관악구",2941,1980,885,378,453,128,122,3,0,1,0,0,0,3,0,1973,7,961
"17412","신사동","신사동제4투","대통령선거","서울특별시","관악구",2961,1725,766,335,386,118,104,0,1,0,1,0,0,1,2,1714,11,1236
"17413","신사동","신사동제5투","대통령선거","서울특별시","관악구",3284,2129,869,415,554,123,153,0,0,1,1,1,1,1,1,2120,9,1155
"17414","조원동","관내사전투표","대통령선거","서울특별시","관악구",3066,3066,1477,498,629,221,212,9,0,4,0,4,0,0,3,3057,9,0
"17415","조원동","조원동제1투","대통령선거","서울특별시","관악구",3129,2068,876,417,494,132,137,0,0,0,2,2,1,0,2,2063,5,1061
"17416","조원동","조원동제2투","대통령선거","서울특별시","관악구",3323,2054,849,418,504,128,139,5,0,0,0,2,0,1,2,2048,6,1269
"17417","조원동","조원동제3투","대통령선거","서울특별시","관악구",2689,1864,807,386,422,113,124,2,0,0,2,1,1,0,0,1858,6,825
"17418","조원동","조원동제4투","대통령선거","서울특별시","관악구",2215,1563,597,394,367,97,99,3,0,2,0,0,0,0,0,1559,4,652
"17419","미성동","관내사전투표","대통령선거","서울특별시","관악구",4739,4739,2214,957,1012,235,288,12,0,4,1,4,1,0,2,4730,9,0
"17420","미성동","미성동제1투","대통령선거","서울특별시","관악구",2951,1830,780,341,412,132,149,5,0,1,0,2,0,0,1,1823,7,1121
"17421","미성동","미성동제2투","대통령선거","서울특별시","관악구",2829,1990,775,432,514,123,126,5,0,2,1,1,3,1,2,1985,5,839
"17422","미성동","미성동제3투","대통령선거","서울특별시","관악구",3203,2678,940,776,652,186,109,4,0,0,0,1,1,2,0,2671,7,525
"17423","미성동","미성동제4투","대통령선거","서울특별시","관악구",2914,1965,770,404,531,118,121,2,0,4,3,0,1,1,1,1956,9,949
"17424","미성동","미성동제5투","대통령선거","서울특별시","관악구",2963,2055,834,426,529,134,110,2,0,3,0,1,1,1,2,2043,12,908
"17425","미성동","미성동제6투","대통령선거","서울특별시","관악구",3012,1960,748,460,520,109,102,8,0,1,0,2,0,0,5,1955,5,1052
"17426","미성동","미성동제7투","대통령선거","서울특별시","관악구",2901,2153,864,467,564,120,123,3,0,1,0,4,1,2,0,2149,4,748
"17427","난곡동","관내사전투표","대통령선거","서울특별시","관악구",3839,3839,1761,704,906,207,224,4,2,2,1,3,2,1,1,3818,21,0
"17428","난곡동","난곡동제1투","대통령선거","서울특별시","관악구",3493,2086,844,421,537,132,127,5,0,1,2,4,1,1,2,2077,9,1407
"17429","난곡동","난곡동제2투","대통령선거","서울특별시","관악구",3636,2484,967,526,663,167,140,1,1,5,2,1,1,0,1,2475,9,1152
"17430","난곡동","난곡동제3투","대통령선거","서울특별시","관악구",3733,2735,1141,572,679,153,167,2,0,3,0,4,2,2,1,2726,9,998
"17431","난곡동","난곡동제4투","대통령선거","서울특별시","관악구",2687,1731,694,368,451,99,97,4,1,1,1,2,2,3,1,1724,7,956
"17432","난곡동","난곡동제5투","대통령선거","서울특별시","관악구",2688,1883,715,406,519,128,98,6,0,0,2,1,0,1,0,1876,7,805
"17433","난곡동","난곡동제6투","대통령선거","서울특별시","관악구",3004,1835,694,391,497,106,118,8,0,2,0,4,2,0,1,1823,12,1169
"17434","난향동","관내사전투표","대통령선거","서울특별시","관악구",2871,2871,1390,512,586,179,186,4,0,2,3,5,0,0,1,2868,3,0
"17435","난향동","난향동제1투","대통령선거","서울특별시","관악구",2948,1998,889,378,469,120,127,6,0,0,0,1,0,1,1,1992,6,950
"17436","난향동","난향동제2투","대통령선거","서울특별시","관악구",3458,2761,1176,505,658,232,176,5,0,0,0,3,1,0,2,2758,3,697
"17437","난향동","난향동제3투","대통령선거","서울특별시","관악구",3193,2082,757,504,565,121,115,3,1,3,1,1,1,1,1,2074,8,1111
"17438","서원동","관내사전투표","대통령선거","서울특별시","관악구",3928,3928,1961,594,754,256,340,1,1,3,1,7,0,2,3,3923,5,0
"17439","서원동","서원동제1투","대통령선거","서울특별시","관악구",3197,2291,1039,408,516,160,149,5,0,3,0,3,1,0,2,2286,5,906
"17440","서원동","서원동제2투","대통령선거","서울특별시","관악구",2706,1827,777,367,404,123,138,5,0,1,0,1,0,0,1,1817,10,879
"17441","서원동","서원동제3투","대통령선거","서울특별시","관악구",3094,1894,889,286,404,131,172,2,0,1,0,1,0,1,2,1889,5,1200
"17442","서원동","서원동제4투","대통령선거","서울특별시","관악구",2396,1539,669,273,380,98,110,0,0,0,1,1,2,0,0,1534,5,857
"17443","서원동","서원동제5투","대통령선거","서울특별시","관악구",3234,2257,977,432,563,134,130,3,0,1,1,2,0,1,3,2247,10,977
"17444","신원동","관내사전투표","대통령선거","서울특별시","관악구",3908,3908,1910,652,773,258,286,5,1,4,0,3,2,0,1,3895,13,0
"17445","신원동","신원동제1투","대통령선거","서울특별시","관악구",3219,1929,755,444,424,140,150,3,0,1,0,3,0,0,1,1921,8,1290
"17446","신원동","신원동제2투","대통령선거","서울특별시","관악구",2681,1827,741,378,452,118,119,4,0,5,1,2,0,0,0,1820,7,854
"17447","신원동","신원동제3투","대통령선거","서울특별시","관악구",2621,1771,770,330,428,105,124,5,0,0,0,1,1,1,2,1767,4,850
"17448","신원동","신원동제4투","대통령선거","서울특별시","관악구",2967,1918,825,356,495,99,125,4,1,2,0,2,0,1,2,1912,6,1049
"17449","서림동","관내사전투표","대통령선거","서울특별시","관악구",3045,3045,1546,394,599,244,241,8,0,1,0,2,1,0,0,3036,9,0
"17450","서림동","서림동제1투","대통령선거","서울특별시","관악구",3430,2165,898,429,534,143,140,5,1,2,1,1,0,0,0,2154,11,1265
"17451","서림동","서림동제2투","대통령선거","서울특별시","관악구",2930,2363,917,580,550,154,137,8,0,0,1,3,0,1,1,2352,11,567
"17452","서림동","서림동제3투","대통령선거","서울특별시","관악구",2643,1742,747,300,429,120,127,2,2,1,0,4,0,0,1,1733,9,901
"17453","서림동","서림동제4투","대통령선거","서울특별시","관악구",3383,2206,1026,338,441,191,193,6,0,2,1,3,0,0,0,2201,5,1177
"17454","서림동","서림동제5투","대통령선거","서울특별시","관악구",3351,2397,1007,430,618,133,180,6,0,2,1,2,1,0,4,2384,13,954
"17455","삼성동","관내사전투표","대통령선거","서울특별시","관악구",4123,4123,1925,731,928,263,242,4,1,5,0,4,0,2,2,4107,16,0
"17456","삼성동","삼성동제1투","대통령선거","서울특별시","관악구",2818,1553,592,373,417,77,67,3,1,2,1,3,2,3,3,1544,9,1265
"17457","삼성동","삼성동제2투","대통령선거","서울특별시","관악구",3082,2183,827,499,592,129,110,2,1,4,0,5,0,2,3,2174,9,899
"17458","삼성동","삼성동제3투","대통령선거","서울특별시","관악구",3184,2334,893,483,662,158,116,6,1,2,0,4,0,0,1,2326,8,850
"17459","삼성동","삼성동제4투","대통령선거","서울특별시","관악구",2487,1739,654,400,478,104,89,6,0,1,0,1,0,0,1,1734,5,748
"17460","삼성동","삼성동제5투","대통령선거","서울특별시","관악구",2883,2019,900,403,489,99,113,3,1,2,1,1,0,0,1,2013,6,864
"17461","삼성동","삼성동제6투","대통령선거","서울특별시","관악구",3121,2530,999,557,644,173,140,4,0,1,0,3,0,0,0,2521,9,591
"17462","대학동","관내사전투표","대통령선거","서울특별시","관악구",5493,5493,2783,668,1049,442,495,14,0,1,2,6,1,2,3,5466,27,0
"17463","대학동","대학동제1투","대통령선거","서울특별시","관악구",3742,2195,933,409,450,190,199,2,0,0,0,0,0,0,0,2183,12,1547
"17464","대학동","대학동제2투","대통령선거","서울특별시","관악구",2963,2294,945,426,583,176,147,6,1,1,0,1,0,2,1,2289,5,669
"17465","대학동","대학동제3투","대통령선거","서울특별시","관악구",3969,2583,1135,485,573,166,189,6,1,3,1,9,1,4,2,2575,8,1386
"17466","대학동","대학동제4투","대통령선거","서울특별시","관악구",3290,2097,924,419,418,164,153,5,0,0,0,3,0,0,0,2086,11,1193
"17467","잘못 투입·구분된 투표지","잘못 투입·구분된 투표지","대통령선거","서울특별시","관악구",0,28,16,3,7,1,1,0,0,0,0,0,0,0,0,28,0,-28
"17468","거소·선상투표","거소·선상투표","대통령선거","서울특별시","서초구",484,457,134,96,157,25,14,5,1,1,2,2,1,1,2,441,16,27
"17469","관외사전투표","관외사전투표","대통령선거","서울특별시","서초구",36041,36036,14964,7209,7456,3510,2596,66,4,10,7,18,3,5,20,35868,168,5
"17470","재외투표","재외투표","대통령선거","서울특별시","서초구",7300,5739,2905,612,1130,389,644,32,2,0,1,2,0,2,0,5719,20,1561
"17471","서초1동","관내사전투표","대통령선거","서울특별시","서초구",3371,3371,1384,781,675,320,191,6,1,1,0,2,0,1,1,3363,8,0
"17472","서초1동","서초1동제1투","대통령선거","서울특별시","서초구",3741,2749,878,796,594,333,135,6,0,0,0,0,0,0,2,2744,5,992
"17473","서초1동","서초1동제2투","대통령선거","서울특별시","서초구",3139,2325,755,668,509,240,138,8,0,0,0,0,0,1,2,2321,4,814
"17474","서초1동","서초1동제3투","대통령선거","서울특별시","서초구",2885,2030,607,629,474,215,92,3,0,0,1,1,1,1,0,2024,6,855
"17475","서초1동","서초1동제4투","대통령선거","서울특별시","서초구",2454,1703,631,429,354,186,97,0,0,2,1,0,0,0,1,1701,2,751
"17476","서초2동","관내사전투표","대통령선거","서울특별시","서초구",3114,3114,1236,772,571,325,193,7,0,0,0,0,0,1,1,3106,8,0
"17477","서초2동","서초2동제1투","대통령선거","서울특별시","서초구",1638,1341,422,378,287,168,74,6,0,0,0,0,0,0,0,1335,6,297
"17478","서초2동","서초2동제2투","대통령선거","서울특별시","서초구",2497,1855,570,493,456,208,114,3,0,0,0,0,0,1,1,1846,9,642
"17479","서초2동","서초2동제3투","대통령선거","서울특별시","서초구",3140,2383,831,647,504,255,126,7,1,0,0,2,0,1,2,2376,7,757
"17480","서초2동","서초2동제4투","대통령선거","서울특별시","서초구",1854,1174,447,285,243,133,65,0,0,0,0,0,0,0,0,1173,1,680
"17481","서초2동","서초2동제5투","대통령선거","서울특별시","서초구",2034,1264,342,437,295,129,56,2,0,0,0,0,0,0,0,1261,3,770
"17482","서초3동","관내사전투표","대통령선거","서울특별시","서초구",4673,4673,1844,1178,883,481,268,5,0,3,1,0,1,0,0,4664,9,0
"17483","서초3동","서초3동제1투","대통령선거","서울특별시","서초구",3053,2079,474,842,494,193,64,4,0,0,0,0,0,2,0,2073,6,974
"17484","서초3동","서초3동제2투","대통령선거","서울특별시","서초구",2554,1927,675,537,403,191,106,1,0,0,1,1,0,2,3,1920,7,627
"17485","서초3동","서초3동제3투","대통령선거","서울특별시","서초구",2536,1865,609,552,434,180,76,4,1,1,0,1,0,0,1,1859,6,671
"17486","서초3동","서초3동제4투","대통령선거","서울특별시","서초구",2223,1625,591,459,344,141,76,4,0,1,0,1,0,0,0,1617,8,598
"17487","서초3동","서초3동제5투","대통령선거","서울특별시","서초구",2484,1719,559,515,399,153,84,2,0,2,1,0,0,0,0,1715,4,765
"17488","서초3동","서초3동제6투","대통령선거","서울특별시","서초구",2886,1992,741,493,428,206,110,7,0,1,0,0,0,0,0,1986,6,894
"17489","서초3동","서초3동제7투","대통령선거","서울특별시","서초구",2112,1648,468,547,388,163,73,3,0,1,0,1,0,0,0,1644,4,464
"17490","서초4동","관내사전투표","대통령선거","서울특별시","서초구",3185,3185,1173,820,638,374,169,3,0,1,0,0,0,1,1,3180,5,0
"17491","서초4동","서초4동제1투","대통령선거","서울특별시","서초구",2869,1658,542,481,346,196,78,6,0,0,0,1,0,0,0,1650,8,1211
"17492","서초4동","서초4동제2투","대통령선거","서울특별시","서초구",2299,1831,493,636,412,217,66,2,0,0,1,1,0,1,0,1829,2,468
"17493","서초4동","서초4동제3투","대통령선거","서울특별시","서초구",2984,2309,578,791,561,293,73,1,0,0,2,1,0,1,2,2303,6,675
"17494","서초4동","서초4동제4투","대통령선거","서울특별시","서초구",2680,2143,465,883,461,265,63,0,0,0,0,0,0,1,1,2139,4,537
"17495","서초4동","서초4동제5투","대통령선거","서울특별시","서초구",3273,2591,688,860,587,331,107,9,0,0,1,0,0,0,1,2584,7,682
"17496","서초4동","서초4동제6투","대통령선거","서울특별시","서초구",2588,2176,673,620,500,293,81,3,0,1,0,0,0,0,0,2171,5,412
"17497","잠원동","관내사전투표","대통령선거","서울특별시","서초구",4401,4401,1747,947,921,538,229,7,1,0,1,0,0,1,0,4392,9,0
"17498","잠원동","잠원동제1투","대통령선거","서울특별시","서초구",3237,2075,629,583,465,276,111,1,1,0,0,2,0,3,2,2073,2,1162
"17499","잠원동","잠원동제2투","대통령선거","서울특별시","서초구",2324,1678,461,504,397,224,85,0,0,0,0,0,0,0,0,1671,7,646
"17500","잠원동","잠원동제3투","대통령선거","서울특별시","서초구",2443,1918,724,395,453,242,99,2,0,0,0,0,0,0,1,1916,2,525
"17501","잠원동","잠원동제4투","대통령선거","서울특별시","서초구",2449,1890,554,557,411,248,108,1,0,0,0,0,0,0,3,1882,8,559
"17502","잠원동","잠원동제5투","대통령선거","서울특별시","서초구",2663,1804,675,433,402,152,124,5,0,0,1,0,1,1,0,1794,10,859
"17503","잠원동","잠원동제6투","대통령선거","서울특별시","서초구",2403,1899,626,500,463,219,82,3,0,0,1,0,0,0,1,1895,4,504
"17504","잠원동","잠원동제7투","대통령선거","서울특별시","서초구",2625,2043,632,596,428,288,90,1,0,0,1,0,0,2,0,2038,5,582
"17505","잠원동","잠원동제8투","대통령선거","서울특별시","서초구",2550,2031,687,544,430,251,104,6,0,1,0,0,1,2,1,2027,4,519
"17506","반포본동","관내사전투표","대통령선거","서울특별시","서초구",1802,1802,674,459,360,188,112,3,0,2,0,1,0,0,0,1799,3,0
"17507","반포본동","반포본동제1투","대통령선거","서울특별시","서초구",1985,1280,489,285,262,164,67,6,1,0,0,0,0,1,1,1276,4,705
"17508","반포본동","반포본동제2투","대통령선거","서울특별시","서초구",1721,1368,315,521,281,174,68,2,1,2,0,0,0,0,0,1364,4,353
"17509","반포본동","반포본동제3투","대통령선거","서울특별시","서초구",2019,1656,441,587,383,161,79,2,0,0,0,0,0,0,0,1653,3,363
"17510","반포본동","반포본동제4투","대통령선거","서울특별시","서초구",1346,1094,340,294,250,147,53,2,0,1,0,0,2,1,0,1090,4,252
"17511","반포1동","관내사전투표","대통령선거","서울특별시","서초구",3550,3550,1450,871,710,326,179,6,0,0,0,0,0,1,1,3544,6,0
"17512","반포1동","반포1동제1투","대통령선거","서울특별시","서초구",3273,2627,840,705,650,320,101,3,0,1,0,0,0,2,0,2622,5,646
"17513","반포1동","반포1동제2투","대통령선거","서울특별시","서초구",3237,2485,846,655,582,272,109,13,1,0,1,0,0,0,0,2479,6,752
"17514","반포1동","반포1동제3투","대통령선거","서울특별시","서초구",2901,1782,716,442,352,144,114,6,0,1,1,1,1,0,0,1778,4,1119
"17515","반포1동","반포1동제4투","대통령선거","서울특별시","서초구",2711,1574,647,347,320,132,111,8,0,1,0,0,0,0,1,1567,7,1137
"17516","반포1동","반포1동제5투","대통령선거","서울특별시","서초구",2449,1363,565,293,260,117,116,1,0,2,0,1,0,2,1,1358,5,1086
"17517","반포1동","반포1동제6투","대통령선거","서울특별시","서초구",3375,2262,587,818,529,257,62,6,0,0,0,0,0,0,1,2260,2,1113
"17518","반포2동","관내사전투표","대통령선거","서울특별시","서초구",3230,3230,1071,895,693,387,166,11,0,0,0,1,0,1,1,3226,4,0
"17519","반포2동","반포2동제1투","대통령선거","서울특별시","서초구",3408,2478,567,822,640,333,101,6,0,1,0,0,0,0,0,2470,8,930
"17520","반포2동","반포2동제2투","대통령선거","서울특별시","서초구",2274,1818,524,570,397,225,88,1,0,0,0,3,0,3,0,1811,7,456
"17521","반포2동","반포2동제3투","대통령선거","서울특별시","서초구",2196,1707,529,448,413,212,91,3,0,0,1,0,0,1,0,1698,9,489
"17522","반포2동","반포2동제4투","대통령선거","서울특별시","서초구",2678,2217,695,590,568,255,99,4,0,1,0,0,0,0,0,2212,5,461
"17523","반포2동","반포2동제5투","대통령선거","서울특별시","서초구",2659,2150,460,785,552,248,91,8,0,0,0,0,0,0,1,2145,5,509
"17524","반포3동","관내사전투표","대통령선거","서울특별시","서초구",2822,2822,1000,714,617,338,137,6,0,2,0,0,1,1,0,2816,6,0
"17525","반포3동","반포3동제1투","대통령선거","서울특별시","서초구",2267,1464,439,433,360,167,52,6,0,0,0,0,0,1,2,1460,4,803
"17526","반포3동","반포3동제2투","대통령선거","서울특별시","서초구",2068,1616,510,449,376,194,77,3,0,0,0,0,0,4,0,1613,3,452
"17527","반포3동","반포3동제3투","대통령선거","서울특별시","서초구",1691,1267,380,394,281,142,62,1,0,1,0,0,0,0,0,1261,6,424
"17528","반포3동","반포3동제4투","대통령선거","서울특별시","서초구",2188,1686,464,508,403,214,83,8,0,0,1,0,0,0,0,1681,5,502
"17529","반포3동","반포3동제5투","대통령선거","서울특별시","서초구",2050,1669,549,449,401,188,69,3,0,1,0,0,0,0,0,1660,9,381
"17530","반포4동","관내사전투표","대통령선거","서울특별시","서초구",2433,2433,910,604,467,286,149,3,1,1,2,2,0,0,0,2425,8,0
"17531","반포4동","반포4동제1투","대통령선거","서울특별시","서초구",2324,1637,561,451,356,166,95,2,0,1,0,0,0,2,0,1634,3,687
"17532","반포4동","반포4동제2투","대통령선거","서울특별시","서초구",2675,1879,563,618,384,203,103,1,0,1,0,0,0,1,1,1875,4,796
"17533","반포4동","반포4동제3투","대통령선거","서울특별시","서초구",2615,2192,715,571,549,253,99,0,0,0,0,0,0,0,1,2188,4,423
"17534","반포4동","반포4동제4투","대통령선거","서울특별시","서초구",1701,1356,452,369,314,165,48,1,0,0,1,1,0,0,0,1351,5,345
"17535","반포4동","반포4동제5투","대통령선거","서울특별시","서초구",2163,1510,459,485,341,154,68,0,0,0,0,0,0,0,0,1507,3,653
"17536","방배본동","관내사전투표","대통령선거","서울특별시","서초구",2830,2830,1124,660,594,251,184,6,0,0,0,1,0,0,3,2823,7,0
"17537","방배본동","방배본동제1투","대통령선거","서울특별시","서초구",3004,2112,647,621,520,213,103,1,0,0,0,1,0,0,0,2106,6,892
"17538","방배본동","방배본동제2투","대통령선거","서울특별시","서초구",3066,2234,518,829,496,286,91,10,0,0,0,0,0,1,0,2231,3,832
"17539","방배본동","방배본동제3투","대통령선거","서울특별시","서초구",3545,2673,877,720,632,277,151,3,0,2,1,0,0,2,4,2669,4,872
"17540","방배본동","방배본동제4투","대통령선거","서울특별시","서초구",3027,2291,898,548,510,181,142,1,1,0,0,1,2,0,1,2285,6,736
"17541","방배1동","관내사전투표","대통령선거","서울특별시","서초구",3051,3051,1325,617,612,284,198,6,0,0,0,1,0,1,2,3046,5,0
"17542","방배1동","방배1동제1투","대통령선거","서울특별시","서초구",2498,1715,682,415,369,142,97,3,0,0,1,1,0,0,0,1710,5,783
"17543","방배1동","방배1동제2투","대통령선거","서울특별시","서초구",2896,2164,818,490,517,209,121,2,0,0,0,0,0,0,1,2158,6,732
"17544","방배1동","방배1동제3투","대통령선거","서울특별시","서초구",1994,1421,527,361,285,137,97,2,0,3,0,2,1,1,2,1418,3,573
"17545","방배1동","방배1동제4투","대통령선거","서울특별시","서초구",2492,1911,496,675,417,216,98,7,0,0,0,0,0,0,0,1909,2,581
"17546","방배2동","관내사전투표","대통령선거","서울특별시","서초구",3973,3973,1794,844,766,310,238,3,1,0,0,1,0,2,4,3963,10,0
"17547","방배2동","방배2동제1투","대통령선거","서울특별시","서초구",2617,1679,635,419,389,129,97,3,0,0,0,0,0,1,0,1673,6,938
"17548","방배2동","방배2동제2투","대통령선거","서울특별시","서초구",2149,1598,646,403,352,109,77,3,1,2,0,1,1,1,0,1596,2,551
"17549","방배2동","방배2동제3투","대통령선거","서울특별시","서초구",2113,1552,531,415,417,118,60,2,1,0,0,1,0,0,1,1546,6,561
"17550","방배2동","방배2동제4투","대통령선거","서울특별시","서초구",1930,1298,444,388,289,94,75,3,0,0,1,1,0,1,0,1296,2,632
"17551","방배2동","방배2동제5투","대통령선거","서울특별시","서초구",2503,2032,745,500,507,172,100,2,0,1,0,0,0,1,2,2030,2,471
"17552","방배2동","방배2동제6투","대통령선거","서울특별시","서초구",1932,1443,606,336,290,119,80,0,1,0,1,0,0,2,1,1436,7,489
"17553","방배2동","방배2동제7투","대통령선거","서울특별시","서초구",1903,1608,533,461,377,144,83,3,0,0,0,1,0,1,0,1603,5,295
"17554","방배2동","방배2동제8투","대통령선거","서울특별시","서초구",1125,843,266,266,217,44,40,2,0,0,1,1,1,0,2,840,3,282
"17555","방배3동","관내사전투표","대통령선거","서울특별시","서초구",2913,2913,1109,757,603,261,173,5,0,0,1,0,0,0,0,2909,4,0
"17556","방배3동","방배3동제1투","대통령선거","서울특별시","서초구",2913,2057,508,749,478,225,83,6,0,0,2,1,0,0,0,2052,5,856
"17557","방배3동","방배3동제2투","대통령선거","서울특별시","서초구",2164,1692,443,510,431,209,89,0,0,3,4,0,0,0,0,1689,3,472
"17558","방배3동","방배3동제3투","대통령선거","서울특별시","서초구",2254,1747,448,569,437,186,90,5,0,2,0,1,2,1,1,1742,5,507
"17559","방배3동","방배3동제4투","대통령선거","서울특별시","서초구",1998,1437,556,332,326,128,84,3,0,1,0,0,1,1,2,1434,3,561
"17560","방배3동","방배3동제5투","대통령선거","서울특별시","서초구",2872,2125,779,545,497,170,122,4,0,0,0,0,0,1,0,2118,7,747
"17561","방배3동","방배3동제6투","대통령선거","서울특별시","서초구",1987,1531,544,380,351,145,95,1,0,0,1,1,3,1,2,1524,7,456
"17562","방배4동","관내사전투표","대통령선거","서울특별시","서초구",3926,3926,1606,921,751,374,259,0,1,4,0,1,1,1,0,3919,7,0
"17563","방배4동","방배4동제1투","대통령선거","서울특별시","서초구",2437,1763,445,629,422,185,69,4,0,1,2,0,0,0,1,1758,5,674
"17564","방배4동","방배4동제2투","대통령선거","서울특별시","서초구",2375,1737,554,528,355,197,95,3,0,0,0,0,0,0,0,1732,5,638
"17565","방배4동","방배4동제3투","대통령선거","서울특별시","서초구",2489,1666,661,369,374,130,123,1,0,2,2,0,0,0,0,1662,4,823
"17566","방배4동","방배4동제4투","대통령선거","서울특별시","서초구",2605,1954,818,377,451,163,138,0,0,2,0,1,0,0,1,1951,3,651
"17567","방배4동","방배4동제5투","대통령선거","서울특별시","서초구",2247,1646,651,349,395,124,114,1,0,0,0,4,0,0,0,1638,8,601
"17568","방배4동","방배4동제6투","대통령선거","서울특별시","서초구",2705,2252,790,612,508,234,99,5,0,0,0,0,0,1,0,2249,3,453
"17569","양재1동","관내사전투표","대통령선거","서울특별시","서초구",4213,4213,1930,853,815,363,236,6,1,0,2,2,0,0,0,4208,5,0
"17570","양재1동","양재1동제1투","대통령선거","서울특별시","서초구",2307,1715,678,426,341,142,116,2,0,1,0,1,0,0,2,1709,6,592
"17571","양재1동","양재1동제2투","대통령선거","서울특별시","서초구",2856,2157,890,490,469,157,140,2,0,2,0,0,1,0,1,2152,5,699
"17572","양재1동","양재1동제3투","대통령선거","서울특별시","서초구",2133,1539,504,528,298,130,69,3,0,0,1,0,0,0,0,1533,6,594
"17573","양재1동","양재1동제4투","대통령선거","서울특별시","서초구",2713,2156,798,551,452,217,124,4,0,1,0,1,0,0,2,2150,6,557
"17574","양재1동","양재1동제5투","대통령선거","서울특별시","서초구",3413,2611,994,652,591,203,153,4,0,2,2,2,1,1,2,2607,4,802
"17575","양재1동","양재1동제6투","대통령선거","서울특별시","서초구",2807,1917,737,496,430,134,104,3,1,0,1,2,2,2,0,1912,5,890
"17576","양재1동","양재1동제7투","대통령선거","서울특별시","서초구",2427,1759,553,579,369,162,82,3,1,0,0,0,0,1,0,1750,9,668
"17577","양재1동","양재1동제8투","대통령선거","서울특별시","서초구",2831,2267,993,442,487,179,150,7,0,1,1,0,0,1,0,2261,6,564
"17578","양재1동","양재1동제9투","대통령선거","서울특별시","서초구",3398,2705,1143,472,661,253,169,1,0,0,0,0,0,3,0,2702,3,693
"17579","양재1동","양재1동제10투","대통령선거","서울특별시","서초구",2762,2165,973,391,540,134,119,0,1,0,1,3,0,1,0,2163,2,597
"17580","양재2동","관내사전투표","대통령선거","서울특별시","서초구",3842,3842,1942,629,693,275,274,6,1,4,0,3,0,0,4,3831,11,0
"17581","양재2동","양재2동제1투","대통령선거","서울특별시","서초구",2830,1806,724,433,410,107,120,1,0,0,0,2,0,0,0,1797,9,1024
"17582","양재2동","양재2동제2투","대통령선거","서울특별시","서초구",2448,1823,780,373,379,174,108,2,0,3,0,0,0,0,1,1820,3,625
"17583","양재2동","양재2동제3투","대통령선거","서울특별시","서초구",3137,2283,983,493,481,169,146,1,0,0,0,1,0,1,2,2277,6,854
"17584","양재2동","양재2동제4투","대통령선거","서울특별시","서초구",3068,2267,935,454,503,206,154,1,0,5,0,3,0,0,0,2261,6,801
"17585","양재2동","양재2동제5투","대통령선거","서울특별시","서초구",2714,1826,778,375,415,149,102,2,0,0,0,0,0,1,1,1823,3,888
"17586","내곡동","관내사전투표","대통령선거","서울특별시","서초구",2280,2280,970,562,435,164,137,2,0,3,0,2,0,0,1,2276,4,0
"17587","내곡동","내곡동제1투","대통령선거","서울특별시","서초구",1543,916,232,332,217,65,55,3,0,3,0,0,0,0,5,912,4,627
"17588","내곡동","내곡동제2투","대통령선거","서울특별시","서초구",2675,2151,783,590,473,221,78,3,0,0,0,1,0,0,0,2149,2,524
"17589","내곡동","내곡동제3투","대통령선거","서울특별시","서초구",3386,2635,1029,608,642,200,145,5,0,1,0,1,0,0,0,2631,4,751
"17590","내곡동","내곡동제4투","대통령선거","서울특별시","서초구",3206,2334,871,630,537,178,106,3,1,2,0,1,0,1,0,2330,4,872
"17591","잘못 투입·구분된 투표지","잘못 투입·구분된 투표지","대통령선거","서울특별시","서초구",0,0,0,0,0,0,0,0,0,0,0,0,0,0,0,0,0,0
"17592","거소·선상투표","거소·선상투표","대통령선거","서울특별시","강남구",600,555,199,116,178,33,10,3,1,1,1,1,2,1,1,547,8,45
"17593","관외사전투표","관외사전투표","대통령선거","서울특별시","강남구",42653,42645,17443,8661,9066,4188,2922,74,6,7,12,22,9,10,34,42454,191,8
"17594","재외투표","재외투표","대통령선거","서울특별시","강남구",8908,6863,3325,867,1409,448,756,28,0,0,0,3,1,1,2,6840,23,2045
"17595","신사동","관내사전투표","대통령선거","서울특별시","강남구",2548,2548,931,691,462,278,170,8,0,0,1,0,0,0,3,2544,4,0
"17596","신사동","신사동제1투","대통령선거","서울특별시","강남구",2329,1467,427,466,342,160,68,2,0,0,0,1,0,1,0,1467,0,862
"17597","신사동","신사동제2투","대통령선거","서울특별시","강남구",1831,1153,460,294,230,95,66,4,0,0,0,0,0,0,0,1149,4,678
"17598","신사동","신사동제3투","대통령선거","서울특별시","강남구",1963,1353,542,326,271,106,102,0,0,0,0,1,0,0,2,1350,3,610
"17599","신사동","신사동제4투","대통령선거","서울특별시","강남구",2815,2089,276,1099,426,220,57,1,0,0,1,0,0,2,0,2082,7,726
"17600","신사동","신사동제5투","대통령선거","서울특별시","강남구",2454,1921,390,742,448,257,75,4,0,0,0,0,0,0,1,1917,4,533
"17601","논현1동","관내사전투표","대통령선거","서울특별시","강남구",3093,3093,1454,598,509,248,272,2,0,0,0,0,1,1,0,3085,8,0
"17602","논현1동","논현1동제1투","대통령선거","서울특별시","강남구",3551,1669,679,376,358,130,117,2,1,0,0,0,0,0,1,1664,5,1882
"17603","논현1동","논현1동제2투","대통령선거","서울특별시","강남구",3207,1900,702,572,353,160,104,4,0,0,1,2,0,0,0,1898,2,1307
"17604","논현1동","논현1동제3투","대통령선거","서울특별시","강남구",3713,2438,836,694,499,251,145,6,0,2,0,0,0,0,1,2434,4,1275
"17605","논현1동","논현1동제4투","대통령선거","서울특별시","강남구",3351,1857,710,460,402,139,133,2,1,1,0,0,0,0,2,1850,7,1494
"17606","논현1동","논현1동제5투","대통령선거","서울특별시","강남구",2980,1694,651,383,405,127,116,3,1,0,0,0,0,0,1,1687,7,1286
"17607","논현2동","관내사전투표","대통령선거","서울특별시","강남구",2800,2800,1154,703,464,270,190,7,0,1,2,2,0,2,1,2796,4,0
"17608","논현2동","논현2동제1투","대통령선거","서울특별시","강남구",3548,1995,581,678,433,189,100,6,0,0,1,0,0,0,2,1990,5,1553
"17609","논현2동","논현2동제2투","대통령선거","서울특별시","강남구",2409,1686,503,531,392,153,92,4,0,2,1,2,0,1,1,1682,4,723
"17610","논현2동","논현2동제3투","대통령선거","서울특별시","강남구",1872,1229,455,330,249,106,87,0,0,0,0,0,0,0,0,1227,2,643
"17611","논현2동","논현2동제4투","대통령선거","서울특별시","강남구",3622,2480,788,757,527,263,131,4,1,2,0,1,0,0,2,2476,4,1142
"17612","논현2동","논현2동제5투","대통령선거","서울특별시","강남구",3124,1953,713,501,410,187,121,7,0,4,1,0,0,0,1,1945,8,1171
"17613","압구정동","관내사전투표","대통령선거","서울특별시","강남구",2899,2899,697,1108,613,350,118,9,0,1,1,0,0,0,0,2897,2,0
"17614","압구정동","압구정동제1투","대통령선거","서울특별시","강남구",3179,1940,288,1000,366,219,48,7,0,1,0,0,0,0,0,1929,11,1239
"17615","압구정동","압구정동제2투","대통령선거","서울특별시","강남구",2100,1575,304,640,393,180,44,10,0,0,1,0,0,1,0,1573,2,525
"17616","압구정동","압구정동제3투","대통령선거","서울특별시","강남구",2652,1978,337,906,417,252,53,8,0,0,0,0,0,0,0,1973,5,674
"17617","압구정동","압구정동제4투","대통령선거","서울특별시","강남구",2315,1583,471,538,334,148,78,1,0,4,1,0,0,0,1,1576,7,732
"17618","압구정동","압구정동제5투","대통령선거","서울특별시","강남구",3169,2444,516,977,539,301,95,4,0,1,0,1,0,0,0,2434,10,725
"17619","압구정동","압구정동제6투","대통령선거","서울특별시","강남구",2973,2114,419,909,444,258,75,4,0,0,2,0,1,0,0,2112,2,859
"17620","압구정동","압구정동제7투","대통령선거","서울특별시","강남구",1352,885,202,371,200,75,35,1,0,0,0,0,0,0,1,885,0,467
"17621","청담동","관내사전투표","대통령선거","서울특별시","강남구",3463,3463,1300,948,631,366,196,2,0,2,0,2,1,2,1,3451,12,0
"17622","청담동","청담동제1투","대통령선거","서울특별시","강남구",3417,1988,541,676,446,224,89,6,0,2,0,0,0,0,0,1984,4,1429
"17623","청담동","청담동제2투","대통령선거","서울특별시","강남구",2413,1598,303,730,344,151,60,4,0,0,0,0,0,0,1,1593,5,815
"17624","청담동","청담동제3투","대통령선거","서울특별시","강남구",2077,1530,354,629,331,150,57,2,0,1,0,0,0,0,0,1524,6,547
"17625","청담동","청담동제4투","대통령선거","서울특별시","강남구",3624,2708,670,958,642,319,96,7,0,2,2,1,1,0,1,2699,9,916
"17626","청담동","청담동제5투","대통령선거","서울특별시","강남구",2886,2154,690,557,519,240,133,2,0,0,0,0,0,2,1,2144,10,732
"17627","청담동","청담동제6투","대통령선거","서울특별시","강남구",2878,2041,703,550,463,214,97,10,0,0,0,0,0,0,1,2038,3,837
"17628","청담동","청담동제7투","대통령선거","서울특별시","강남구",1718,1117,316,404,225,110,55,3,0,1,0,0,0,1,1,1116,1,601
"17629","삼성1동","관내사전투표","대통령선거","서울특별시","강남구",2483,2482,915,681,498,236,130,7,0,0,0,1,1,0,3,2472,10,1
"17630","삼성1동","삼성1동제1투","대통령선거","서울특별시","강남구",2852,1936,538,698,424,175,86,10,0,0,0,0,0,1,1,1933,3,916
"17631","삼성1동","삼성1동제2투","대통령선거","서울특별시","강남구",3081,2267,565,812,545,233,102,3,1,0,1,0,0,1,0,2263,4,814
"17632","삼성1동","삼성1동제3투","대통령선거","서울특별시","강남구",3047,2095,657,582,511,233,96,5,0,2,0,0,0,1,2,2089,6,952
"17633","삼성2동","관내사전투표","대통령선거","서울특별시","강남구",4699,4699,2016,990,901,462,312,6,0,0,1,0,0,1,2,4691,8,0
"17634","삼성2동","삼성2동제1투","대통령선거","서울특별시","강남구",3770,2115,839,510,407,183,155,7,0,1,1,1,0,0,0,2104,11,1655
"17635","삼성2동","삼성2동제2투","대통령선거","서울특별시","강남구",4067,3271,1033,960,761,375,121,9,1,2,0,1,1,0,0,3264,7,796
"17636","삼성2동","삼성2동제3투","대통령선거","서울특별시","강남구",3492,2433,848,671,538,227,136,0,0,2,1,2,0,2,3,2430,3,1059
"17637","삼성2동","삼성2동제4투","대통령선거","서울특별시","강남구",2952,1913,716,522,397,152,117,4,0,1,0,0,1,0,0,1910,3,1039
"17638","삼성2동","삼성2동제5투","대통령선거","서울특별시","강남구",3904,3055,921,902,734,377,111,3,0,0,0,0,1,0,0,3049,6,849
"17639","대치1동","관내사전투표","대통령선거","서울특별시","강남구",3359,3359,1118,968,711,397,152,4,0,0,0,0,0,0,1,3351,8,0
"17640","대치1동","대치1동제1투","대통령선거","서울특별시","강남구",3370,2716,676,877,730,333,84,6,1,2,0,0,0,0,2,2711,5,654
"17641","대치1동","대치1동제2투","대통령선거","서울특별시","강남구",2148,1698,547,397,461,199,84,1,0,0,1,0,0,0,0,1690,8,450
"17642","대치1동","대치1동제3투","대통령선거","서울특별시","강남구",2199,1765,405,651,390,237,75,3,0,0,0,0,0,0,2,1763,2,434
"17643","대치1동","대치1동제4투","대통령선거","서울특별시","강남구",2257,1776,385,678,409,224,69,4,0,2,0,0,0,0,0,1771,5,481
"17644","대치1동","대치1동제5투","대통령선거","서울특별시","강남구",3246,2554,689,734,691,323,102,3,0,1,1,1,0,0,0,2545,9,692
"17645","대치2동","관내사전투표","대통령선거","서울특별시","강남구",4493,4493,1775,1056,901,462,271,10,0,2,1,2,0,0,3,4483,10,0
"17646","대치2동","대치2동제1투","대통령선거","서울특별시","강남구",3459,2796,915,730,687,299,144,8,1,0,1,0,1,1,1,2788,8,663
"17647","대치2동","대치2동제2투","대통령선거","서울특별시","강남구",2697,2146,686,585,545,209,112,5,0,0,0,0,0,0,2,2144,2,551
"17648","대치2동","대치2동제3투","대통령선거","서울특별시","강남구",2969,2351,742,662,541,268,128,4,0,1,0,0,0,1,0,2347,4,618
"17649","대치2동","대치2동제4투","대통령선거","서울특별시","강남구",2651,2120,443,804,512,297,53,8,0,0,0,0,0,0,0,2117,3,531
"17650","대치2동","대치2동제5투","대통령선거","서울특별시","강남구",2665,2224,475,865,517,295,62,5,0,0,0,0,0,0,0,2219,5,441
"17651","대치2동","대치2동제6투","대통령선거","서울특별시","강남구",3127,2626,603,931,635,356,84,11,0,1,1,0,0,0,0,2622,4,501
"17652","대치2동","대치2동제7투","대통령선거","서울특별시","강남구",3856,2623,853,682,666,268,138,6,0,0,0,2,0,4,1,2620,3,1233
"17653","대치2동","대치2동제8투","대통령선거","서울특별시","강남구",2693,1878,684,514,418,158,99,5,0,0,0,0,0,0,0,1878,0,815
"17654","대치4동","관내사전투표","대통령선거","서울특별시","강남구",3644,3644,1641,660,670,370,284,6,0,2,0,2,0,1,1,3637,7,0
"17655","대치4동","대치4동제1투","대통령선거","서울특별시","강남구",3166,1965,738,433,487,135,158,3,1,0,1,0,0,0,1,1957,8,1201
"17656","대치4동","대치4동제2투","대통령선거","서울특별시","강남구",3464,2444,948,517,558,227,175,1,0,0,1,1,0,2,2,2432,12,1020
"17657","대치4동","대치4동제3투","대통령선거","서울특별시","강남구",2733,1704,578,469,377,173,100,0,0,1,0,0,2,0,0,1700,4,1029
"17658","대치4동","대치4동제4투","대통령선거","서울특별시","강남구",3052,1749,732,356,376,162,117,3,0,0,0,0,0,0,0,1746,3,1303
"17659","역삼1동","관내사전투표","대통령선거","서울특별시","강남구",3988,3988,1921,694,691,357,303,9,1,1,1,1,0,1,1,3981,7,0
"17660","역삼1동","역삼1동제1투","대통령선거","서울특별시","강남구",3158,1744,662,429,366,155,120,5,0,3,0,0,0,0,1,1741,3,1414
"17661","역삼1동","역삼1동제2투","대통령선거","서울특별시","강남구",2666,1520,602,338,344,133,95,3,0,0,0,0,0,1,1,1517,3,1146
"17662","역삼1동","역삼1동제3투","대통령선거","서울특별시","강남구",3265,1834,783,379,409,146,103,2,0,1,0,1,0,2,1,1827,7,1431
"17663","역삼1동","역삼1동제4투","대통령선거","서울특별시","강남구",3500,1950,747,509,391,156,139,2,0,0,0,1,0,0,3,1948,2,1550
"17664","역삼1동","역삼1동제5투","대통령선거","서울특별시","강남구",4126,1868,761,431,378,147,139,2,0,0,0,0,0,1,0,1859,9,2258
"17665","역삼1동","역삼1동제6투","대통령선거","서울특별시","강남구",3015,1912,742,450,427,156,119,3,0,3,0,1,0,0,1,1902,10,1103
"17666","역삼1동","역삼1동제7투","대통령선거","서울특별시","강남구",4082,2590,992,585,577,250,177,3,0,1,0,0,1,0,0,2586,4,1492
"17667","역삼2동","관내사전투표","대통령선거","서울특별시","강남구",5262,5262,2147,1148,1066,568,318,6,0,2,0,0,1,0,0,5256,6,0
"17668","역삼2동","역삼2동제1투","대통령선거","서울특별시","강남구",3799,2447,829,606,568,300,138,1,1,0,0,1,0,0,0,2444,3,1352
"17669","역삼2동","역삼2동제2투","대통령선거","서울특별시","강남구",3711,2797,815,837,668,332,132,4,0,0,1,0,0,1,2,2792,5,914
"17670","역삼2동","역삼2동제3투","대통령선거","서울특별시","강남구",3540,2127,793,501,476,219,125,4,0,1,0,0,0,1,1,2121,6,1413
"17671","역삼2동","역삼2동제4투","대통령선거","서울특별시","강남구",3376,2265,917,510,465,213,147,2,0,2,0,0,1,0,0,2257,8,1111
"17672","역삼2동","역삼2동제5투","대통령선거","서울특별시","강남구",3005,2252,873,509,539,202,113,6,1,0,1,0,0,2,2,2248,4,753
"17673","역삼2동","역삼2동제6투","대통령선거","서울특별시","강남구",3513,2741,867,776,641,335,110,4,0,0,0,0,0,0,1,2734,7,772
"17674","도곡1동","관내사전투표","대통령선거","서울특별시","강남구",3698,3698,1417,880,724,425,237,8,0,0,1,1,0,0,0,3693,5,0
"17675","도곡1동","도곡1동제1투","대통령선거","서울특별시","강남구",1484,1156,287,389,270,150,51,3,0,0,0,0,1,1,0,1152,4,328
"17676","도곡1동","도곡1동제2투","대통령선거","서울특별시","강남구",3316,2481,762,656,633,282,131,5,1,3,0,1,0,0,1,2475,6,835
"17677","도곡1동","도곡1동제3투","대통령선거","서울특별시","강남구",2964,2352,819,591,529,291,112,3,0,1,0,0,0,1,1,2348,4,612
"17678","도곡1동","도곡1동제4투","대통령선거","서울특별시","강남구",3218,2339,877,565,513,215,153,5,0,2,3,1,0,1,0,2335,4,879
"17679","도곡1동","도곡1동제5투","대통령선거","서울특별시","강남구",1884,1437,374,508,324,159,63,2,0,1,0,1,0,0,0,1432,5,447
"17680","도곡2동","관내사전투표","대통령선거","서울특별시","강남구",2917,2917,924,895,598,355,137,3,0,1,0,0,0,0,1,2914,3,0
"17681","도곡2동","도곡2동제1투","대통령선거","서울특별시","강남구",2046,1403,479,382,292,148,87,5,1,0,0,2,0,1,0,1397,6,643
"17682","도곡2동","도곡2동제2투","대통령선거","서울특별시","강남구",2685,2037,443,729,491,288,77,2,0,1,0,0,0,0,1,2032,5,648
"17683","도곡2동","도곡2동제3투","대통령선거","서울특별시","강남구",2779,2095,322,1002,494,220,40,10,0,0,0,0,0,0,0,2088,7,684
"17684","도곡2동","도곡2동제4투","대통령선거","서울특별시","강남구",3580,2743,386,1431,556,291,64,6,1,0,0,0,0,1,1,2737,6,837
"17685","도곡2동","도곡2동제5투","대통령선거","서울특별시","강남구",3385,2576,577,940,624,318,98,4,0,0,1,0,0,0,2,2564,12,809
"17686","도곡2동","도곡2동제6투","대통령선거","서울특별시","강남구",3465,2844,786,909,684,346,105,6,0,0,0,0,0,1,1,2838,6,621
"17687","도곡2동","도곡2동제7투","대통령선거","서울특별시","강남구",3255,2703,882,678,667,341,119,3,0,0,1,3,1,1,0,2696,7,552
"17688","개포1동","관내사전투표","대통령선거","서울특별시","강남구",3382,3382,1307,852,719,305,183,7,0,0,2,1,0,0,0,3376,6,0
"17689","개포1동","개포1동제1투","대통령선거","서울특별시","강남구",2708,1856,569,608,408,172,86,5,0,0,0,1,1,0,1,1851,5,852
"17690","개포1동","개포1동제2투","대통령선거","서울특별시","강남구",3149,2535,546,948,574,371,79,6,0,0,0,0,1,1,1,2527,8,614
"17691","개포1동","개포1동제3투","대통령선거","서울특별시","강남구",2701,1952,655,564,421,161,131,12,1,0,1,1,0,1,0,1948,4,749
"17692","개포1동","개포1동제4투","대통령선거","서울특별시","강남구",2839,2070,786,539,461,164,101,8,0,0,0,1,1,0,3,2064,6,769
"17693","개포1동","개포1동제5투","대통령선거","서울특별시","강남구",1271,918,309,294,245,36,26,1,0,1,0,2,0,0,0,914,4,353
"17694","개포2동","관내사전투표","대통령선거","서울특별시","강남구",3238,3238,1308,723,705,293,187,6,1,3,0,0,0,1,1,3228,10,0
"17695","개포2동","개포2동제1투","대통령선거","서울특별시","강남구",2250,1565,579,368,365,144,97,3,0,0,0,0,0,0,0,1556,9,685
"17696","개포2동","개포2동제2투","대통령선거","서울특별시","강남구",1741,1185,406,332,276,92,71,3,0,0,0,0,0,0,0,1180,5,556
"17697","개포2동","개포2동제3투","대통령선거","서울특별시","강남구",2224,1657,485,581,350,153,79,4,0,1,0,0,0,1,0,1654,3,567
"17698","개포2동","개포2동제4투","대통령선거","서울특별시","강남구",2650,1926,639,510,432,251,86,2,1,1,0,1,0,1,0,1924,2,724
"17699","개포2동","개포2동제5투","대통령선거","서울특별시","강남구",2763,2230,735,601,520,249,109,7,0,1,4,1,0,0,1,2228,2,533
"17700","개포4동","관내사전투표","대통령선거","서울특별시","강남구",2352,2352,1053,492,441,178,169,4,0,1,0,2,0,0,7,2347,5,0
"17701","개포4동","개포4동제1투","대통령선거","서울특별시","강남구",3585,2336,991,500,524,163,131,12,0,2,2,0,0,2,3,2330,6,1249
"17702","개포4동","개포4동제2투","대통령선거","서울특별시","강남구",1517,1166,240,485,285,123,30,2,0,0,0,0,0,0,1,1166,0,351
"17703","개포4동","개포4동제3투","대통령선거","서울특별시","강남구",2201,1667,667,375,392,141,81,2,0,0,1,0,0,1,1,1661,6,534
"17704","개포4동","개포4동제4투","대통령선거","서울특별시","강남구",3683,2639,1135,500,578,211,201,1,1,2,1,0,0,1,2,2633,6,1044
"17705","일원본동","관내사전투표","대통령선거","서울특별시","강남구",3960,3960,1655,781,816,428,239,5,0,7,3,2,1,1,0,3938,22,0
"17706","일원본동","일원본동제1투","대통령선거","서울특별시","강남구",3760,2727,887,749,666,292,115,2,0,2,1,2,0,1,2,2719,8,1033
"17707","일원본동","일원본동제2투","대통령선거","서울특별시","강남구",2846,2315,896,530,525,223,127,5,0,1,0,1,0,2,1,2311,4,531
"17708","일원본동","일원본동제3투","대통령선거","서울특별시","강남구",3721,2957,968,792,669,341,174,0,2,0,0,0,0,3,2,2951,6,764
"17709","일원본동","일원본동제4투","대통령선거","서울특별시","강남구",2818,2168,907,405,492,230,123,3,0,0,0,1,0,0,0,2161,7,650
"17710","일원1동","관내사전투표","대통령선거","서울특별시","강남구",2617,2617,1125,562,545,216,145,2,0,1,1,1,3,1,2,2604,13,0
"17711","일원1동","일원1동제1투","대통령선거","서울특별시","강남구",2440,1634,589,458,382,113,79,5,0,2,0,0,1,0,1,1630,4,806
"17712","일원1동","일원1동제2투","대통령선거","서울특별시","강남구",1981,1527,604,394,321,112,83,4,2,0,0,0,0,1,0,1521,6,454
"17713","일원1동","일원1동제3투","대통령선거","서울특별시","강남구",1955,1392,494,349,319,138,75,6,0,1,0,1,0,2,0,1385,7,563
"17714","일원1동","일원1동제4투","대통령선거","서울특별시","강남구",2011,1425,514,349,346,106,102,0,0,0,1,0,0,2,0,1420,5,586
"17715","일원1동","일원1동제5투","대통령선거","서울특별시","강남구",2147,1479,512,421,375,82,71,3,2,1,0,0,0,0,2,1469,10,668
"17716","일원2동","관내사전투표","대통령선거","서울특별시","강남구",2720,2720,1189,565,595,216,144,1,1,0,1,1,0,0,0,2713,7,0
"17717","일원2동","일원2동제1투","대통령선거","서울특별시","강남구",2192,1460,576,429,338,52,43,6,1,2,0,1,0,3,1,1452,8,732
"17718","일원2동","일원2동제2투","대통령선거","서울특별시","강남구",2433,1852,773,417,368,164,114,3,0,2,3,0,0,0,0,1844,8,581
"17719","일원2동","일원2동제3투","대통령선거","서울특별시","강남구",2253,1708,607,458,387,181,71,0,0,0,1,0,0,0,0,1705,3,545
"17720","일원2동","일원2동제4투","대통령선거","서울특별시","강남구",2664,2163,690,554,522,275,110,4,0,1,0,0,0,3,0,2159,4,501
"17721","수서동","관내사전투표","대통령선거","서울특별시","강남구",2989,2989,1219,746,605,228,167,10,0,0,2,0,0,1,1,2979,10,0
"17722","수서동","수서동제1투","대통령선거","서울특별시","강남구",2227,1636,472,550,365,175,70,2,0,0,0,0,0,0,1,1635,1,591
"17723","수서동","수서동제2투","대통령선거","서울특별시","강남구",1737,1209,428,344,297,57,56,3,0,1,1,0,3,2,1,1193,16,528
"17724","수서동","수서동제3투","대통령선거","서울특별시","강남구",2061,1375,467,387,360,80,51,3,1,2,2,0,3,1,5,1362,13,686
"17725","수서동","수서동제4투","대통령선거","서울특별시","강남구",1905,1293,423,396,325,69,58,2,1,3,2,0,2,2,1,1284,9,612
"17726","수서동","수서동제5투","대통령선거","서울특별시","강남구",3152,2494,894,651,560,247,132,0,0,0,0,0,0,2,0,2486,8,658
"17727","세곡동","관내사전투표","대통령선거","서울특별시","강남구",4326,4326,2047,806,865,342,242,10,0,0,0,4,0,1,1,4318,8,0
"17728","세곡동","세곡동제1투","대통령선거","서울특별시","강남구",2374,1612,631,374,368,141,88,2,1,0,0,0,1,2,1,1609,3,762
"17729","세곡동","세곡동제2투","대통령선거","서울특별시","강남구",2646,1969,786,441,471,130,122,6,0,1,0,1,0,0,4,1962,7,677
"17730","세곡동","세곡동제3투","대통령선거","서울특별시","강남구",3212,2489,900,687,563,202,123,5,0,0,0,1,1,1,0,2483,6,723
"17731","세곡동","세곡동제4투","대통령선거","서울특별시","강남구",2705,2037,843,490,440,162,96,2,0,0,0,0,0,0,2,2035,2,668
"17732","세곡동","세곡동제5투","대통령선거","서울특별시","강남구",2597,2111,858,463,487,162,129,2,0,0,0,2,1,1,1,2106,5,486
"17733","세곡동","세곡동제6투","대통령선거","서울특별시","강남구",2690,2081,912,420,439,184,114,3,1,1,0,0,0,3,0,2077,4,609
"17734","세곡동","세곡동제7투","대통령선거","서울특별시","강남구",2519,1873,862,343,369,174,114,1,1,0,2,1,1,0,1,1869,4,646
"17735","세곡동","세곡동제8투","대통령선거","서울특별시","강남구",3648,2768,1226,550,659,138,175,3,0,3,1,1,1,1,0,2758,10,880
"17736","세곡동","세곡동제9투","대통령선거","서울특별시","강남구",2709,2220,766,604,523,201,116,4,0,0,0,1,0,0,0,2215,5,489
"17737","잘못 투입·구분된 투표지","잘못 투입·구분된 투표지","대통령선거","서울특별시","강남구",0,2,0,2,0,0,0,0,0,0,0,0,0,0,0,2,0,-2
"17738","거소·선상투표","거소·선상투표","대통령선거","서울특별시","송파구",710,674,200,138,248,49,13,3,1,2,1,1,3,1,1,661,13,36
"17739","관외사전투표","관외사전투표","대통령선거","서울특별시","송파구",45929,45920,20681,7600,9728,4136,3364,63,6,17,4,25,14,12,46,45696,224,9
"17740","재외투표","재외투표","대통령선거","서울특별시","송파구",7684,5993,3256,593,1088,316,689,21,0,3,0,1,1,3,4,5975,18,1691
"17741","풍납1동","관내사전투표","대통령선거","서울특별시","송파구",2938,2938,1305,603,652,163,198,0,1,2,0,2,2,1,3,2932,6,0
"17742","풍납1동","풍납1동제1투","대통령선거","서울특별시","송파구",2694,1619,606,426,383,98,89,4,0,2,1,0,1,2,2,1614,5,1075
"17743","풍납1동","풍납1동제2투","대통령선거","서울특별시","송파구",2407,1693,663,404,401,106,112,3,0,0,0,1,0,1,1,1692,1,714
"17744","풍납1동","풍납1동제3투","대통령선거","서울특별시","송파구",2532,1642,639,429,383,85,90,0,0,2,1,1,1,1,3,1635,7,890
"17745","풍납1동","풍납1동제4투","대통령선거","서울특별시","송파구",2837,2175,828,497,540,169,124,5,0,2,0,0,1,0,1,2167,8,662
"17746","풍납2동","관내사전투표","대통령선거","서울특별시","송파구",4045,4045,1910,731,801,319,261,2,0,0,1,3,0,3,2,4033,12,0
"17747","풍납2동","풍납2동제1투","대통령선거","서울특별시","송파구",2318,1687,699,339,397,138,106,1,0,0,0,0,1,1,0,1682,5,631
"17748","풍납2동","풍납2동제2투","대통령선거","서울특별시","송파구",2029,1409,580,335,289,119,79,1,0,1,0,0,1,1,1,1407,2,620
"17749","풍납2동","풍납2동제3투","대통령선거","서울특별시","송파구",2571,1933,713,444,491,155,114,6,1,1,1,1,0,0,0,1927,6,638
"17750","풍납2동","풍납2동제4투","대통령선거","서울특별시","송파구",2861,2171,933,452,465,175,130,5,0,0,1,3,0,1,0,2165,6,690
"17751","풍납2동","풍납2동제5투","대통령선거","서울특별시","송파구",2079,1530,555,404,380,99,85,2,0,0,0,0,0,0,0,1525,5,549
"17752","풍납2동","풍납2동제6투","대통령선거","서울특별시","송파구",2697,2078,808,487,481,168,122,3,0,1,1,2,0,0,1,2074,4,619
"17753","거여1동","관내사전투표","대통령선거","서울특별시","송파구",1941,1941,854,425,411,122,118,0,1,3,3,0,0,1,0,1938,3,0
"17754","거여1동","거여1동제1투","대통령선거","서울특별시","송파구",3359,2262,844,575,563,147,111,5,0,1,0,0,0,0,4,2250,12,1097
"17755","거여1동","거여1동제2투","대통령선거","서울특별시","송파구",2383,1669,631,419,415,83,106,4,0,3,0,0,0,2,2,1665,4,714
"17756","거여1동","거여1동제3투","대통령선거","서울특별시","송파구",2665,2001,702,554,484,144,108,2,0,0,0,1,0,0,2,1997,4,664
"17757","거여2동","관내사전투표","대통령선거","서울특별시","송파구",2915,2915,1365,553,597,199,178,3,0,3,1,1,2,0,1,2903,12,0
"17758","거여2동","거여2동제1투","대통령선거","서울특별시","송파구",2900,1737,615,468,431,116,93,1,0,2,0,2,0,0,4,1732,5,1163
"17759","거여2동","거여2동제2투","대통령선거","서울특별시","송파구",2483,1733,586,448,423,108,110,3,1,0,3,1,3,1,3,1690,43,750
"17760","거여2동","거여2동제3투","대통령선거","서울특별시","송파구",3403,2661,1084,637,590,191,147,1,0,2,0,1,2,2,1,2658,3,742
"17761","거여2동","거여2동제4투","대통령선거","서울특별시","송파구",2861,2179,946,505,441,151,119,3,0,2,0,1,0,3,2,2173,6,682
"17762","마천1동","관내사전투표","대통령선거","서울특별시","송파구",2644,2644,1160,598,563,148,152,3,0,1,1,4,1,1,5,2637,7,0
"17763","마천1동","마천1동제1투","대통령선거","서울특별시","송파구",2694,1612,621,391,428,80,75,0,0,3,0,3,1,2,2,1606,6,1082
"17764","마천1동","마천1동제2투","대통령선거","서울특별시","송파구",2918,1873,719,430,474,117,113,4,0,2,0,0,0,3,2,1864,9,1045
"17765","마천1동","마천1동제3투","대통령선거","서울특별시","송파구",3048,2073,747,548,552,109,100,0,0,2,1,0,0,1,6,2066,7,975
"17766","마천1동","마천1동제4투","대통령선거","서울특별시","송파구",2444,1544,521,406,433,84,88,1,0,0,0,1,0,3,1,1538,6,900
"17767","마천1동","마천1동제5투","대통령선거","서울특별시","송파구",3389,2654,1100,578,605,184,170,1,0,2,3,1,2,0,2,2648,6,735
"17768","마천2동","관내사전투표","대통령선거","서울특별시","송파구",3056,3056,1360,659,696,147,179,3,0,1,0,0,0,1,2,3048,8,0
"17769","마천2동","마천2동제1투","대통령선거","서울특별시","송파구",3438,2107,841,486,532,127,106,2,0,1,2,0,1,2,2,2102,5,1331
"17770","마천2동","마천2동제2투","대통령선거","서울특별시","송파구",3436,2235,869,537,594,97,118,7,0,3,0,1,1,2,0,2229,6,1201
"17771","마천2동","마천2동제3투","대통령선거","서울특별시","송파구",3660,2579,1062,577,634,145,141,6,1,4,0,0,0,0,1,2571,8,1081
"17772","마천2동","마천2동제4투","대통령선거","서울특별시","송파구",3143,2214,852,506,569,143,128,1,0,2,1,0,1,0,1,2204,10,929
"17773","방이1동","관내사전투표","대통령선거","서울특별시","송파구",3085,3085,1374,663,596,258,180,3,0,0,1,0,1,1,1,3078,7,0
"17774","방이1동","방이1동제1투","대통령선거","서울특별시","송파구",3023,2262,797,606,547,186,107,8,0,0,0,2,2,1,2,2258,4,761
"17775","방이1동","방이1동제2투","대통령선거","서울특별시","송파구",3379,2424,1044,518,502,189,147,7,0,3,1,0,0,0,0,2411,13,955
"17776","방이1동","방이1동제3투","대통령선거","서울특별시","송파구",3005,2403,840,629,527,250,142,2,0,2,0,0,1,3,2,2398,5,602
"17777","방이2동","관내사전투표","대통령선거","서울특별시","송파구",3827,3827,1878,659,744,295,237,2,1,0,0,3,2,1,0,3822,5,0
"17778","방이2동","방이2동제1투","대통령선거","서울특별시","송파구",3389,2207,876,499,487,200,133,4,1,1,0,3,1,0,1,2206,1,1182
"17779","방이2동","방이2동제2투","대통령선거","서울특별시","송파구",2998,2041,870,411,460,145,148,2,0,1,1,0,0,1,0,2039,2,957
"17780","방이2동","방이2동제3투","대통령선거","서울특별시","송파구",3089,1944,817,468,403,139,105,6,0,0,1,0,0,0,1,1940,4,1145
"17781","방이2동","방이2동제4투","대통령선거","서울특별시","송파구",3248,2392,943,527,553,209,146,5,0,0,0,2,0,2,2,2389,3,856
"17782","방이2동","방이2동제5투","대통령선거","서울특별시","송파구",3052,2237,907,470,524,184,141,1,0,0,4,0,0,0,2,2233,4,815
"17783","오륜동","관내사전투표","대통령선거","서울특별시","송파구",3180,3180,1184,788,709,318,173,3,0,0,0,1,0,1,1,3178,2,0
"17784","오륜동","오륜동제1투","대통령선거","서울특별시","송파구",2163,1665,444,540,412,189,73,1,0,1,0,0,0,0,0,1660,5,498
"17785","오륜동","오륜동제2투","대통령선거","서울특별시","송파구",2988,2438,742,765,551,263,110,3,0,0,0,0,0,0,1,2435,3,550
"17786","오륜동","오륜동제3투","대통령선거","서울특별시","송파구",2690,2238,685,681,486,260,114,6,0,1,0,0,0,1,0,2234,4,452
"17787","오륜동","오륜동제4투","대통령선거","서울특별시","송파구",2695,2112,624,591,537,246,100,5,0,1,1,0,0,3,0,2108,4,583
"17788","오금동","관내사전투표","대통령선거","서울특별시","송파구",5088,5088,2114,1099,1077,441,325,10,2,1,1,1,1,0,3,5075,13,0
"17789","오금동","오금동제1투","대통령선거","서울특별시","송파구",3373,2386,667,821,529,252,104,1,0,1,1,0,1,0,2,2379,7,987
"17790","오금동","오금동제2투","대통령선거","서울특별시","송파구",3478,2676,919,672,689,231,149,4,0,0,0,1,0,0,4,2669,7,802
"17791","오금동","오금동제3투","대통령선거","서울특별시","송파구",3327,2382,910,573,546,184,147,3,0,1,1,2,2,1,1,2371,11,945
"17792","오금동","오금동제4투","대통령선거","서울특별시","송파구",3274,2321,903,553,552,140,151,7,1,3,2,1,0,0,1,2314,7,953
"17793","오금동","오금동제5투","대통령선거","서울특별시","송파구",3516,2568,1068,565,582,192,148,5,0,2,0,1,0,2,0,2565,3,948
"17794","오금동","오금동제6투","대통령선거","서울특별시","송파구",2694,2111,794,479,502,232,97,1,0,2,0,0,0,0,0,2107,4,583
"17795","오금동","오금동제7투","대통령선거","서울특별시","송파구",3234,2390,935,523,577,169,167,3,0,3,0,0,0,1,2,2380,10,844
"17796","송파1동","관내사전투표","대통령선거","서울특별시","송파구",4470,4470,2166,742,874,358,307,10,0,1,2,1,1,0,2,4464,6,0
"17797","송파1동","송파1동제1투","대통령선거","서울특별시","송파구",3077,2031,873,406,454,156,137,1,0,0,0,1,1,0,0,2029,2,1046
"17798","송파1동","송파1동제2투","대통령선거","서울특별시","송파구",2388,1795,703,461,392,133,93,6,0,0,1,0,0,0,0,1789,6,593
"17799","송파1동","송파1동제3투","대통령선거","서울특별시","송파구",2185,1586,694,328,332,133,94,2,1,0,0,0,0,1,0,1585,1,599
"17800","송파1동","송파1동제4투","대통령선거","서울특별시","송파구",2433,1783,756,373,364,143,135,6,0,0,0,0,0,2,1,1780,3,650
"17801","송파1동","송파1동제5투","대통령선거","서울특별시","송파구",2820,2074,924,410,436,140,150,1,0,0,0,2,0,1,0,2064,10,746
"17802","송파1동","송파1동제6투","대통령선거","서울특별시","송파구",3115,2342,827,616,542,209,130,7,0,1,1,0,0,4,3,2340,2,773
"17803","송파2동","관내사전투표","대통령선거","서울특별시","송파구",3605,3605,1517,749,781,302,240,7,0,0,0,0,1,0,2,3599,6,0
"17804","송파2동","송파2동제1투","대통령선거","서울특별시","송파구",2772,2014,699,525,511,166,101,4,1,0,0,0,0,0,0,2007,7,758
"17805","송파2동","송파2동제2투","대통령선거","서울특별시","송파구",3028,2293,935,494,561,165,126,5,0,0,1,3,0,0,1,2291,2,735
"17806","송파2동","송파2동제3투","대통령선거","서울특별시","송파구",3199,2577,954,621,585,293,112,2,0,0,0,1,0,0,2,2570,7,622
"17807","송파2동","송파2동제4투","대통령선거","서울특별시","송파구",3580,2897,930,754,748,307,145,4,0,0,1,0,0,0,0,2889,8,683
"17808","석촌동","관내사전투표","대통령선거","서울특별시","송파구",5197,5197,2531,861,1045,385,346,9,0,1,0,0,0,1,2,5181,16,0
"17809","석촌동","석촌동제1투","대통령선거","서울특별시","송파구",2853,1918,800,424,405,141,135,2,1,1,0,0,0,2,2,1913,5,935
"17810","석촌동","석촌동제2투","대통령선거","서울특별시","송파구",2810,1855,852,331,407,131,120,6,0,2,0,1,1,0,1,1852,3,955
"17811","석촌동","석촌동제3투","대통령선거","서울특별시","송파구",3315,2241,943,437,520,191,138,2,0,0,0,3,0,2,0,2236,5,1074
"17812","석촌동","석촌동제4투","대통령선거","서울특별시","송파구",3175,2216,917,469,540,133,140,1,0,4,0,0,0,1,2,2207,9,959
"17813","석촌동","석촌동제5투","대통령선거","서울특별시","송파구",3195,1942,806,429,441,133,116,6,0,0,0,1,0,0,1,1933,9,1253
"17814","석촌동","석촌동제6투","대통령선거","서울특별시","송파구",3164,2146,835,504,524,144,113,7,0,2,0,1,0,3,0,2133,13,1018
"17815","석촌동","석촌동제7투","대통령선거","서울특별시","송파구",2486,1798,755,368,428,127,105,2,0,0,0,0,1,0,1,1787,11,688
"17816","삼전동","관내사전투표","대통령선거","서울특별시","송파구",5290,5290,2612,830,1034,387,395,4,1,2,0,4,1,0,2,5272,18,0
"17817","삼전동","삼전동제1투","대통령선거","서울특별시","송파구",2424,1388,534,298,347,101,95,2,0,1,1,0,0,0,1,1380,8,1036
"17818","삼전동","삼전동제2투","대통령선거","서울특별시","송파구",2455,1635,692,355,368,112,97,0,0,2,1,0,0,1,2,1630,5,820
"17819","삼전동","삼전동제3투","대통령선거","서울특별시","송파구",2640,1907,769,430,401,151,140,3,0,1,0,0,0,2,1,1898,9,733
"17820","삼전동","삼전동제4투","대통령선거","서울특별시","송파구",2630,1805,732,391,410,151,113,0,0,3,0,1,0,1,0,1802,3,825
"17821","삼전동","삼전동제5투","대통령선거","서울특별시","송파구",2750,1982,855,409,418,155,133,4,0,2,0,0,0,0,2,1978,4,768
"17822","삼전동","삼전동제6투","대통령선거","서울특별시","송파구",2541,1649,708,340,355,114,124,1,0,0,1,0,0,1,0,1644,5,892
"17823","삼전동","삼전동제7투","대통령선거","서울특별시","송파구",2774,1922,831,379,417,161,126,1,0,1,1,0,0,0,1,1918,4,852
"17824","삼전동","삼전동제8투","대통령선거","서울특별시","송파구",2357,1684,750,321,363,121,118,2,0,1,0,0,1,0,3,1680,4,673
"17825","가락본동","관내사전투표","대통령선거","서울특별시","송파구",4290,4290,1921,783,895,362,306,4,0,1,2,0,0,3,0,4277,13,0
"17826","가락본동","가락본동제1투","대통령선거","서울특별시","송파구",2607,1604,596,401,372,134,89,5,0,0,0,0,1,0,1,1599,5,1003
"17827","가락본동","가락본동제2투","대통령선거","서울특별시","송파구",3281,2470,941,561,607,181,164,3,0,1,0,2,1,1,2,2464,6,811
"17828","가락본동","가락본동제3투","대통령선거","서울특별시","송파구",3161,2221,887,527,482,171,137,9,0,2,0,0,0,2,0,2217,4,940
"17829","가락본동","가락본동제4투","대통령선거","서울특별시","송파구",2119,1598,660,313,373,161,88,1,0,0,0,1,0,1,0,1598,0,521
"17830","가락본동","가락본동제5투","대통령선거","서울특별시","송파구",2881,2122,879,430,512,142,139,7,0,0,1,0,1,1,3,2115,7,759
"17831","가락본동","가락본동제6투","대통령선거","서울특별시","송파구",2614,2025,657,582,522,171,86,6,0,0,0,0,0,0,0,2024,1,589
"17832","가락1동","관내사전투표","대통령선거","서울특별시","송파구",286,286,115,71,67,14,17,2,0,0,0,0,0,0,0,286,0,0
"17833","가락1동","가락1동투표소","대통령선거","서울특별시","송파구",582,339,140,65,83,31,17,2,0,0,0,0,0,0,0,338,1,243
"17834","가락2동","관내사전투표","대통령선거","서울특별시","송파구",3883,3883,1789,752,777,282,258,5,0,2,0,6,0,1,2,3874,9,0
"17835","가락2동","가락2동제1투","대통령선거","서울특별시","송파구",3059,2114,888,426,475,180,135,1,0,1,1,0,0,0,3,2110,4,945
"17836","가락2동","가락2동제2투","대통령선거","서울특별시","송파구",2830,2179,867,458,535,184,123,1,0,1,0,0,0,1,1,2171,8,651
"17837","가락2동","가락2동제3투","대통령선거","서울특별시","송파구",3347,2901,1257,524,687,271,148,1,0,2,0,1,0,0,3,2894,7,446
"17838","가락2동","가락2동제4투","대통령선거","서울특별시","송파구",2813,2217,845,507,544,200,102,11,1,0,1,0,0,0,0,2211,6,596
"17839","가락2동","가락2동제5투","대통령선거","서울특별시","송파구",2931,2281,776,630,552,199,107,2,0,1,1,1,1,2,0,2272,9,650
"17840","가락2동","가락2동제6투","대통령선거","서울특별시","송파구",2950,2309,855,541,579,203,121,2,0,0,0,0,0,0,0,2301,8,641
"17841","가락2동","가락2동제7투","대통령선거","서울특별시","송파구",2793,2215,777,519,572,205,127,6,0,0,0,0,1,0,0,2207,8,578
"17842","문정1동","관내사전투표","대통령선거","서울특별시","송파구",4003,4003,1881,692,799,348,264,3,0,2,0,1,0,2,1,3993,10,0
"17843","문정1동","문정1동제1투","대통령선거","서울특별시","송파구",3536,2321,980,475,548,158,140,6,1,2,0,1,0,2,0,2313,8,1215
"17844","문정1동","문정1동제2투","대통령선거","서울특별시","송파구",2788,2189,823,512,534,176,133,1,2,2,0,1,1,0,2,2187,2,599
"17845","문정1동","문정1동제3투","대통령선거","서울특별시","송파구",3217,2238,922,475,512,174,143,1,0,0,0,1,3,1,2,2234,4,979
"17846","문정1동","문정1동제4투","대통령선거","서울특별시","송파구",3785,3104,878,1030,786,278,118,5,0,0,0,0,0,3,2,3100,4,681
"17847","문정2동","관내사전투표","대통령선거","서울특별시","송파구",2831,2831,1029,823,579,259,129,4,0,0,0,0,0,1,1,2825,6,0
"17848","문정2동","문정2동제1투","대통령선거","서울특별시","송파구",2678,2097,502,818,457,237,72,5,0,2,0,0,0,0,0,2093,4,581
"17849","문정2동","문정2동제2투","대통령선거","서울특별시","송파구",3437,2740,706,933,696,302,92,1,0,0,1,1,0,0,0,2732,8,697
"17850","문정2동","문정2동제3투","대통령선거","서울특별시","송파구",3077,2387,611,865,544,262,91,7,0,0,0,1,0,2,0,2383,4,690
"17851","문정2동","문정2동제4투","대통령선거","서울특별시","송파구",3287,2294,1179,236,451,237,184,2,0,0,0,1,0,0,2,2292,2,993
"17852","문정2동","문정2동제5투","대통령선거","서울특별시","송파구",3728,2980,1231,466,715,354,205,1,0,0,0,0,1,1,0,2974,6,748
"17853","장지동","관내사전투표","대통령선거","서울특별시","송파구",5225,5225,2413,889,1117,411,371,2,1,1,0,4,0,0,5,5214,11,0
"17854","장지동","장지동제1투","대통령선거","서울특별시","송파구",3221,2215,923,434,525,167,155,1,0,1,0,3,0,1,1,2211,4,1006
"17855","장지동","장지동제2투","대통령선거","서울특별시","송파구",2246,1619,603,368,435,101,104,4,0,0,0,0,0,0,1,1616,3,627
"17856","장지동","장지동제3투","대통령선거","서울특별시","송파구",3075,2200,911,483,524,138,128,1,0,2,0,1,0,1,3,2192,8,875
"17857","장지동","장지동제4투","대통령선거","서울특별시","송파구",2545,1927,793,371,466,148,135,6,0,2,0,2,0,0,0,1923,4,618
"17858","장지동","장지동제5투","대통령선거","서울특별시","송파구",3693,2723,1059,621,618,231,175,5,0,2,0,0,0,0,0,2711,12,970
"17859","장지동","장지동제6투","대통령선거","서울특별시","송파구",3329,2608,1108,513,603,218,145,3,1,0,0,1,1,0,0,2593,15,721
"17860","장지동","장지동제7투","대통령선거","서울특별시","송파구",2856,2223,1002,435,497,168,113,0,0,0,0,3,0,1,0,2219,4,633
"17861","잠실본동","관내사전투표","대통령선거","서울특별시","송파구",4801,4801,2307,874,905,321,358,4,0,2,0,3,1,3,1,4779,22,0
"17862","잠실본동","잠실본동제1투","대통령선거","서울특별시","송파구",3475,2072,904,440,448,136,136,3,0,1,0,0,0,0,1,2069,3,1403
"17863","잠실본동","잠실본동제2투","대통령선거","서울특별시","송파구",2679,1661,667,383,363,118,113,4,0,0,0,2,1,0,0,1651,10,1018
"17864","잠실본동","잠실본동제3투","대통령선거","서울특별시","송파구",2708,1865,792,404,411,143,109,1,0,0,0,2,0,0,0,1862,3,843
"17865","잠실본동","잠실본동제4투","대통령선거","서울특별시","송파구",2866,2019,876,427,433,162,106,5,0,0,1,0,0,1,1,2012,7,847
"17866","잠실본동","잠실본동제5투","대통령선거","서울특별시","송파구",3033,2187,856,500,496,178,140,2,0,2,0,3,1,1,0,2179,8,846
"17867","잠실본동","잠실본동제6투","대통령선거","서울특별시","송파구",3090,2151,920,462,439,171,149,2,0,0,1,2,0,0,1,2147,4,939
"17868","잠실2동","관내사전투표","대통령선거","서울특별시","송파구",5969,5969,2646,1152,1226,610,305,11,0,2,1,1,0,1,0,5955,14,0
"17869","잠실2동","잠실2동제1투","대통령선거","서울특별시","송파구",2113,1679,673,353,370,197,82,3,0,0,0,0,0,0,0,1678,1,434
"17870","잠실2동","잠실2동제2투","대통령선거","서울특별시","송파구",2968,2442,835,561,616,311,108,5,0,1,0,0,0,1,0,2438,4,526
"17871","잠실2동","잠실2동제3투","대통령선거","서울특별시","송파구",3005,1966,767,383,506,206,94,1,0,1,0,1,0,1,1,1961,5,1039
"17872","잠실2동","잠실2동제4투","대통령선거","서울특별시","송파구",2599,2083,671,535,524,239,101,3,0,1,0,1,0,3,0,2078,5,516
"17873","잠실2동","잠실2동제5투","대통령선거","서울특별시","송파구",2921,2363,910,499,578,268,99,0,0,1,0,0,0,2,0,2357,6,558
"17874","잠실2동","잠실2동제6투","대통령선거","서울특별시","송파구",2541,2132,804,496,536,210,80,3,0,0,0,0,0,0,0,2129,3,409
"17875","잠실2동","잠실2동제7투","대통령선거","서울특별시","송파구",2955,2457,955,535,560,284,113,4,0,1,0,1,0,0,0,2453,4,498
"17876","잠실3동","관내사전투표","대통령선거","서울특별시","송파구",4164,4164,1574,1144,829,392,205,8,2,0,0,2,1,0,0,4157,7,0
"17877","잠실3동","잠실3동제1투","대통령선거","서울특별시","송파구",2293,1824,545,543,445,204,76,5,0,1,0,1,0,0,1,1821,3,469
"17878","잠실3동","잠실3동제2투","대통령선거","서울특별시","송파구",2865,1981,617,617,440,188,105,9,0,0,0,0,0,0,0,1976,5,884
"17879","잠실3동","잠실3동제3투","대통령선거","서울특별시","송파구",2219,1784,559,545,446,154,68,4,0,2,0,0,0,1,0,1779,5,435
"17880","잠실3동","잠실3동제4투","대통령선거","서울특별시","송파구",1723,1322,250,578,324,125,39,3,0,0,0,0,2,0,0,1321,1,401
"17881","잠실3동","잠실3동제5투","대통령선거","서울특별시","송파구",3165,2594,819,785,607,270,100,4,0,1,0,0,0,0,3,2589,5,571
"17882","잠실3동","잠실3동제6투","대통령선거","서울특별시","송파구",2424,1988,602,663,433,198,77,4,0,0,2,0,0,1,0,1980,8,436
"17883","잠실3동","잠실3동제7투","대통령선거","서울특별시","송파구",3351,2694,959,694,641,291,99,4,0,0,1,0,0,0,0,2689,5,657
"17884","잠실3동","잠실3동제8투","대통령선거","서울특별시","송파구",3470,2878,1113,675,630,300,139,11,0,0,0,0,1,0,1,2870,8,592
"17885","잠실4동","관내사전투표","대통령선거","서울특별시","송파구",4547,4547,1984,1062,840,422,225,4,0,1,1,0,0,1,0,4540,7,0
"17886","잠실4동","잠실4동제1투","대통령선거","서울특별시","송파구",2591,1867,699,468,434,186,75,2,0,0,0,2,0,0,0,1866,1,724
"17887","잠실4동","잠실4동제2투","대통령선거","서울특별시","송파구",3036,2491,887,628,598,264,109,3,0,0,0,0,0,0,1,2490,1,545
"17888","잠실4동","잠실4동제3투","대통령선거","서울특별시","송파구",3202,2581,942,647,618,252,106,5,0,0,0,2,0,2,0,2574,7,621
"17889","잠실4동","잠실4동제4투","대통령선거","서울특별시","송파구",3192,2558,962,634,551,273,125,2,0,0,0,2,1,1,1,2552,6,634
"17890","잠실4동","잠실4동제5투","대통령선거","서울특별시","송파구",2227,1845,652,467,409,209,95,2,1,0,0,0,0,2,0,1837,8,382
"17891","잠실4동","잠실4동제6투","대통령선거","서울특별시","송파구",2789,2247,675,801,483,209,66,6,0,0,1,0,1,0,1,2243,4,542
"17892","잠실6동","관내사전투표","대통령선거","서울특별시","송파구",3715,3715,1445,986,722,351,194,3,0,0,1,0,0,4,0,3706,9,0
"17893","잠실6동","잠실6동제1투","대통령선거","서울특별시","송파구",3369,2484,815,724,553,278,104,5,0,0,0,0,0,0,0,2479,5,885
"17894","잠실6동","잠실6동제2투","대통령선거","서울특별시","송파구",3081,2300,724,742,509,220,94,3,0,0,0,0,0,1,1,2294,6,781
"17895","잠실6동","잠실6동제3투","대통령선거","서울특별시","송파구",3164,2480,829,713,557,244,128,1,0,0,0,1,1,1,1,2476,4,684
"17896","잠실7동","관내사전투표","대통령선거","서울특별시","송파구",1847,1846,587,556,388,214,91,3,0,0,0,0,0,0,1,1840,6,1
"17897","잠실7동","잠실7동제1투","대통령선거","서울특별시","송파구",3274,2474,475,1130,526,240,90,4,0,1,0,0,0,1,2,2469,5,800
"17898","잠실7동","잠실7동제2투","대통령선거","서울특별시","송파구",2992,2461,693,753,554,305,135,8,0,0,0,2,0,2,1,2453,8,531
"17899","위례동","관내사전투표","대통령선거","서울특별시","송파구",3545,3545,1634,584,763,338,210,3,1,2,1,0,0,0,0,3536,9,0
"17900","위례동","위례동제1투","대통령선거","서울특별시","송파구",2490,1941,785,318,512,187,135,1,0,0,0,0,0,1,0,1939,2,549
"17901","위례동","위례동제2투","대통령선거","서울특별시","송파구",2856,2237,1097,315,498,179,136,4,0,1,1,1,1,1,0,2234,3,619
"17902","위례동","위례동제3투","대통령선거","서울특별시","송파구",3131,2516,948,537,641,259,127,1,0,0,0,1,0,0,0,2514,2,615
"17903","위례동","위례동제4투","대통령선거","서울특별시","송파구",1804,1394,380,370,359,222,53,0,1,0,0,1,0,1,1,1388,6,410
"17904","잘못 투입·구분된 투표지","잘못 투입·구분된 투표지","대통령선거","서울특별시","송파구",0,0,0,0,0,0,0,0,0,0,0,0,0,0,0,0,0,0
"17905","거소·선상투표","거소·선상투표","대통령선거","서울특별시","강동구",630,596,190,101,193,40,19,8,1,0,3,2,1,0,2,560,36,34
"17906","관외사전투표","관외사전투표","대통령선거","서울특별시","강동구",30867,30854,14334,4927,6550,2512,2231,37,7,12,3,20,7,9,40,30689,165,13
"17907","재외투표","재외투표","대통령선거","서울특별시","강동구",3856,2995,1779,269,462,124,336,8,1,3,0,1,1,1,1,2986,9,861
"17908","강일동","관내사전투표","대통령선거","서울특별시","강동구",3972,3972,1933,685,798,289,241,5,0,2,0,4,2,0,2,3961,11,0
"17909","강일동","강일동제1투","대통령선거","서울특별시","강동구",3164,2184,929,486,463,152,133,4,1,2,0,2,1,1,3,2177,7,980
"17910","강일동","강일동제2투","대통령선거","서울특별시","강동구",2789,2088,905,457,468,122,122,2,0,1,1,1,1,0,0,2080,8,701
"17911","강일동","강일동제3투","대통령선거","서울특별시","강동구",2813,2103,844,466,542,131,106,1,0,2,0,1,0,1,1,2095,8,710
"17912","강일동","강일동제4투","대통령선거","서울특별시","강동구",3114,2349,951,492,564,174,157,4,1,0,1,0,0,1,0,2345,4,765
"17913","강일동","강일동제5투","대통령선거","서울특별시","강동구",2521,2022,897,362,471,157,122,2,0,1,0,4,1,0,0,2017,5,499
"17914","강일동","강일동제6투","대통령선거","서울특별시","강동구",2070,1585,628,344,397,85,111,2,1,3,0,1,0,1,2,1575,10,485
"17915","강일동","강일동제7투","대통령선거","서울특별시","강동구",2269,1765,819,300,390,130,116,3,0,1,0,1,0,0,0,1760,5,504
"17916","상일동","관내사전투표","대통령선거","서울특별시","강동구",2122,2122,970,434,431,152,122,5,0,2,1,0,0,1,1,2119,3,0
"17917","상일동","상일동제1투","대통령선거","서울특별시","강동구",2604,1793,655,412,441,162,111,1,0,2,1,0,0,0,0,1785,8,811
"17918","상일동","상일동제2투","대통령선거","서울특별시","강동구",2417,1716,608,489,393,109,98,11,0,0,0,1,1,1,0,1711,5,701
"17919","상일동","상일동제3투","대통령선거","서울특별시","강동구",2230,1670,552,529,355,130,82,5,1,0,0,0,0,0,5,1659,11,560
"17920","명일제1동","관내사전투표","대통령선거","서울특별시","강동구",4570,4569,1915,1056,931,382,251,2,0,9,1,2,0,5,3,4557,12,1
"17921","명일제1동","명일제1동제1투","대통령선거","서울특별시","강동구",3072,2087,714,635,464,145,114,1,0,0,2,1,0,0,2,2078,9,985
"17922","명일제1동","명일제1동제2투","대통령선거","서울특별시","강동구",3363,2617,869,755,633,202,145,6,0,2,0,0,0,0,0,2612,5,746
"17923","명일제1동","명일제1동제3투","대통령선거","서울특별시","강동구",2128,1706,572,507,391,149,81,1,0,0,1,0,1,0,1,1704,2,422
"17924","명일제1동","명일제1동제4투","대통령선거","서울특별시","강동구",2423,1987,785,421,477,177,117,5,0,3,0,0,0,0,1,1986,1,436
"17925","명일제1동","명일제1동제5투","대통령선거","서울특별시","강동구",2132,1557,594,417,362,93,83,1,0,1,0,1,1,0,0,1553,4,575
"17926","명일제2동","관내사전투표","대통령선거","서울특별시","강동구",2596,2596,1127,587,514,205,148,9,0,1,0,0,0,0,1,2592,4,0
"17927","명일제2동","명일제2동제1투","대통령선거","서울특별시","강동구",2477,2065,746,534,490,178,110,1,0,1,1,0,0,0,1,2062,3,412
"17928","명일제2동","명일제2동제2투","대통령선거","서울특별시","강동구",2616,1871,644,512,433,164,99,8,0,0,0,0,0,0,2,1862,9,745
"17929","명일제2동","명일제2동제3투","대통령선거","서울특별시","강동구",2671,2219,836,543,509,187,132,2,0,0,2,0,0,0,1,2212,7,452
"17930","명일제2동","명일제2동제4투","대통령선거","서울특별시","강동구",2650,2144,769,599,447,213,103,3,0,2,0,1,0,0,2,2139,5,506
"17931","고덕제1동","관내사전투표","대통령선거","서울특별시","강동구",4261,4261,1982,780,870,360,248,3,0,1,2,0,0,3,2,4251,10,0
"17932","고덕제1동","고덕제1동제1투","대통령선거","서울특별시","강동구",2029,1480,664,303,329,103,72,0,0,0,0,1,0,1,0,1473,7,549
"17933","고덕제1동","고덕제1동제2투","대통령선거","서울특별시","강동구",2090,1688,743,322,367,159,93,1,0,0,0,0,0,0,0,1685,3,402
"17934","고덕제1동","고덕제1동제3투","대통령선거","서울특별시","강동구",1980,1474,580,359,352,104,72,3,0,1,1,0,0,0,0,1472,2,506
"17935","고덕제1동","고덕제1동제4투","대통령선거","서울특별시","강동구",2357,1612,548,469,392,96,93,2,0,3,1,1,0,0,2,1607,5,745
"17936","고덕제1동","고덕제1동제5투","대통령선거","서울특별시","강동구",2125,1814,704,354,448,197,106,0,0,3,0,0,0,0,1,1813,1,311
"17937","고덕제1동","고덕제1동제6투","대통령선거","서울특별시","강동구",2071,1737,810,305,368,153,94,1,0,0,0,0,0,0,0,1731,6,334
"17938","고덕제2동","관내사전투표","대통령선거","서울특별시","강동구",1147,1147,455,308,242,67,70,1,0,1,0,0,0,0,0,1144,3,0
"17939","고덕제2동","고덕제2동제1투","대통령선거","서울특별시","강동구",2853,1753,617,488,433,102,82,3,0,3,1,5,2,0,5,1741,12,1100
"17940","고덕제2동","고덕제2동제2투","대통령선거","서울특별시","강동구",2607,1793,630,513,431,112,95,1,0,2,0,2,1,0,2,1789,4,814
"17941","암사제1동","관내사전투표","대통령선거","서울특별시","강동구",4327,4327,2008,865,908,255,254,13,1,0,1,4,1,4,0,4314,13,0
"17942","암사제1동","암사제1동제1투","대통령선거","서울특별시","강동구",3716,2143,898,493,471,138,133,3,0,0,1,0,1,1,0,2139,4,1573
"17943","암사제1동","암사제1동제2투","대통령선거","서울특별시","강동구",3020,1994,784,454,509,113,121,1,0,0,2,1,0,1,2,1988,6,1026
"17944","암사제1동","암사제1동제3투","대통령선거","서울특별시","강동구",3050,2056,839,472,463,143,123,5,0,1,0,1,1,0,1,2049,7,994
"17945","암사제1동","암사제1동제4투","대통령선거","서울특별시","강동구",2794,1854,695,442,474,116,104,6,2,2,0,2,0,0,3,1846,8,940
"17946","암사제1동","암사제1동제5투","대통령선거","서울특별시","강동구",2463,1580,654,342,404,86,82,1,0,0,0,1,2,1,2,1575,5,883
"17947","암사제1동","암사제1동제6투","대통령선거","서울특별시","강동구",2782,1858,696,453,469,114,113,4,0,1,0,1,0,0,0,1851,7,924
"17948","암사제1동","암사제1동제7투","대통령선거","서울특별시","강동구",2734,1903,689,482,447,146,124,0,0,4,0,0,0,0,3,1895,8,831
"17949","암사제1동","암사제1동제8투","대통령선거","서울특별시","강동구",2998,2506,967,619,559,205,146,3,0,2,2,0,1,0,0,2504,2,492
"17950","암사제2동","관내사전투표","대통령선거","서울특별시","강동구",4263,4263,2054,765,841,291,294,2,0,3,0,0,0,1,3,4254,9,0
"17951","암사제2동","암사제2동제1투","대통령선거","서울특별시","강동구",2103,1592,584,390,405,116,89,3,0,1,0,0,0,2,0,1590,2,511
"17952","암사제2동","암사제2동제2투","대통령선거","서울특별시","강동구",2976,2040,848,453,420,165,143,2,0,1,1,0,0,0,1,2034,6,936
"17953","암사제2동","암사제2동제3투","대통령선거","서울특별시","강동구",2955,2310,990,509,499,175,121,6,1,0,0,1,0,0,0,2302,8,645
"17954","암사제3동","관내사전투표","대통령선거","서울특별시","강동구",3626,3626,1639,708,735,315,209,2,0,2,3,1,0,0,3,3617,9,0
"17955","암사제3동","암사제3동제1투","대통령선거","서울특별시","강동구",3121,2396,890,601,568,216,106,5,0,0,0,0,0,1,3,2390,6,725
"17956","암사제3동","암사제3동제2투","대통령선거","서울특별시","강동구",2634,2138,724,573,517,204,107,7,0,0,1,1,0,0,1,2135,3,496
"17957","암사제3동","암사제3동제3투","대통령선거","서울특별시","강동구",2522,1965,793,457,449,132,125,1,0,0,0,1,0,0,1,1959,6,557
"17958","암사제3동","암사제3동제4투","대통령선거","서울특별시","강동구",2257,1813,702,420,436,127,118,1,0,0,0,1,1,0,0,1806,7,444
"17959","천호제1동","관내사전투표","대통령선거","서울특별시","강동구",3967,3967,1747,815,885,235,256,5,0,0,0,1,2,3,1,3950,17,0
"17960","천호제1동","천호제1동제1투","대통령선거","서울특별시","강동구",3520,2072,807,469,527,135,121,3,0,0,0,2,0,1,2,2067,5,1448
"17961","천호제1동","천호제1동제2투","대통령선거","서울특별시","강동구",3446,2445,902,653,594,153,130,1,0,1,0,1,0,2,0,2437,8,1001
"17962","천호제1동","천호제1동제3투","대통령선거","서울특별시","강동구",2970,1928,698,449,522,121,120,2,0,1,0,0,2,1,2,1918,10,1042
"17963","천호제1동","천호제1동제4투","대통령선거","서울특별시","강동구",3473,2521,992,621,590,160,138,5,0,3,0,2,0,0,2,2513,8,952
"17964","천호제1동","천호제1동제5투","대통령선거","서울특별시","강동구",2944,2087,793,555,474,136,116,1,0,3,2,0,0,2,1,2083,4,857
"17965","천호제1동","천호제1동제6투","대통령선거","서울특별시","강동구",2797,1910,736,480,456,115,112,3,0,0,0,1,0,0,0,1903,7,887
"17966","천호제2동","관내사전투표","대통령선거","서울특별시","강동구",4539,4539,2088,924,965,246,281,8,0,3,3,4,1,1,5,4529,10,0
"17967","천호제2동","천호제2동제1투","대통령선거","서울특별시","강동구",2475,1609,579,419,414,85,100,1,0,0,0,1,0,3,0,1602,7,866
"17968","천호제2동","천호제2동제2투","대통령선거","서울특별시","강동구",2758,1982,851,440,438,123,115,3,2,2,0,2,0,0,1,1977,5,776
"17969","천호제2동","천호제2동제3투","대통령선거","서울특별시","강동구",2049,1441,539,373,328,91,98,1,1,1,1,0,0,3,0,1436,5,608
"17970","천호제2동","천호제2동제4투","대통령선거","서울특별시","강동구",2567,1650,678,373,361,133,93,1,0,1,0,2,0,2,1,1645,5,917
"17971","천호제2동","천호제2동제5투","대통령선거","서울특별시","강동구",3608,2392,938,572,596,150,122,1,0,1,0,3,0,2,1,2386,6,1216
"17972","천호제2동","천호제2동제6투","대통령선거","서울특별시","강동구",3469,2322,854,563,621,140,126,2,0,3,0,0,0,1,2,2312,10,1147
"17973","천호제2동","천호제2동제7투","대통령선거","서울특별시","강동구",3723,2186,815,529,566,141,117,5,0,2,0,2,1,1,1,2180,6,1537
"17974","천호제2동","천호제2동제8투","대통령선거","서울특별시","강동구",2751,1652,600,447,437,79,70,2,0,2,2,1,2,1,1,1644,8,1099
"17975","천호제3동","관내사전투표","대통령선거","서울특별시","강동구",3624,3623,1574,814,765,210,241,6,0,0,1,1,1,0,2,3615,8,1
"17976","천호제3동","천호제3동제1투","대통령선거","서울특별시","강동구",3087,1879,640,519,473,134,95,2,0,3,2,2,0,2,1,1873,6,1208
"17977","천호제3동","천호제3동제2투","대통령선거","서울특별시","강동구",3308,2282,944,488,565,158,112,5,0,0,1,1,0,0,0,2274,8,1026
"17978","천호제3동","천호제3동제3투","대통령선거","서울특별시","강동구",2629,1593,578,382,453,84,76,5,0,1,1,1,0,2,1,1584,9,1036
"17979","천호제3동","천호제3동제4투","대통령선거","서울특별시","강동구",2233,1408,502,356,372,80,83,3,0,2,0,0,1,0,2,1401,7,825
"17980","천호제3동","천호제3동제5투","대통령선거","서울특별시","강동구",2391,1521,578,349,391,111,78,5,0,1,0,0,1,1,1,1516,5,870
"17981","천호제3동","천호제3동제6투","대통령선거","서울특별시","강동구",2834,2079,809,486,488,148,134,3,0,3,0,2,1,0,0,2074,5,755
"17982","성내제1동","관내사전투표","대통령선거","서울특별시","강동구",3687,3687,1670,705,761,278,255,5,0,2,0,0,0,0,4,3680,7,0
"17983","성내제1동","성내제1동제1투","대통령선거","서울특별시","강동구",2965,2043,802,497,504,104,126,3,0,2,0,0,0,1,0,2039,4,922
"17984","성내제1동","성내제1동제2투","대통령선거","서울특별시","강동구",3247,2557,1049,545,629,153,167,2,1,2,0,1,0,0,3,2552,5,690
"17985","성내제1동","성내제1동제3투","대통령선거","서울특별시","강동구",2722,1975,838,435,423,136,124,4,0,0,0,0,0,2,3,1965,10,747
"17986","성내제1동","성내제1동제4투","대통령선거","서울특별시","강동구",3248,2587,1027,604,571,231,144,4,1,0,0,0,1,0,0,2583,4,661
"17987","성내제2동","관내사전투표","대통령선거","서울특별시","강동구",4001,4001,1904,752,845,226,245,9,0,0,2,2,2,0,2,3989,12,0
"17988","성내제2동","성내제2동제1투","대통령선거","서울특별시","강동구",3409,2088,845,472,492,123,137,7,0,3,0,1,0,0,2,2082,6,1321
"17989","성내제2동","성내제2동제2투","대통령선거","서울특별시","강동구",3371,2390,941,549,556,168,161,7,0,2,0,0,0,0,2,2386,4,981
"17990","성내제2동","성내제2동제3투","대통령선거","서울특별시","강동구",3500,2447,1037,532,582,147,131,4,1,3,0,1,1,0,2,2441,6,1053
"17991","성내제2동","성내제2동제4투","대통령선거","서울특별시","강동구",3157,2257,892,515,581,149,106,1,0,1,0,1,2,1,0,2249,8,900
"17992","성내제2동","성내제2동제5투","대통령선거","서울특별시","강동구",2940,1890,705,502,440,110,120,1,0,1,0,0,1,1,1,1882,8,1050
"17993","성내제3동","관내사전투표","대통령선거","서울특별시","강동구",4223,4223,1888,848,897,306,262,4,0,0,0,2,0,1,2,4210,13,0
"17994","성내제3동","성내제3동제1투","대통령선거","서울특별시","강동구",3219,2116,849,492,474,154,132,3,0,2,0,1,1,0,1,2109,7,1103
"17995","성내제3동","성내제3동제2투","대통령선거","서울특별시","강동구",3214,2278,887,497,571,180,131,2,0,0,0,1,0,0,1,2270,8,936
"17996","성내제3동","성내제3동제3투","대통령선거","서울특별시","강동구",3793,2784,1128,667,587,222,168,3,0,0,0,0,0,0,3,2778,6,1009
"17997","성내제3동","성내제3동제4투","대통령선거","서울특별시","강동구",4301,2988,1239,676,651,214,173,7,1,7,1,0,1,6,2,2978,10,1313
"17998","길동","관내사전투표","대통령선거","서울특별시","강동구",6751,6751,2974,1399,1426,468,448,13,0,4,0,2,0,1,4,6739,12,0
"17999","길동","길동제1투","대통령선거","서울특별시","강동구",3638,2579,1042,576,642,150,152,3,0,3,0,0,0,0,3,2571,8,1059
"18000","길동","길동제2투","대통령선거","서울특별시","강동구",2924,2137,786,586,514,132,98,5,1,0,1,1,3,1,2,2130,7,787
"18001","길동","길동제3투","대통령선거","서울특별시","강동구",3314,2386,949,568,570,143,137,6,1,1,0,2,0,0,4,2381,5,928
"18002","길동","길동제4투","대통령선거","서울특별시","강동구",3809,2523,1054,504,555,212,181,4,0,4,1,0,1,1,0,2517,6,1286
"18003","길동","길동제5투","대통령선거","서울특별시","강동구",2454,1804,700,423,418,140,112,3,0,1,0,0,0,0,1,1798,6,650
"18004","길동","길동제6투","대통령선거","서울특별시","강동구",3450,1871,750,424,451,119,116,0,0,0,0,0,0,0,0,1860,11,1579
"18005","길동","길동제7투","대통령선거","서울특별시","강동구",3326,2439,855,621,639,190,118,0,0,2,0,3,0,0,2,2430,9,887
"18006","길동","길동제8투","대통령선거","서울특별시","강동구",3046,2289,888,564,500,192,125,7,0,1,0,1,0,0,1,2279,10,757
"18007","길동","길동제9투","대통령선거","서울특별시","강동구",2888,2076,788,511,476,181,107,5,0,1,0,2,2,0,1,2074,2,812
"18008","길동","길동제10투","대통령선거","서울특별시","강동구",3197,2315,821,603,613,148,113,3,0,1,1,0,0,0,3,2306,9,882
"18009","둔촌제1동","관내사전투표","대통령선거","서울특별시","강동구",3660,3660,1618,755,752,293,226,4,0,1,0,3,0,1,2,3655,5,0
"18010","둔촌제1동","둔촌제1동제1투","대통령선거","서울특별시","강동구",2710,2098,696,582,494,176,140,5,0,1,0,0,0,0,0,2094,4,612
"18011","둔촌제1동","둔촌제1동제2투","대통령선거","서울특별시","강동구",2401,1718,598,415,434,170,90,0,1,2,0,0,1,3,1,1715,3,683
"18012","둔촌제1동","둔촌제1동제3투","대통령선거","서울특별시","강동구",2652,2095,743,513,525,188,111,10,1,0,0,0,0,0,0,2091,4,557
"18013","둔촌제1동","둔촌제1동제4투","대통령선거","서울특별시","강동구",2457,1895,699,467,429,179,111,6,0,1,0,0,0,0,1,1893,2,562
"18014","둔촌제2동","관내사전투표","대통령선거","서울특별시","강동구",4632,4632,2054,984,945,311,313,6,0,0,0,2,0,2,2,4619,13,0
"18015","둔촌제2동","둔촌제2동제1투","대통령선거","서울특별시","강동구",3509,2325,903,547,556,165,135,3,0,2,2,0,0,0,4,2317,8,1184
"18016","둔촌제2동","둔촌제2동제2투","대통령선거","서울특별시","강동구",3271,2350,935,552,551,157,141,2,0,3,0,0,0,1,0,2342,8,921
"18017","둔촌제2동","둔촌제2동제3투","대통령선거","서울특별시","강동구",3662,2883,1222,634,646,217,155,1,1,0,0,1,0,0,1,2878,5,779
"18018","둔촌제2동","둔촌제2동제4투","대통령선거","서울특별시","강동구",3206,2354,850,609,540,190,146,3,0,1,0,0,1,2,2,2344,10,852
"18019","둔촌제2동","둔촌제2동제5투","대통령선거","서울특별시","강동구",3318,2540,891,674,603,219,146,1,0,0,0,0,0,0,1,2535,5,778
"18020","잘못 투입·구분된 투표지","잘못 투입·구분된 투표지","대통령선거","서울특별시","강동구",0,2,0,0,0,0,1,0,0,0,0,0,0,0,0,1,1,-2
"18021","거소·선상투표","거소·선상투표","대통령선거","울산광역시","중구",441,423,138,88,110,40,20,4,0,0,1,1,0,4,3,409,14,18
"18022","관외사전투표","관외사전투표","대통령선거","울산광역시","중구",15690,15688,6572,2973,2780,1636,1493,10,4,11,7,12,5,8,31,15542,146,2
"18023","재외투표","재외투표","대통령선거","울산광역시","중구",937,709,434,46,102,40,75,5,0,0,0,0,0,0,0,702,7,228
"18024","학성동","관내사전투표","대통령선거","울산광역시","중구",2205,2204,731,841,305,128,168,3,0,6,1,3,0,0,5,2191,13,1
"18025","학성동","학성동제1투","대통령선거","울산광역시","중구",1957,1230,303,550,218,86,61,4,0,1,0,1,0,0,1,1225,5,727
"18026","학성동","학성동제2투","대통령선거","울산광역시","중구",1865,1258,325,596,180,73,69,0,0,5,0,1,1,1,1,1252,6,607
"18027","학성동","학성동제3투","대통령선거","울산광역시","중구",1750,1257,301,573,225,65,80,1,0,1,0,2,0,1,0,1249,8,493
"18028","학성동","학성동제4투","대통령선거","울산광역시","중구",1854,1149,278,523,218,52,66,0,0,2,0,1,1,3,0,1144,5,705
"18029","반구1동","관내사전투표","대통령선거","울산광역시","중구",3348,3348,1512,773,451,218,353,5,0,3,1,3,1,4,1,3325,23,0
"18030","반구1동","반구1동제1투","대통령선거","울산광역시","중구",2801,1909,707,528,361,148,148,1,0,1,2,0,1,1,3,1901,8,892
"18031","반구1동","반구1동제2투","대통령선거","울산광역시","중구",3057,2225,697,762,381,171,185,4,1,1,0,2,0,3,9,2216,9,832
"18032","반구1동","반구1동제3투","대통령선거","울산광역시","중구",3145,2094,618,757,382,155,155,2,1,3,1,1,3,1,2,2081,13,1051
"18033","반구1동","반구1동제4투","대통령선거","울산광역시","중구",2864,2067,773,553,346,159,217,1,0,0,0,1,3,1,4,2058,9,797
"18034","반구2동","관내사전투표","대통령선거","울산광역시","중구",1713,1713,668,459,267,145,152,3,1,1,0,0,1,2,1,1700,13,0
"18035","반구2동","반구2동제1투","대통령선거","울산광역시","중구",2077,1332,392,529,211,80,106,1,0,0,0,0,0,1,3,1323,9,745
"18036","반구2동","반구2동제2투","대통령선거","울산광역시","중구",2007,1438,430,504,247,125,119,2,1,0,1,0,0,1,0,1430,8,569
"18037","반구2동","반구2동제3투","대통령선거","울산광역시","중구",1945,1387,397,541,246,96,94,2,1,2,0,0,0,1,2,1382,5,558
"18038","복산1동","관내사전투표","대통령선거","울산광역시","중구",1622,1622,569,577,251,101,107,3,0,0,2,1,0,0,2,1613,9,0
"18039","복산1동","복산1동제1투","대통령선거","울산광역시","중구",2038,1431,438,507,264,95,114,1,0,2,0,2,2,0,1,1426,5,607
"18040","복산1동","복산1동제2투","대통령선거","울산광역시","중구",1876,1149,345,476,180,64,72,2,0,1,1,0,0,0,1,1142,7,727
"18041","복산1동","복산1동제3투","대통령선거","울산광역시","중구",1298,825,202,352,149,70,45,1,0,0,0,0,0,0,1,820,5,473
"18042","복산2동","관내사전투표","대통령선거","울산광역시","중구",1943,1943,847,456,295,167,155,3,0,2,0,3,0,0,3,1931,12,0
"18043","복산2동","복산2동제1투","대통령선거","울산광역시","중구",1825,1332,425,444,247,109,93,1,0,3,1,1,1,0,1,1326,6,493
"18044","복산2동","복산2동제2투","대통령선거","울산광역시","중구",2478,1798,632,506,323,162,153,1,2,4,0,0,1,0,2,1786,12,680
"18045","복산2동","복산2동제3투","대통령선거","울산광역시","중구",1820,1264,379,462,212,94,104,1,0,1,1,2,2,2,0,1260,4,556
"18046","성안동","관내사전투표","대통령선거","울산광역시","중구",3649,3649,1598,881,566,253,330,4,0,1,0,3,0,2,3,3641,8,0
"18047","성안동","성안동제1투","대통령선거","울산광역시","중구",2967,2110,762,593,378,176,183,3,1,0,0,1,0,3,2,2102,8,857
"18048","성안동","성안동제2투","대통령선거","울산광역시","중구",2772,1979,686,603,365,152,151,2,0,3,0,0,3,4,3,1972,7,793
"18049","성안동","성안동제3투","대통령선거","울산광역시","중구",3093,2253,839,639,359,200,187,6,1,0,2,5,0,0,2,2240,13,840
"18050","성안동","성안동제4투","대통령선거","울산광역시","중구",3079,2174,802,606,403,173,164,4,1,1,1,7,1,0,0,2163,11,905
"18051","중앙동","관내사전투표","대통령선거","울산광역시","중구",1907,1907,630,747,277,130,105,1,0,1,1,2,1,2,0,1897,10,0
"18052","중앙동","중앙동제1투","대통령선거","울산광역시","중구",3176,1860,456,811,334,153,91,2,1,1,1,0,1,1,2,1854,6,1316
"18053","중앙동","중앙동제2투","대통령선거","울산광역시","중구",2423,1619,356,762,268,106,94,3,0,5,2,2,0,1,1,1600,19,804
"18054","중앙동","중앙동제3투","대통령선거","울산광역시","중구",1979,1258,326,609,203,62,46,1,0,4,0,0,1,1,0,1253,5,721
"18055","중앙동","중앙동제4투","대통령선거","울산광역시","중구",1935,1292,312,601,221,79,58,2,0,2,1,2,0,0,2,1280,12,643
"18056","중앙동","중앙동제5투","대통령선거","울산광역시","중구",1477,963,262,437,144,63,46,2,1,0,0,0,0,0,0,955,8,514
"18057","우정동","관내사전투표","대통령선거","울산광역시","중구",2688,2688,1050,850,392,193,187,3,0,1,0,2,0,2,1,2681,7,0
"18058","우정동","우정동제1투","대통령선거","울산광역시","중구",2983,1962,545,787,374,137,99,5,0,3,0,1,0,2,1,1954,8,1021
"18059","우정동","우정동제2투","대통령선거","울산광역시","중구",2100,1281,308,602,197,90,71,1,0,2,0,0,0,1,1,1273,8,819
"18060","우정동","우정동제3투","대통령선거","울산광역시","중구",1802,1279,362,511,222,97,75,0,0,1,1,0,0,2,0,1271,8,523
"18061","우정동","우정동제4투","대통령선거","울산광역시","중구",3518,2855,1060,853,529,215,187,2,0,0,0,0,1,1,0,2848,7,663
"18062","우정동","우정동제5투","대통령선거","울산광역시","중구",3361,2793,997,889,472,208,202,1,0,0,0,3,1,1,1,2775,18,568
"18063","태화동","관내사전투표","대통령선거","울산광역시","중구",4623,4623,2060,1060,685,407,379,8,0,4,0,4,0,2,4,4613,10,0
"18064","태화동","태화동제1투","대통령선거","울산광역시","중구",2533,1805,631,620,303,119,119,1,0,0,0,2,0,0,4,1799,6,728
"18065","태화동","태화동제2투","대통령선거","울산광역시","중구",2647,1897,628,662,324,154,116,2,0,3,0,0,0,0,1,1890,7,750
"18066","태화동","태화동제3투","대통령선거","울산광역시","중구",3125,2377,715,892,428,183,138,2,0,2,0,2,2,0,1,2365,12,748
"18067","태화동","태화동제4투","대통령선거","울산광역시","중구",2528,2046,763,614,334,175,147,0,0,4,0,1,0,1,3,2042,4,482
"18068","태화동","태화동제5투","대통령선거","울산광역시","중구",2778,2143,629,775,389,174,150,7,0,4,1,2,0,3,1,2135,8,635
"18069","태화동","태화동제6투","대통령선거","울산광역시","중구",2632,2221,848,548,450,210,153,2,0,1,1,1,0,2,1,2217,4,411
"18070","태화동","태화동제7투","대통령선거","울산광역시","중구",2282,1930,944,319,361,172,130,1,0,0,0,0,0,0,0,1927,3,352
"18071","태화동","태화동제8투","대통령선거","울산광역시","중구",2093,1727,855,256,306,172,131,1,1,1,0,1,0,0,0,1724,3,366
"18072","다운동","관내사전투표","대통령선거","울산광역시","중구",3438,3438,1350,975,545,254,281,4,0,1,4,6,1,1,1,3423,15,0
"18073","다운동","다운동제1투","대통령선거","울산광역시","중구",3239,2278,668,841,436,195,124,1,0,1,0,1,1,1,0,2269,9,961
"18074","다운동","다운동제2투","대통령선거","울산광역시","중구",2768,1789,568,680,272,145,106,2,0,2,0,0,0,3,2,1780,9,979
"18075","다운동","다운동제3투","대통령선거","울산광역시","중구",2627,1899,613,688,289,141,151,2,0,1,0,0,2,1,4,1892,7,728
"18076","다운동","다운동제4투","대통령선거","울산광역시","중구",3087,2148,574,868,384,165,140,1,0,3,1,0,0,3,1,2140,8,939
"18077","다운동","다운동제5투","대통령선거","울산광역시","중구",3036,2142,627,786,388,165,163,1,0,3,1,0,0,1,1,2136,6,894
"18078","다운동","다운동제6투","대통령선거","울산광역시","중구",2973,2280,822,641,427,182,184,1,0,1,1,2,1,3,3,2268,12,693
"18079","병영1동","관내사전투표","대통령선거","울산광역시","중구",4246,4246,1721,1130,613,300,444,8,1,3,0,3,1,0,5,4229,17,0
"18080","병영1동","병영1동제1투","대통령선거","울산광역시","중구",2508,1552,451,645,246,94,96,1,0,2,1,1,2,1,1,1541,11,956
"18081","병영1동","병영1동제2투","대통령선거","울산광역시","중구",2303,1461,396,569,239,114,126,2,0,1,1,1,1,0,3,1453,8,842
"18082","병영1동","병영1동제3투","대통령선거","울산광역시","중구",2716,1901,593,753,258,124,144,6,1,1,2,0,2,3,5,1892,9,815
"18083","병영1동","병영1동제4투","대통령선거","울산광역시","중구",1999,1363,385,573,219,94,74,4,0,2,0,1,2,2,1,1357,6,636
"18084","병영1동","병영1동제5투","대통령선거","울산광역시","중구",2596,2093,885,467,380,152,198,5,0,0,3,0,0,0,0,2090,3,503
"18085","병영1동","병영1동제6투","대통령선거","울산광역시","중구",2873,2431,1079,453,440,236,218,0,0,0,0,1,0,0,0,2427,4,442
"18086","병영2동","관내사전투표","대통령선거","울산광역시","중구",2262,2262,1030,508,278,142,272,2,0,2,1,4,2,1,8,2250,12,0
"18087","병영2동","병영2동제1투","대통령선거","울산광역시","중구",2371,1662,524,569,283,131,133,2,0,2,0,3,0,1,1,1649,13,709
"18088","병영2동","병영2동제2투","대통령선거","울산광역시","중구",1461,954,294,306,189,66,81,2,1,1,1,0,0,0,2,943,11,507
"18089","병영2동","병영2동제3투","대통령선거","울산광역시","중구",1412,914,255,330,165,85,69,1,0,2,0,0,0,1,0,908,6,498
"18090","병영2동","병영2동제4투","대통령선거","울산광역시","중구",1789,1197,350,471,187,79,96,0,0,1,1,1,1,1,2,1190,7,592
"18091","병영2동","병영2동제5투","대통령선거","울산광역시","중구",2555,1944,723,520,340,140,198,2,0,3,1,3,1,0,1,1932,12,611
"18092","병영2동","병영2동제6투","대통령선거","울산광역시","중구",3698,2927,1321,534,527,258,271,1,0,0,1,5,1,0,1,2920,7,771
"18093","약사동","관내사전투표","대통령선거","울산광역시","중구",2779,2779,1313,549,422,231,237,2,1,2,2,0,0,3,5,2767,12,0
"18094","약사동","약사동제1투","대통령선거","울산광역시","중구",2483,2024,855,442,349,190,173,4,0,1,2,2,1,1,2,2022,2,459
"18095","약사동","약사동제2투","대통령선거","울산광역시","중구",2490,1880,723,423,347,184,185,2,0,1,0,3,0,3,1,1872,8,610
"18096","잘못 투입·구분된 투표지","잘못 투입·구분된 투표지","대통령선거","울산광역시","중구",0,1,0,1,0,0,0,0,0,0,0,0,0,0,0,1,0,-1
"18097","거소·선상투표","거소·선상투표","대통령선거","울산광역시","남구",592,557,196,103,175,17,34,3,1,5,1,0,0,1,6,542,15,35
"18098","관외사전투표","관외사전투표","대통령선거","울산광역시","남구",22543,22528,9336,4223,4078,2549,2022,26,12,8,9,18,6,11,54,22352,176,15
"18099","재외투표","재외투표","대통령선거","울산광역시","남구",1392,1090,635,80,156,57,155,1,0,0,0,1,0,0,0,1085,5,302
"18100","신정1동","관내사전투표","대통령선거","울산광역시","남구",3235,3235,1116,1251,441,207,192,2,0,2,1,4,0,4,3,3223,12,0
"18101","신정1동","신정1동제1투","대통령선거","울산광역시","남구",3407,2018,519,931,345,118,91,1,0,3,0,1,1,0,1,2011,7,1389
"18102","신정1동","신정1동제2투","대통령선거","울산광역시","남구",3109,2020,500,904,345,140,111,4,0,3,1,1,1,0,1,2011,9,1089
"18103","신정1동","신정1동제3투","대통령선거","울산광역시","남구",3004,2268,674,896,377,172,129,5,0,2,0,1,0,2,0,2258,10,736
"18104","신정1동","신정1동제4투","대통령선거","울산광역시","남구",3300,2431,683,1053,394,145,140,4,0,2,0,0,0,2,0,2423,8,869
"18105","신정2동","관내사전투표","대통령선거","울산광역시","남구",3099,3099,1212,858,483,290,229,8,0,0,2,2,0,0,3,3087,12,0
"18106","신정2동","신정2동제1투","대통령선거","울산광역시","남구",2776,1719,482,691,297,134,103,2,0,2,0,0,0,0,2,1713,6,1057
"18107","신정2동","신정2동제2투","대통령선거","울산광역시","남구",3248,2566,964,705,512,204,164,2,0,1,1,0,0,1,2,2556,10,682
"18108","신정2동","신정2동제3투","대통령선거","울산광역시","남구",3637,2811,937,924,560,211,158,3,0,1,0,0,0,2,2,2798,13,826
"18109","신정2동","신정2동제4투","대통령선거","울산광역시","남구",3327,2617,793,908,535,216,150,2,0,0,2,0,0,1,1,2608,9,710
"18110","신정2동","신정2동제5투","대통령선거","울산광역시","남구",2099,1773,571,593,369,157,74,3,0,0,0,2,0,2,1,1772,1,326
"18111","신정3동","관내사전투표","대통령선거","울산광역시","남구",2951,2951,1189,912,429,201,200,0,0,3,2,2,2,1,2,2943,8,0
"18112","신정3동","신정3동제1투","대통령선거","울산광역시","남구",3133,1823,475,762,328,124,121,1,0,2,0,1,0,2,0,1816,7,1310
"18113","신정3동","신정3동제2투","대통령선거","울산광역시","남구",3748,2999,1157,752,587,282,208,5,0,0,1,0,1,0,1,2994,5,749
"18114","신정3동","신정3동제3투","대통령선거","울산광역시","남구",3582,2150,564,955,332,136,136,4,0,4,1,1,0,2,3,2138,12,1432
"18115","신정4동","관내사전투표","대통령선거","울산광역시","남구",3734,3734,1582,1008,590,286,239,6,2,0,4,3,0,0,2,3722,12,0
"18116","신정4동","신정4동제1투","대통령선거","울산광역시","남구",3702,3011,1209,751,558,262,216,1,0,3,0,1,0,1,0,3002,9,691
"18117","신정4동","신정4동제2투","대통령선거","울산광역시","남구",2436,1728,512,672,280,147,98,3,0,0,1,4,0,1,1,1719,9,708
"18118","신정4동","신정4동제3투","대통령선거","울산광역시","남구",2140,1592,513,556,302,103,101,1,0,2,1,2,1,1,2,1585,7,548
"18119","신정4동","신정4동제4투","대통령선거","울산광역시","남구",1543,1012,289,417,176,61,57,5,1,0,0,0,0,0,1,1007,5,531
"18120","신정4동","신정4동제5투","대통령선거","울산광역시","남구",1737,1091,394,341,181,83,82,1,0,2,0,0,0,0,2,1086,5,646
"18121","신정4동","신정4동제6투","대통령선거","울산광역시","남구",2552,2051,840,446,388,222,145,0,1,1,0,1,0,1,1,2046,5,501
"18122","신정5동","관내사전투표","대통령선거","울산광역시","남구",1908,1908,698,631,275,138,148,1,1,2,0,2,1,1,2,1900,8,0
"18123","신정5동","신정5동제1투","대통령선거","울산광역시","남구",2934,1932,514,767,349,154,139,0,0,1,0,1,0,0,0,1925,7,1002
"18124","신정5동","신정5동제2투","대통령선거","울산광역시","남구",2678,1702,532,649,291,103,115,2,0,2,1,2,0,0,1,1698,4,976
"18125","달동","관내사전투표","대통령선거","울산광역시","남구",3456,3456,1466,838,535,280,294,5,0,2,0,6,1,0,5,3432,24,0
"18126","달동","달동제1투","대통령선거","울산광역시","남구",4086,2478,829,795,451,198,182,8,0,0,1,2,1,1,0,2468,10,1608
"18127","달동","달동제2투","대통령선거","울산광역시","남구",2963,1839,536,713,317,149,108,3,0,1,0,2,0,1,0,1830,9,1124
"18128","달동","달동제3투","대통령선거","울산광역시","남구",2348,1757,594,549,332,137,130,6,0,0,0,1,0,0,1,1750,7,591
"18129","달동","달동제4투","대통령선거","울산광역시","남구",2656,1703,448,731,315,104,85,0,0,1,1,2,0,0,3,1690,13,953
"18130","달동","달동제5투","대통령선거","울산광역시","남구",3259,2334,848,574,492,211,187,0,0,1,0,2,1,0,3,2319,15,925
"18131","달동","달동제6투","대통령선거","울산광역시","남구",3423,2695,971,764,476,253,214,2,0,2,1,2,0,3,1,2689,6,728
"18132","삼산동","관내사전투표","대통령선거","울산광역시","남구",7492,7492,3422,1583,1138,618,669,10,0,1,3,4,0,4,8,7460,32,0
"18133","삼산동","삼산동제1투","대통령선거","울산광역시","남구",3556,2463,846,738,442,230,187,1,0,3,1,1,1,1,3,2454,9,1093
"18134","삼산동","삼산동제2투","대통령선거","울산광역시","남구",3305,2324,828,691,445,174,174,2,0,1,1,0,0,1,2,2319,5,981
"18135","삼산동","삼산동제3투","대통령선거","울산광역시","남구",2999,2054,680,714,361,163,125,2,0,1,1,1,0,0,1,2049,5,945
"18136","삼산동","삼산동제4투","대통령선거","울산광역시","남구",3684,1710,566,523,322,137,144,1,0,0,2,0,0,2,5,1702,8,1974
"18137","삼산동","삼산동제5투","대통령선거","울산광역시","남구",3291,2294,910,536,449,189,194,3,0,2,1,1,1,0,0,2286,8,997
"18138","삼산동","삼산동제6투","대통령선거","울산광역시","남구",3770,2890,1192,636,510,263,274,1,0,2,0,0,2,0,4,2884,6,880
"18139","삼산동","삼산동제7투","대통령선거","울산광역시","남구",3659,2829,1287,551,467,235,275,1,0,1,0,5,0,0,1,2823,6,830
"18140","삼산동","삼산동제8투","대통령선거","울산광역시","남구",3177,2144,724,658,442,177,127,5,0,5,0,2,0,1,0,2141,3,1033
"18141","삼산동","삼산동제9투","대통령선거","울산광역시","남구",3807,2547,946,672,496,216,205,1,0,2,0,2,0,0,3,2543,4,1260
"18142","삼호동","관내사전투표","대통령선거","울산광역시","남구",3356,3356,1398,825,552,275,273,7,0,2,0,2,0,1,7,3342,14,0
"18143","삼호동","삼호동제1투","대통령선거","울산광역시","남구",3453,2523,840,816,457,228,162,2,0,1,0,3,2,1,3,2515,8,930
"18144","삼호동","삼호동제2투","대통령선거","울산광역시","남구",3080,2029,640,731,377,128,136,3,0,0,0,1,0,1,3,2020,9,1051
"18145","삼호동","삼호동제3투","대통령선거","울산광역시","남구",2559,1635,454,633,311,108,113,0,0,1,0,0,0,3,5,1628,7,924
"18146","삼호동","삼호동제4투","대통령선거","울산광역시","남구",3194,2179,676,783,390,162,143,5,1,4,0,3,0,1,2,2170,9,1015
"18147","삼호동","삼호동제5투","대통령선거","울산광역시","남구",2983,2260,892,523,424,206,193,5,0,1,1,1,1,1,2,2250,10,723
"18148","무거동","관내사전투표","대통령선거","울산광역시","남구",4933,4933,2263,938,778,459,450,1,0,2,3,3,0,4,4,4905,28,0
"18149","무거동","무거동제1투","대통령선거","울산광역시","남구",3077,2207,766,693,382,183,166,3,0,1,1,1,0,1,3,2200,7,870
"18150","무거동","무거동제2투","대통령선거","울산광역시","남구",2093,1583,545,511,255,158,97,3,2,2,1,1,0,0,3,1578,5,510
"18151","무거동","무거동제3투","대통령선거","울산광역시","남구",3211,2548,948,666,480,247,174,5,1,6,4,1,1,0,4,2537,11,663
"18152","무거동","무거동제4투","대통령선거","울산광역시","남구",2829,2188,893,460,427,211,180,4,0,0,1,1,0,1,4,2182,6,641
"18153","무거동","무거동제5투","대통령선거","울산광역시","남구",3208,2385,728,843,434,225,137,1,1,0,0,2,1,2,3,2377,8,823
"18154","무거동","무거동제6투","대통령선거","울산광역시","남구",3173,2518,1041,528,468,244,213,5,0,0,0,5,1,2,3,2510,8,655
"18155","무거동","무거동제7투","대통령선거","울산광역시","남구",3108,2539,990,638,476,254,164,3,0,0,0,2,0,2,2,2531,8,569
"18156","옥동","관내사전투표","대통령선거","울산광역시","남구",4639,4639,2076,990,782,420,329,5,0,3,2,7,0,3,3,4620,19,0
"18157","옥동","옥동제1투","대통령선거","울산광역시","남구",2143,1532,453,576,272,119,101,1,0,2,1,0,0,1,1,1527,5,611
"18158","옥동","옥동제2투","대통령선거","울산광역시","남구",2849,2343,865,710,437,170,154,1,0,0,1,0,0,0,0,2338,5,506
"18159","옥동","옥동제3투","대통령선거","울산광역시","남구",2424,2024,774,565,383,174,119,2,0,0,1,1,0,1,3,2023,1,400
"18160","옥동","옥동제4투","대통령선거","울산광역시","남구",2304,1684,567,485,353,144,115,3,0,2,1,3,0,0,1,1674,10,620
"18161","옥동","옥동제5투","대통령선거","울산광역시","남구",2599,2060,714,670,403,153,112,1,0,0,0,2,0,0,0,2055,5,539
"18162","옥동","옥동제6투","대통령선거","울산광역시","남구",2275,1953,693,544,414,205,90,0,0,2,0,0,0,3,1,1952,1,322
"18163","야음장생포동","관내사전투표","대통령선거","울산광역시","남구",2011,2011,755,686,300,125,121,1,0,2,1,4,0,1,0,1996,15,0
"18164","야음장생포동","야음장생포동제1투","대통령선거","울산광역시","남구",2799,1665,395,750,291,109,99,5,0,1,1,3,3,3,0,1660,5,1134
"18165","야음장생포동","야음장생포동제2투","대통령선거","울산광역시","남구",2001,1257,332,544,212,86,73,0,0,1,1,1,0,0,2,1252,5,744
"18166","야음장생포동","야음장생포동제3투","대통령선거","울산광역시","남구",2431,1587,415,695,280,81,97,6,0,2,0,1,0,0,1,1578,9,844
"18167","야음장생포동","야음장생포동제4투","대통령선거","울산광역시","남구",1057,743,139,398,113,47,42,0,0,0,0,0,0,1,1,741,2,314
"18168","대현동","관내사전투표","대통령선거","울산광역시","남구",4335,4335,1892,984,692,384,344,7,0,3,1,3,0,1,4,4315,20,0
"18169","대현동","대현동제1투","대통령선거","울산광역시","남구",2945,2043,675,690,371,154,137,1,0,1,2,0,0,1,3,2035,8,902
"18170","대현동","대현동제2투","대통령선거","울산광역시","남구",3029,2503,911,696,484,230,164,2,0,0,0,0,0,2,3,2492,11,526
"18171","대현동","대현동제3투","대통령선거","울산광역시","남구",3135,2328,813,707,448,183,161,1,1,0,2,2,0,0,1,2319,9,807
"18172","대현동","대현동제4투","대통령선거","울산광역시","남구",2751,2092,776,587,405,173,139,5,0,1,0,0,0,2,0,2088,4,659
"18173","대현동","대현동제5투","대통령선거","울산광역시","남구",3335,2482,874,758,424,217,187,2,0,2,0,1,0,1,4,2470,12,853
"18174","대현동","대현동제6투","대통령선거","울산광역시","남구",1039,647,166,299,93,43,37,3,0,2,0,0,1,1,1,646,1,392
"18175","수암동","관내사전투표","대통령선거","울산광역시","남구",3626,3626,1582,842,549,323,306,0,0,2,0,1,1,3,6,3615,11,0
"18176","수암동","수암동제1투","대통령선거","울산광역시","남구",1398,1100,386,262,244,107,96,1,0,0,0,0,0,0,0,1096,4,298
"18177","수암동","수암동제2투","대통령선거","울산광역시","남구",2306,1637,541,554,272,127,129,1,0,0,0,1,1,0,4,1630,7,669
"18178","수암동","수암동제3투","대통령선거","울산광역시","남구",2936,2408,922,647,477,197,152,2,2,0,0,1,0,0,1,2401,7,528
"18179","수암동","수암동제4투","대통령선거","울산광역시","남구",2295,1826,653,500,350,170,142,1,0,0,0,0,2,2,0,1820,6,469
"18180","선암동","관내사전투표","대통령선거","울산광역시","남구",1176,1176,519,284,184,65,111,3,1,2,0,0,1,0,2,1172,4,0
"18181","선암동","선암동제1투","대통령선거","울산광역시","남구",2665,1724,540,612,313,119,121,1,1,0,0,1,0,2,5,1715,9,941
"18182","선암동","선암동제2투","대통령선거","울산광역시","남구",3613,2733,992,726,555,221,213,6,0,1,1,3,1,3,4,2726,7,880
"18183","선암동","선암동제3투","대통령선거","울산광역시","남구",1969,1546,465,524,291,117,137,1,1,2,0,0,0,1,3,1542,4,423
"18184","선암동","선암동제4투","대통령선거","울산광역시","남구",2048,1557,524,453,314,132,118,3,0,1,0,2,0,1,1,1549,8,491
"18185","잘못 투입·구분된 투표지","잘못 투입·구분된 투표지","대통령선거","울산광역시","남구",0,0,0,0,0,0,0,0,0,0,0,0,0,0,0,0,0,0
"18186","거소·선상투표","거소·선상투표","대통령선거","울산광역시","동구",264,260,87,41,68,22,12,0,1,2,2,1,0,1,3,240,20,4
"18187","관외사전투표","관외사전투표","대통령선거","울산광역시","동구",10594,10594,4701,1579,1896,1055,1170,10,3,7,4,12,5,8,29,10479,115,0
"18188","재외투표","재외투표","대통령선거","울산광역시","동구",422,326,202,21,43,16,40,0,0,0,0,1,0,0,0,323,3,96
"18189","방어동","관내사전투표","대통령선거","울산광역시","동구",5147,5146,2344,1045,783,356,568,4,0,2,2,13,3,2,8,5130,16,1
"18190","방어동","방어동제1투","대통령선거","울산광역시","동구",3301,1954,604,620,379,151,181,1,2,4,0,1,0,1,4,1948,6,1347
"18191","방어동","방어동제2투","대통령선거","울산광역시","동구",2463,1608,469,587,264,132,126,0,0,8,0,1,3,2,4,1596,12,855
"18192","방어동","방어동제3투","대통령선거","울산광역시","동구",2500,1610,556,471,277,109,177,1,1,0,0,5,0,1,0,1598,12,890
"18193","방어동","방어동제4투","대통령선거","울산광역시","동구",2192,1539,559,437,251,105,165,0,0,2,3,0,2,1,3,1528,11,653
"18194","방어동","방어동제5투","대통령선거","울산광역시","동구",3183,2157,769,581,440,139,207,2,0,4,1,0,1,0,6,2150,7,1026
"18195","방어동","방어동제6투","대통령선거","울산광역시","동구",3379,2340,955,450,471,169,277,1,0,2,0,6,1,1,0,2333,7,1039
"18196","방어동","방어동제7투","대통령선거","울산광역시","동구",2978,2042,782,467,386,161,226,2,0,1,2,2,0,2,3,2034,8,936
"18197","방어동","방어동제8투","대통령선거","울산광역시","동구",2727,1684,627,384,331,150,173,4,0,1,0,1,1,2,3,1677,7,1043
"18198","방어동","방어동제9투","대통령선거","울산광역시","동구",2789,2067,891,445,367,147,196,1,0,1,0,3,1,1,2,2055,12,722
"18199","일산동","관내사전투표","대통령선거","울산광역시","동구",1245,1245,493,339,185,84,115,0,0,3,0,5,2,0,2,1228,17,0
"18200","일산동","일산동제1투","대통령선거","울산광역시","동구",2243,1412,447,473,256,91,127,0,0,1,0,2,1,5,2,1405,7,831
"18201","일산동","일산동제2투","대통령선거","울산광역시","동구",2198,1341,447,386,272,94,128,2,0,4,0,0,0,0,3,1336,5,857
"18202","화정동","관내사전투표","대통령선거","울산광역시","동구",3135,3135,1424,662,491,206,333,0,0,5,0,3,0,2,4,3130,5,0
"18203","화정동","화정동제1투","대통령선거","울산광역시","동구",3625,2902,1383,372,523,267,341,1,0,1,0,0,2,0,4,2894,8,723
"18204","화정동","화정동제2투","대통령선거","울산광역시","동구",2910,1748,503,615,351,104,152,3,0,1,0,2,0,1,6,1738,10,1162
"18205","화정동","화정동제3투","대통령선거","울산광역시","동구",2621,1769,718,382,344,114,191,1,0,0,0,1,1,0,1,1753,16,852
"18206","화정동","화정동제4투","대통령선거","울산광역시","동구",1975,1329,398,444,275,92,100,1,0,4,0,2,1,1,2,1320,9,646
"18207","화정동","화정동제5투","대통령선거","울산광역시","동구",2253,1437,557,354,264,79,167,0,0,1,0,2,1,0,3,1428,9,816
"18208","대송동","관내사전투표","대통령선거","울산광역시","동구",2212,2212,1037,388,339,164,264,1,0,1,1,2,0,1,2,2200,12,0
"18209","대송동","대송동제1투","대통령선거","울산광역시","동구",1955,1386,537,297,251,114,170,4,0,2,2,0,2,0,1,1380,6,569
"18210","대송동","대송동제2투","대통령선거","울산광역시","동구",2982,2213,878,454,429,171,258,4,1,2,3,1,0,1,4,2206,7,769
"18211","대송동","대송동제3투","대통령선거","울산광역시","동구",3149,2049,759,541,378,165,184,1,0,3,0,2,1,1,1,2036,13,1100
"18212","전하1동","관내사전투표","대통령선거","울산광역시","동구",3380,3380,1558,656,520,270,348,2,0,2,1,5,1,0,4,3367,13,0
"18213","전하1동","전하1동제1투","대통령선거","울산광역시","동구",1419,862,318,240,151,65,84,0,0,0,0,2,1,0,0,861,1,557
"18214","전하1동","전하1동제2투","대통령선거","울산광역시","동구",3011,2140,800,553,405,154,198,0,0,3,3,2,1,1,6,2126,14,871
"18215","전하1동","전하1동제3투","대통령선거","울산광역시","동구",2492,1815,707,427,354,106,198,0,0,6,3,1,0,0,4,1806,9,677
"18216","전하1동","전하1동제4투","대통령선거","울산광역시","동구",2169,1791,747,373,317,146,200,1,0,3,0,0,0,0,0,1787,4,378
"18217","전하2동","관내사전투표","대통령선거","울산광역시","동구",4227,4227,1995,786,644,298,467,4,0,2,2,5,0,0,4,4207,20,0
"18218","전하2동","전하2동제1투","대통령선거","울산광역시","동구",2182,1467,505,471,250,93,128,2,1,0,0,3,0,1,3,1457,10,715
"18219","전하2동","전하2동제2투","대통령선거","울산광역시","동구",2122,1364,467,392,248,110,133,4,0,2,0,1,0,1,1,1359,5,758
"18220","전하2동","전하2동제3투","대통령선거","울산광역시","동구",1716,1184,420,344,210,81,113,1,0,2,0,4,0,0,3,1178,6,532
"18221","전하2동","전하2동제4투","대통령선거","울산광역시","동구",2506,2045,853,362,441,149,223,3,1,0,0,1,0,0,3,2036,9,461
"18222","전하2동","전하2동제5투","대통령선거","울산광역시","동구",1606,1314,609,196,238,108,155,0,0,0,1,0,0,0,2,1309,5,292
"18223","전하2동","전하2동제6투","대통령선거","울산광역시","동구",2483,2082,976,304,356,171,263,3,0,0,0,1,0,0,2,2076,6,401
"18224","남목1동","관내사전투표","대통령선거","울산광역시","동구",1853,1853,860,359,276,148,188,1,0,0,1,7,0,0,0,1840,13,0
"18225","남목1동","남목1동제1투","대통령선거","울산광역시","동구",1711,1156,401,315,235,79,107,0,0,3,0,4,1,0,1,1146,10,555
"18226","남목1동","남목1동제2투","대통령선거","울산광역시","동구",2049,1480,480,489,264,93,137,0,0,1,0,4,0,1,1,1470,10,569
"18227","남목1동","남목1동제3투","대통령선거","울산광역시","동구",2237,1703,725,373,291,133,166,2,0,0,0,5,0,0,1,1696,7,534
"18228","남목2동","관내사전투표","대통령선거","울산광역시","동구",2983,2983,1411,563,453,225,307,1,2,2,0,3,0,3,3,2973,10,0
"18229","남목2동","남목2동제1투","대통령선거","울산광역시","동구",2222,1538,589,366,292,129,154,1,0,0,1,1,0,0,2,1535,3,684
"18230","남목2동","남목2동제2투","대통령선거","울산광역시","동구",1612,1189,481,261,220,88,131,0,0,0,2,3,0,2,0,1188,1,423
"18231","남목2동","남목2동제3투","대통령선거","울산광역시","동구",4085,3116,1284,576,620,238,367,1,2,7,0,2,0,2,3,3102,14,969
"18232","남목2동","남목2동제4투","대통령선거","울산광역시","동구",2712,2101,956,345,346,178,257,3,1,1,0,1,2,0,3,2093,8,611
"18233","남목2동","남목2동제5투","대통령선거","울산광역시","동구",3020,2600,1174,412,516,224,254,0,0,1,0,0,1,0,3,2585,15,420
"18234","남목3동","관내사전투표","대통령선거","울산광역시","동구",2211,2211,1114,334,329,137,276,1,1,4,0,6,0,0,2,2204,7,0
"18235","남목3동","남목3동제1투","대통령선거","울산광역시","동구",2406,1798,732,335,346,148,223,0,1,0,2,3,0,0,1,1791,7,608
"18236","남목3동","남목3동제2투","대통령선거","울산광역시","동구",2425,1738,662,449,289,126,193,2,0,1,2,3,0,1,4,1732,6,687
"18237","남목3동","남목3동제3투","대통령선거","울산광역시","동구",2464,1933,871,342,302,156,243,2,0,2,1,4,1,1,4,1929,4,531
"18238","남목3동","남목3동제4투","대통령선거","울산광역시","동구",634,479,109,243,63,27,29,0,0,1,0,0,0,1,0,473,6,155
"18239","잘못 투입·구분된 투표지","잘못 투입·구분된 투표지","대통령선거","울산광역시","동구",0,0,0,0,0,0,0,0,0,0,0,0,0,0,0,0,0,0
"18240","거소·선상투표","거소·선상투표","대통령선거","울산광역시","북구",331,314,106,55,88,26,21,1,1,1,2,0,0,0,5,306,8,17
"18241","관외사전투표","관외사전투표","대통령선거","울산광역시","북구",13135,13134,5685,2165,2323,1283,1453,23,5,4,5,17,7,9,26,13005,129,1
"18242","재외투표","재외투표","대통령선거","울산광역시","북구",583,426,234,25,82,26,55,1,0,0,0,1,0,0,1,425,1,157
"18243","농소1동","관내사전투표","대통령선거","울산광역시","북구",2702,2702,1101,709,372,204,283,6,0,4,0,3,1,1,5,2689,13,0
"18244","농소1동","농소1동제1투","대통령선거","울산광역시","북구",2713,1803,536,697,291,117,140,3,0,5,0,1,2,1,1,1794,9,910
"18245","농소1동","농소1동제2투","대통령선거","울산광역시","북구",4014,2423,731,859,441,167,196,3,1,1,0,2,1,1,5,2408,15,1591
"18246","농소1동","농소1동제3투","대통령선거","울산광역시","북구",3434,2724,1083,658,500,213,246,1,0,0,2,4,0,2,3,2712,12,710
"18247","농소1동","농소1동제4투","대통령선거","울산광역시","북구",1403,970,323,316,166,79,76,2,0,3,0,0,0,0,2,967,3,433
"18248","농소1동","농소1동제5투","대통령선거","울산광역시","북구",1300,956,349,265,180,60,87,1,0,1,0,2,1,0,2,948,8,344
"18249","농소1동","농소1동제6투","대통령선거","울산광역시","북구",2943,2389,995,495,440,201,242,3,1,1,0,1,0,0,2,2381,8,554
"18250","농소1동","농소1동제7투","대통령선거","울산광역시","북구",1922,1606,716,297,308,122,155,0,0,1,1,0,0,0,3,1603,3,316
"18251","농소2동","관내사전투표","대통령선거","울산광역시","북구",7112,7112,3476,1142,1029,590,819,6,2,7,0,4,2,1,13,7091,21,0
"18252","농소2동","농소2동제1투","대통령선거","울산광역시","북구",3667,2691,1206,479,487,232,272,0,0,0,1,1,0,1,0,2679,12,976
"18253","농소2동","농소2동제2투","대통령선거","울산광역시","북구",1655,1112,351,395,148,102,104,2,0,3,0,1,0,1,2,1109,3,543
"18254","농소2동","농소2동제3투","대통령선거","울산광역시","북구",3506,2457,878,693,420,205,242,1,0,3,0,0,1,2,3,2448,9,1049
"18255","농소2동","농소2동제4투","대통령선거","울산광역시","북구",2339,1610,509,543,288,126,121,1,0,1,2,2,1,1,2,1597,13,729
"18256","농소2동","농소2동제5투","대통령선거","울산광역시","북구",2237,1582,577,375,323,152,138,1,0,6,0,0,0,1,3,1576,6,655
"18257","농소2동","농소2동제6투","대통령선거","울산광역시","북구",2698,2041,762,504,374,167,215,1,0,1,1,2,1,2,5,2035,6,657
"18258","농소2동","농소2동제7투","대통령선거","울산광역시","북구",3150,2566,1147,482,460,196,270,0,0,0,0,0,0,0,2,2557,9,584
"18259","농소3동","관내사전투표","대통령선거","울산광역시","북구",5858,5858,3017,858,773,483,682,6,0,1,1,11,2,2,5,5841,17,0
"18260","농소3동","농소3동제1투","대통령선거","울산광역시","북구",2781,2001,798,572,328,144,139,5,1,1,0,1,1,1,4,1995,6,780
"18261","농소3동","농소3동제2투","대통령선거","울산광역시","북구",3694,2737,1110,612,487,235,274,1,1,1,0,2,1,0,5,2729,8,957
"18262","농소3동","농소3동제3투","대통령선거","울산광역시","북구",2449,1874,804,382,302,184,181,0,0,4,1,4,1,0,3,1866,8,575
"18263","농소3동","농소3동제4투","대통령선거","울산광역시","북구",2720,1930,733,512,344,165,159,4,0,0,1,3,0,0,4,1925,5,790
"18264","농소3동","농소3동제5투","대통령선거","울산광역시","북구",1781,1195,531,273,190,75,112,1,0,3,1,1,0,0,0,1187,8,586
"18265","농소3동","농소3동제6투","대통령선거","울산광역시","북구",2873,2313,1114,357,430,201,200,0,1,0,0,3,1,0,2,2309,4,560
"18266","농소3동","농소3동제7투","대통령선거","울산광역시","북구",3079,2474,1157,492,412,214,183,5,1,0,0,3,0,1,3,2471,3,605
"18267","농소3동","농소3동제8투","대통령선거","울산광역시","북구",1849,1508,698,234,275,142,150,2,0,0,0,0,1,0,1,1503,5,341
"18268","강동동","관내사전투표","대통령선거","울산광역시","북구",1907,1907,901,339,256,148,246,1,0,3,0,4,2,0,1,1901,6,0
"18269","강동동","강동동제1투","대통령선거","울산광역시","북구",1788,1145,437,307,191,89,109,1,0,2,0,1,2,0,3,1142,3,643
"18270","강동동","강동동제2투","대통령선거","울산광역시","북구",1363,879,205,466,107,46,37,1,0,0,0,1,2,3,5,873,6,484
"18271","강동동","강동동제3투","대통령선거","울산광역시","북구",621,448,96,241,61,20,18,5,0,0,0,0,1,0,0,442,6,173
"18272","강동동","강동동제4투","대통령선거","울산광역시","북구",442,306,67,178,36,12,9,0,0,1,0,0,1,0,0,304,2,136
"18273","강동동","강동동제5투","대통령선거","울산광역시","북구",2899,2226,1024,343,391,187,262,4,0,1,0,0,0,2,1,2215,11,673
"18274","효문동","관내사전투표","대통령선거","울산광역시","북구",3327,3327,1709,451,452,249,434,3,0,5,0,4,2,2,4,3315,12,0
"18275","효문동","효문동제1투","대통령선거","울산광역시","북구",2192,1419,430,505,234,97,134,5,0,0,0,1,2,2,0,1410,9,773
"18276","효문동","효문동제2투","대통령선거","울산광역시","북구",631,400,93,198,52,23,29,0,1,0,0,0,0,3,0,399,1,231
"18277","효문동","효문동제3투","대통령선거","울산광역시","북구",2141,1787,729,417,297,137,190,0,0,2,2,5,0,1,1,1781,6,354
"18278","효문동","효문동제4투","대통령선거","울산광역시","북구",3403,2541,946,706,456,174,235,2,0,1,1,4,3,2,3,2533,8,862
"18279","효문동","효문동제5투","대통령선거","울산광역시","북구",3054,1984,787,471,328,167,222,0,0,1,0,1,2,0,0,1979,5,1070
"18280","효문동","효문동제6투","대통령선거","울산광역시","북구",2483,1971,869,358,330,173,226,6,0,0,0,1,0,1,1,1965,6,512
"18281","효문동","효문동제7투","대통령선거","울산광역시","북구",2848,2081,774,533,381,163,217,1,0,1,0,1,0,1,0,2072,9,767
"18282","송정동","관내사전투표","대통령선거","울산광역시","북구",5776,5776,2884,895,719,460,754,7,1,3,3,10,0,4,7,5747,29,0
"18283","송정동","송정동제1투","대통령선거","울산광역시","북구",2186,1702,621,491,260,139,167,1,0,4,3,5,0,1,1,1693,9,484
"18284","송정동","송정동제2투","대통령선거","울산광역시","북구",1861,1494,683,283,244,107,169,0,0,0,1,0,0,0,3,1490,4,367
"18285","송정동","송정동제3투","대통령선거","울산광역시","북구",2170,1595,586,426,280,147,142,3,0,0,0,1,2,1,1,1589,6,575
"18286","송정동","송정동제4투","대통령선거","울산광역시","북구",2452,1808,718,421,298,142,204,7,0,0,1,5,0,3,4,1803,5,644
"18287","송정동","송정동제5투","대통령선거","울산광역시","북구",1985,1387,475,451,249,91,101,4,1,1,0,4,0,0,4,1381,6,598
"18288","양정동","관내사전투표","대통령선거","울산광역시","북구",2351,2351,1245,276,306,169,332,2,1,2,0,5,0,1,2,2341,10,0
"18289","양정동","양정동제1투","대통령선거","울산광역시","북구",2490,2027,892,335,327,189,275,0,0,0,0,3,1,0,2,2024,3,463
"18290","양정동","양정동제2투","대통령선거","울산광역시","북구",1773,1191,472,277,196,98,136,1,0,2,1,3,0,0,2,1188,3,582
"18291","양정동","양정동제3투","대통령선거","울산광역시","북구",2362,1665,707,350,269,128,194,1,1,1,0,1,2,0,0,1654,11,697
"18292","염포동","관내사전투표","대통령선거","울산광역시","북구",2265,2265,1103,341,306,176,321,1,0,0,0,4,0,2,2,2256,9,0
"18293","염포동","염포동제1투","대통령선거","울산광역시","북구",1059,746,303,182,110,58,78,2,1,1,0,1,1,0,2,739,7,313
"18294","염포동","염포동제2투","대통령선거","울산광역시","북구",1272,849,292,254,156,55,85,1,0,0,0,1,1,1,1,847,2,423
"18295","염포동","염포동제3투","대통령선거","울산광역시","북구",2691,2143,954,358,359,174,282,7,0,1,0,1,0,1,0,2137,6,548
"18296","염포동","염포동제4투","대통령선거","울산광역시","북구",1733,1005,329,297,203,75,93,0,0,1,1,1,0,0,2,1002,3,728
"18297","잘못 투입·구분된 투표지","잘못 투입·구분된 투표지","대통령선거","울산광역시","북구",0,0,0,0,0,0,0,0,0,0,0,0,0,0,0,0,0,0
"18298","거소·선상투표","거소·선상투표","대통령선거","울산광역시","울주군",420,399,133,83,121,35,7,2,0,0,0,0,1,1,0,383,16,21
"18299","관외사전투표","관외사전투표","대통령선거","울산광역시","울주군",17021,17013,6874,3701,2965,1689,1502,21,6,11,8,10,5,5,43,16840,173,8
"18300","재외투표","재외투표","대통령선거","울산광역시","울주군",1021,692,383,53,140,37,75,1,0,0,0,0,0,1,0,690,2,329
"18301","온산읍","관내사전투표","대통령선거","울산광역시","울주군",2935,2935,1240,732,422,241,268,5,3,4,0,3,0,0,7,2925,10,0
"18302","온산읍","온산읍제1투","대통령선거","울산광역시","울주군",2502,1246,307,547,220,87,75,1,2,1,0,0,1,2,2,1245,1,1256
"18303","온산읍","온산읍제2투","대통령선거","울산광역시","울주군",2255,1566,591,387,293,135,147,1,1,2,0,2,0,1,1,1561,5,689
"18304","온산읍","온산읍제3투","대통령선거","울산광역시","울주군",2270,1296,379,484,246,94,83,1,0,0,0,0,0,2,1,1290,6,974
"18305","온산읍","온산읍제4투","대통령선거","울산광역시","울주군",2621,1525,500,470,324,121,90,0,0,1,0,3,0,1,1,1511,14,1096
"18306","온산읍","온산읍제5투","대통령선거","울산광역시","울주군",1988,1221,440,358,213,108,91,3,0,2,0,0,0,0,3,1218,3,767
"18307","온산읍","온산읍제6투","대통령선거","울산광역시","울주군",2763,1969,682,530,361,203,176,3,0,0,0,0,1,2,0,1958,11,794
"18308","온산읍","온산읍제7투","대통령선거","울산광역시","울주군",786,509,80,318,56,33,14,0,0,1,1,0,0,3,1,507,2,277
"18309","언양읍","관내사전투표","대통령선거","울산광역시","울주군",3846,3846,1546,1045,610,306,299,0,4,11,1,2,2,0,1,3827,19,0
"18310","언양읍","언양읍제1투","대통령선거","울산광역시","울주군",2564,1578,396,667,269,119,104,1,1,2,2,0,0,1,2,1564,14,986
"18311","언양읍","언양읍제2투","대통령선거","울산광역시","울주군",2747,2014,676,655,368,171,114,2,1,3,0,5,2,3,4,2004,10,733
"18312","언양읍","언양읍제3투","대통령선거","울산광역시","울주군",2034,1338,329,636,224,77,51,4,0,4,1,1,0,1,2,1330,8,696
"18313","언양읍","언양읍제4투","대통령선거","울산광역시","울주군",2229,1557,508,544,261,110,114,2,0,2,0,1,1,1,2,1546,11,672
"18314","언양읍","언양읍제5투","대통령선거","울산광역시","울주군",1213,794,171,466,92,35,19,2,0,0,0,0,1,3,1,790,4,419
"18315","언양읍","언양읍제6투","대통령선거","울산광역시","울주군",2362,1719,610,495,335,148,115,2,0,3,1,0,0,0,2,1711,8,643
"18316","언양읍","언양읍제7투","대통령선거","울산광역시","울주군",2614,1829,642,534,315,170,139,1,1,5,1,1,0,0,2,1811,18,785
"18317","온양읍","관내사전투표","대통령선거","울산광역시","울주군",2763,2763,1149,663,457,238,230,3,1,1,1,1,2,0,4,2750,13,0
"18318","온양읍","온양읍제1투","대통령선거","울산광역시","울주군",1899,1205,268,634,158,74,57,2,0,2,0,0,1,2,2,1200,5,694
"18319","온양읍","온양읍제2투","대통령선거","울산광역시","울주군",1531,986,283,424,158,66,52,0,0,0,0,0,0,0,1,984,2,545
"18320","온양읍","온양읍제3투","대통령선거","울산광역시","울주군",2583,1586,473,600,290,114,86,2,1,6,1,1,0,1,2,1577,9,997
"18321","온양읍","온양읍제4투","대통령선거","울산광역시","울주군",1789,1355,455,405,276,105,99,5,0,1,0,1,0,1,2,1350,5,434
"18322","온양읍","온양읍제5투","대통령선거","울산광역시","울주군",2018,1497,562,368,309,123,123,1,0,1,0,0,0,0,5,1492,5,521
"18323","온양읍","온양읍제6투","대통령선거","울산광역시","울주군",3339,2271,782,654,458,197,157,8,0,2,1,1,0,1,1,2262,9,1068
"18324","온양읍","온양읍제7투","대통령선거","울산광역시","울주군",2127,1579,564,426,333,120,119,1,2,2,0,0,0,0,3,1570,9,548
"18325","범서읍","관내사전투표","대통령선거","울산광역시","울주군",9560,9560,4629,1772,1456,822,807,8,0,3,3,10,1,1,9,9521,39,0
"18326","범서읍","범서읍제1투","대통령선거","울산광역시","울주군",3453,2681,1040,665,497,255,200,3,0,4,1,6,0,0,2,2673,8,772
"18327","범서읍","범서읍제2투","대통령선거","울산광역시","울주군",2595,1849,601,578,378,162,107,2,0,1,2,3,0,5,1,1840,9,746
"18328","범서읍","범서읍제3투","대통령선거","울산광역시","울주군",1410,1058,243,564,146,54,39,1,0,0,2,0,1,2,3,1055,3,352
"18329","범서읍","범서읍제4투","대통령선거","울산광역시","울주군",2754,2053,757,563,377,170,163,3,0,2,1,0,4,1,4,2045,8,701
"18330","범서읍","범서읍제5투","대통령선거","울산광역시","울주군",3904,2945,1212,725,538,241,203,11,0,0,0,3,0,1,4,2938,7,959
"18331","범서읍","범서읍제6투","대통령선거","울산광역시","울주군",2007,1528,606,363,283,142,123,2,0,0,1,0,1,1,1,1523,5,479
"18332","범서읍","범서읍제7투","대통령선거","울산광역시","울주군",2374,1855,633,546,345,184,130,3,0,1,1,1,0,1,3,1848,7,519
"18333","범서읍","범서읍제8투","대통령선거","울산광역시","울주군",2961,2207,923,515,433,174,148,2,0,2,0,2,0,0,1,2200,7,754
"18334","범서읍","범서읍제9투","대통령선거","울산광역시","울주군",2785,2133,744,560,437,192,176,7,1,2,0,3,0,0,4,2126,7,652
"18335","범서읍","범서읍제10투","대통령선거","울산광역시","울주군",2857,2153,816,599,388,186,146,5,0,0,1,3,1,0,1,2146,7,704
"18336","범서읍","범서읍제11투","대통령선거","울산광역시","울주군",2583,2106,974,385,384,191,154,3,2,2,1,2,0,0,1,2099,7,477
"18337","범서읍","범서읍제12투","대통령선거","울산광역시","울주군",3331,2778,1300,522,509,264,176,0,0,1,0,0,0,0,0,2772,6,553
"18338","범서읍","범서읍제13투","대통령선거","울산광역시","울주군",3663,3011,1275,615,579,306,222,0,1,2,0,2,0,0,2,3004,7,652
"18339","범서읍","범서읍제14투","대통령선거","울산광역시","울주군",2069,1680,645,398,335,171,122,2,0,1,0,1,0,1,1,1677,3,389
"18340","서생면","관내사전투표","대통령선거","울산광역시","울주군",1027,1027,332,450,121,65,50,1,0,0,2,1,0,1,2,1025,2,0
"18341","서생면","서생면제1투","대통령선거","울산광역시","울주군",2022,1296,304,653,204,77,44,1,0,2,0,1,3,0,1,1290,6,726
"18342","서생면","서생면제2투","대통령선거","울산광역시","울주군",1160,725,155,404,93,31,35,0,0,1,0,1,0,2,2,724,1,435
"18343","서생면","서생면제3투","대통령선거","울산광역시","울주군",2364,1502,365,678,250,105,83,4,0,1,0,0,1,1,1,1489,13,862
"18344","청량면","관내사전투표","대통령선거","울산광역시","울주군",1484,1484,584,490,217,102,77,1,0,1,0,3,1,0,2,1478,6,0
"18345","청량면","청량면제1투","대통령선거","울산광역시","울주군",1469,854,197,439,131,51,23,2,0,1,0,2,0,1,1,848,6,615
"18346","청량면","청량면제2투","대통령선거","울산광역시","울주군",1943,1392,423,501,252,110,92,1,0,2,0,1,0,0,4,1386,6,551
"18347","청량면","청량면제3투","대통령선거","울산광역시","울주군",2764,2085,617,742,405,166,140,0,0,1,1,2,3,4,1,2082,3,679
"18348","청량면","청량면제4투","대통령선거","울산광역시","울주군",2999,2300,865,607,453,186,171,1,0,0,0,2,0,0,4,2289,11,699
"18349","청량면","청량면제5투","대통령선거","울산광역시","울주군",1225,754,177,358,127,52,31,2,0,0,0,2,0,0,1,750,4,471
"18350","웅촌면","관내사전투표","대통령선거","울산광역시","울주군",1027,1027,386,344,145,66,62,0,1,2,0,2,0,0,1,1009,18,0
"18351","웅촌면","웅촌면제1투","대통령선거","울산광역시","울주군",1948,1283,300,642,192,81,53,1,1,1,3,0,1,2,1,1278,5,665
"18352","웅촌면","웅촌면제2투","대통령선거","울산광역시","울주군",1358,929,213,476,138,52,34,0,0,0,2,0,0,3,1,919,10,429
"18353","웅촌면","웅촌면제3투","대통령선거","울산광역시","울주군",2290,1634,490,578,317,135,101,1,0,2,0,2,1,1,1,1629,5,656
"18354","두동면","관내사전투표","대통령선거","울산광역시","울주군",673,673,235,259,84,35,31,4,2,4,3,2,1,2,3,665,8,0
"18355","두동면","두동면제1투","대통령선거","울산광역시","울주군",1898,1133,273,553,154,66,50,1,2,1,1,1,3,3,9,1117,16,765
"18356","두동면","두동면제2투","대통령선거","울산광역시","울주군",874,550,126,303,74,16,13,0,1,0,0,0,1,3,2,539,11,324
"18357","두서면","관내사전투표","대통령선거","울산광역시","울주군",547,547,171,232,70,30,25,1,0,1,1,5,0,1,3,540,7,0
"18358","두서면","두서면제1투","대통령선거","울산광역시","울주군",1631,1072,238,581,167,46,22,2,0,1,0,1,0,6,3,1067,5,559
"18359","두서면","두서면제2투","대통령선거","울산광역시","울주군",609,395,68,248,50,15,6,0,0,0,0,0,0,3,3,393,2,214
"18360","상북면","관내사전투표","대통령선거","울산광역시","울주군",1306,1306,467,459,185,90,88,1,2,0,1,0,2,4,2,1301,5,0
"18361","상북면","상북면제1투","대통령선거","울산광역시","울주군",2075,1283,319,558,228,96,69,1,1,2,0,2,0,0,4,1280,3,792
"18362","상북면","상북면제2투","대통령선거","울산광역시","울주군",1184,747,179,410,87,31,27,1,0,0,2,0,0,3,1,741,6,437
"18363","상북면","상북면제3투","대통령선거","울산광역시","울주군",2197,1413,311,725,230,78,43,0,1,3,0,1,0,4,7,1403,10,784
"18364","삼남면","관내사전투표","대통령선거","울산광역시","울주군",2583,2583,979,805,425,195,154,4,2,1,1,0,1,0,3,2570,13,0
"18365","삼남면","삼남면제1투","대통령선거","울산광역시","울주군",3569,2250,617,954,389,145,117,5,0,3,2,2,1,5,1,2241,9,1319
"18366","삼남면","삼남면제2투","대통령선거","울산광역시","울주군",2385,1524,404,610,281,119,93,2,0,4,0,0,2,2,2,1519,5,861
"18367","삼남면","삼남면제3투","대통령선거","울산광역시","울주군",3401,2345,666,923,446,158,125,0,1,3,0,2,1,4,1,2330,15,1056
"18368","삼남면","삼남면제4투","대통령선거","울산광역시","울주군",1893,1198,342,528,175,77,59,0,0,2,0,0,1,5,3,1192,6,695
"18369","삼동면","관내사전투표","대통령선거","울산광역시","울주군",361,361,109,173,49,18,11,0,0,0,0,0,0,0,0,360,1,0
"18370","삼동면","삼동면제1투","대통령선거","울산광역시","울주군",676,437,84,237,65,23,21,0,0,0,0,0,0,1,1,432,5,239
"18371","삼동면","삼동면제2투","대통령선거","울산광역시","울주군",491,359,69,180,54,26,24,0,0,0,1,1,0,1,1,357,2,132
"18372","잘못 투입·구분된 투표지","잘못 투입·구분된 투표지","대통령선거","울산광역시","울주군",0,0,0,0,0,0,0,0,0,0,0,0,0,0,0,0,0,0
